Obama nomeia Susan Rice como consultor de segurança nacional	Donilon Out, Rice em como consultor de segurança nacional de Obama
As fundações da África do Sul são construídas na memória de Nelson Mandela	Os políticos australianos lamentam a morte de Nelson Mandela
Polícia turca Polícia Lágrima Gás Taksim Square Protect	Polícia de tumultos turcos entra na praça Taksim
Chicago Shooting mostra lacuna no policiamento intensificado	Chicago Shooting mostra lacuna no policiamento intensificado
Feds movendo-se para exigir comunicação de segurança para carro a carro	A Guatemala derruba a convicção de genocídio do ex -ditador
Carter Stars for Crusaders	vencedor do Super Rugby de ponto de bônus para cruzados
Líderes de protesto da Ucrânia Nome dos Ministros, tropas russas em alerta	Ucrânia se recusa a agir contra a 'provocação' russa
A Coréia do Norte Shuns Oferta de palestras	Coréia do Norte dispara 2 foguetes
04: 47 Renzi jurou como premier italiano	Renzi da Itália jurou como primeiro -ministro
O príncipe Charles se compara a Putin a Hitler '	O príncipe Charles compara Vladimir Putin a Adolf Hitler '
Chefe da OTAN pede restrição no Egito	O Irã diminui o massacre extenso no Egito
Malala, Snowden, Bielorrusianos selecionados para o Prêmio Sakharov	Fugitive Snowden Listado curto para o Prêmio Europeu de Direitos
40 ainda ausentes nos acidente de trem canadense	Hunt ainda por 40 desaparecidos no Canadá Blaze Blaze
O Irã alerta contra a intervenção militar no Iraque	Explosão perto do Aeroporto Militar de Damasco
Exército israelense retoma a ofensiva de Gaza	Israel escala a ofensiva de Gaza, as vítimas montam
Nigéria: militantes matam estudantes no ataque da faculdade	Os islâmicos da Nigéria matam 9 estudantes em ataques escolares
PM de Israel acusa o presidente do Irã de hipocrisia	PM grego acusa coalizão de hipocrisia
2ª Índias da Nova Zelândia Odi abandonado	Nova Zelândia, Índias Ocidentais ODI choveu
Um morto na Filadélfia colapso, outros puxados de escombros	Seis confirmados mortos após o colapso do prédio da Filadélfia
A UE oferece para ajudar a destruir as armas da Síria	A Alemanha oferece ajuda para destruir armas da Síria
A polícia se chocou com a juventude no Cairo após o protesto anti-Morsi	Egito: Polícia colidem com manifestantes pró-Morsi
Os principais diplomatas se reúnem em Munique no momento crítico	Os principais diplomatas discutem o programa nuclear do Irã
Presidente da Argélia Bouteflika no Hospital Paris	Presidente da Argélia Bouteflika no hospital
EUA perseguem líderes da Al Qaeda na Dual Líbia, Somália Raids	Fonte da AP: as forças dos EUA levam o líder da Al Qaeda na Líbia
Por que o Elbaradei deve se afastar	Elbaradei não confirmado como Egito PM
Ronaldo Hat Trick envia Portugal para a Copa do Mundo	Ronaldo hat-trick demitir Portugal para a Copa do Mundo
Snowden 'Dado o documento de refugiados pelo Equador'	Snowden pronto para voar para fora de Moscou
NA Presidente, Mensagem äôs no Dia Mundial da Liberdade de Imprensa	Paquistão marca o Dia Mundial da Liberdade de Imprensa
Greve de drones nos EUA mata 11 no Paquistão	O drone dos EUA mata 18 no noroeste do Paquistão
Israel move forças perto da fronteira com Gaza	Israel reforça as forças ao longo da fronteira volátil de Gaza
Ministros das Relações Exteriores da UE para discutir o embargo de armas na Síria	Ministros das Relações Exteriores da UE buscam solução na Síria Arms
Forte Taiwan Quake mata dois, fere 21	O forte terremoto do Irã mata a criança, causa danos
Israel libera palestinos como gesto de conversa	Abbas aceita renúncia do negociador da paz palestina Shtayyeh
Toll de um terremoto da Philippine sobe para 185	Toll do Quake de Filipinas aumenta para 144
ações para assistir perto na segunda -feira	ações para assistir na segunda -feira
Jatos do exército matam 38 militantes no NW Pakistan Air Raids	nós. drone mata 4 militantes no Paquistão
Novo governo da Itália em juramento	Premier italiano para ser jurado hoje
Ucrânia 'à beira da guerra civil'	A Ucrânia está realmente à beira da guerra civil?
Israel concorda com a trégua de Gaza de 24 horas	Israel concorda em estender a trégua de Gaza por quatro horas
A turbulência do Egito se aprofunda; militantes matam 25 policiais	A turbulência do Egito se aprofunda à medida que o ataque do Sinai mata 25 policiais
Polícia egípcia Fire Limke Gas para manifestantes no Cairo	Police Fire Limke Gas para manifestantes no Cairo
Elbaradei para se tornar PM egípcio	Liberal Elbaradei chamado Egito PM, Islamists Cry Falt
Líderes da EDL presos durante março a Woolwich	Líderes da EDL presos a caminho de Woolwich
O Tribunal Superior de Andhra Pradesh pergunta aos atores Telugu Mohan Babu, Brahmanandam para devolver Padma Shri	HC aconselha os atores Mohan Babu, Brahmanandam a devolver Padma Shri
Homem que incendiou o shopping nacional	Homem que incendiou o National Mall em DC Dies
Filipinas mantém o segundo senador por corrupção	Filipinas se recuperando após um tufão poderoso
'Fast & amp; A estrela do furiosa Paul Walker morre em acidente de carro aos 40	A estrela de Hollywood Paul Walker morre em acidente de carro
Inundações no sul da China mata 37	Explosão no norte da Síria mata 6
Enviado alemão otimista sobre o Irã-G5 + 1 palestras	Irã 'cautelosamente otimista' sobre futuras negociações nucleares
O renomado guitarrista espanhol de flamenco Paco de Lucia morre	O guitarrista de flamenco espanhol Paco de Lucia morre aos 66
A oposição síria aguarda o convite para as negociações de paz de Genebra	A oposição síria define a condição de partida de Assad para as negociações de Genebra
O quebra -gelo chinês muda de curso para objetos suspeitos	O avião de pesquisa chinês encontra 'objetos suspeitos'
O lançamento do Paquistão americano identificado como agente do FBI	Paquistão libera agente do FBI sob fiança
Snowden atinge obstáculos em busca de asilo	Snowden hits obstáculos em busca de asilo
notícias de tendência em toda a China em 20 de outubro	notícias de tendência em toda a China, 15 de setembro
Hoje na história, janeiro. 24	hoje na história, 4 de abril
Suspeito de bombardeio de maratona de Boston pego depois de Manhunt	Suspeito sobrevivente de Boston Marathon Aguards aguardam acusações
O número de mortos no colapso do edifício no sul da Índia aumenta para 47	4 mortos no colapso do edifício no sul da Índia
O Paquistão impõe proibição temporária em 2 canais de TV	O Paquistão descarta o caso contra o agente do FBI
Chris Froome estabelecido para a vitória do Tour de France	Chris Froome 'Sonumental' Tour de France Win
Prisioneiros palestinos chegam a Muqata em Ramallah	Prisioneiro Paquistão agrediu na prisão de Jammu
10 mortos, cinco feridos no acidente rodoviário da SW China	5 doer no acidente de carro da cidade de Gaza
Sinais detectados na pesquisa MH370 na 'mesma ampla área'	sinal detectado na pesquisa de MH370, äėconsistent, äô com caixa preta
Funeral cerimonial para Margaret Thatcher	O Reino Unido se despediu de 'Iron Lady' Margaret Thatcher
Angelina Jolie "muito agradecida" pelo apoio após mastectomia dupla	Angelina Jolie passa por mastectomia dupla
Matt Smith sai da BBC, Doctor Who	Matt Smith deixa o médico da BBC que
Junta tailandesa acumula força de segurança para sufocar protestos de Bangkok	As forças de segurança da junta tailandesa permanecem no quartel à medida que os protestos diminuem
Rowhani declarou vencedor da eleição presidencial do Irã	Anúncio oficial: Rowhani vence as eleições presidenciais do Irã, diz o Ministro
ASO se recusa a renunciar aos comentários nazistas	PM espanhol se recusa a renunciar ao escândalo de corrupção
Shehla Raza, do PPP, eleito vice -presidente da SA	Shehla Raza faz juramento como vice -presidente da Assembléia de Sindh
Explosões Mate 29 fora de duas mesquitas na Trípoli do Líbano	2 Explosions Rock City, no norte do Líbano
A Greve dos Drones dos EUA mata seis funcionários do Paquistão	Greve de drones nos EUA mata 11 no Paquistão
Cantores de caça do Paquistão 'Escondimentos Taliban'	O Paquistão quer o suprimento de armas para os lados sírios parados
Turista britânico morto no acidente de mergulho da Malásia	Advogado morto em acidente de barco
Sisi jurou como presidente do Egito, Recepção Cool do West	Egito, äôs sisi jurou como presidente
A economia de Taiwan cresce 2,27 % no trimestre de abril a junho	O crescimento econômico da China se recupera para 7,8 % no último trimestre
Bananas jogadas no primeiro ministro negro da Itália	Bananas jogadas no primeiro ministro negro da Itália, Cecile Kyenge
pistoleiros matam oito no segundo ataque do Quênia	pistoleiros 'Kill 15' no segundo ataque do Quênia
Us Writer Homes Blocks Mantel ‚äôs Treble Win	Casas nega as triplas literárias de Mantel
jogador de futebol profissional Aaron Hernandez acusado de assassinato na morte de um amigo	Jogador de futebol americano Aaron Hernandez acusado de assassinato
Quatro presos quando o pedágio de Bangladesh aumenta para 352	Proprietário preso como Bangladesh Building Toll atinge 372
nós. retoma a busca de marinheiros britânicos desaparecidos após o público	A Guarda Costeira dos EUA suspende a busca por marinheiros britânicos desaparecidos
resgatadores vasculham detritos após o colapso dos edifícios da Índia	Selecione imagens do colapso do prédio de Bangladesh
Ataques iraquianos da bomba matam pelo menos 13	carro -bomba iraquiano perto da igreja mata pelo menos 14
As leituras obrigatórias da nota para segunda-feira, 25 de novembro de 2013	As leituras obrigatórias da nota para terça-feira, 10 de setembro de 2013
Tamerlan Tsarnaev enterrado na Virgínia	Suspeito de bomba de Boston enterrado no cemitério da Virgínia
Forças do Egito definidas para bloquear o acesso aos campos de protesto de Morsi	As forças egípcias se movem para limpar campos de protesto pró-Morsi
desemprego da zona do euro em recorde de 12 %	O desemprego da zona do euro atinge o recorde de 12,1 % em março
O autor Nobel Doris Lessing morre aos 94	Nobel Laureate Doris Lessing morre aos 94
O chefe do partido da oposição do Japão critica as políticas econômicas de Abe	Zimbábue ‚äôs oposição MDC Party desafia Robert Mugabe, vitória na eleição
O ruído é não. 1 queixa de qualidade de vida em Nova York	O ruído é não. 1 queixa de qualidade de vida em Nova York
3 suspeitos levados sob custódia no caso de bombardeio de Boston	A polícia de Boston diz que 3 levou sob custódia em bombardeio de maratona
O avião da Malaysia Airlines 'abatido' na Ucrânia	avião da Malásia abatido sobre a Ucrânia
Chefe da ONU: 'Esperança frágil, mas real' nas negociações de paz na Síria	Líder israelense para manter a linha dura em negociações de paz
Ordens do Tribunal Turco levantando o levantamento da proibição do Twitter	As ordens do tribunal turco param para a proibição do Twitter
O chefe de oposição da Ucrânia quer mais protestos	Os manifestantes da Ucrânia derrubaram a estátua de Lenin
Queen presta homenagem a Nelson Mandela	A fraternidade de rugby da África do Sul lamenta Mandela
Defesa no julgamento da Ferry da Coréia do Sul avisa do bode expiatório	Defense in Ferry Trial alerta do bode expiatório
declina no mercado de ações dos EUA moderado	A venda de tecnologia envia bolsas de ações asiáticas mais baixas
11: 42 O último filho de Churchill morre com 91 anos	O filho mais novo de Churchill Lady Soames morre com 91 anos
chamadas israelenses para executar cativos palestinos em vez de libertá -los	Israel permite libertação de prisioneiros palestinos
Afeganistão se prepara para votação presidencial de segundo turno	Afeganistão se prepara para a segunda rodada de eleições presidenciais
A mais recente violência anti-muçulmana na Birmânia mata 1, ferida 10	Briefing mundial | Ásia: Mianmar: A violência anti-muçulmana mortal explode
suspeito dos EUA Drone Strike mata 5 no Paquistão	nós. Drone Strike mata 5 no Paquistão
As leituras obrigatórias da nota para sexta-feira, 24 de maio de 2013	As leituras obrigatórias da nota para terça-feira, 29 de outubro de 2013
TV suíça: a polícia diz 44 feridos em colisão de trem	4 mortos, 30 feridos em colisão de trem perto de Moscou
22 mortos no acidente de minas no sudoeste da China	2 mortos, dezenas feridas por explosão no sudoeste do Paquistão
NYPD Twitter Outreach sai pela culatra	A campanha do Twitter da NYPD sai pela culatra
19 doer no tiroteio de Nova Orleans	Polícia: 19 doeu no tiroteio do dia da mãe de Nola
Outro navio migrante limita a Itália	Outro barco migrante limita a Itália, 27 mortos
Wawrinka derrota Nadal ferido para ganhar o Australian Open	A lesão de Nadal Jinx continua no Aberto da Austrália
Pranab para liderar a equipe em Mandela, Serviço Memorial	Jonathan para participar de Mandela ‚äôs Memorial Service
A pesquisa turca termina como os últimos mineiros ausentes encontrados	A pesquisa turca termina como os últimos mineiros ausentes encontrados
Margaret Thatcher receberá funeral cerimonial	Margaret Thatcher ajudou a prevenir a 'guerra de raça devastadora' na África do Sul, diz o ex -presidente
ONU convida o Irã para as negociações de paz na Síria	França e nós evitam o Irã nas negociações de paz na Síria
O Irã prevê o fracasso das negociações de paz israelense-palestinas	O acordo tentativo alcançou para retomar as conversas israelenses -palestinas - nós
Sobrevivente do Paquistão de Honra Killing Tecy temes por sua vida	Garota adolescente paquistanesa sobrevive à tentativa de 'assassinato de honra'
Olivia Colman vence o segundo prêmio BAFTA	BAFTAS 2013: Olivia Colman recebe dois prêmios
O Titanic Violin Nabs recorde US $ 1,4 milhão	Violino Titanic é vendido por US $ 1,7 milhão
Última tempestade traz mais neve para a costa leste dos EUA	Última tempestade para trazer mais neve para a costa leste
Ankeet Chavan concedeu fiança condicional para casamento	Ankeet Chavan concedeu fiança para se casar
O novo julgamento de Hosni Mubarak foi adiado até 8 de junho	Recupela de Mubarak encerrado para junho
A primeira ordem de Jal da Airbus é o golpe para a Boeing	Japan Airlines Ordens 31 Airbus A350s avaliados em US $ 9,5 bilhões
maratona de rock bastões gêmeos	Dois mortos em explosões gêmeas na maratona de Boston
Eu	Os líderes da UE dão polegares a Juncker, a Grã -Bretanha isolada
Sienna Miller testemunha no teste de hacking por telefone no Reino Unido	Sienna Miller ataca pressiona por 'Titilating, relatórios de relatórios no julgamento de hackers
Israelenses atacam 2 palestinos na área de Jerusalém	Os colonos espancaram palestino em Jerusalém
Índia tinta: Imagem do dia: 25 de fevereiro	Índia tinta: Imagem do dia: 27 de janeiro
Bangladesh Baces para protestos violentos após a suspensão do líder da oposição	Bangladesh executa o líder da oposição
Filha e genro de casal de idosos encontrado enterrado em seu quintal é acusado de assassinato	Filha e genro acusado de assassinar o casal de idosos encontrados em bastidores depois de desaparecer há 15 anos são presos sob custódia
UE estende sanções contra a Rússia	Nigéria retira acusações de tráfico de armas contra marinheiros russos
Cuba vê "papel principal" para investimento estrangeiro	Câmara pronta para votar no plano para reabrir o governo
`` Äėglee ‚äô estrela cory monteith encontrada morta no quarto de hotel	Cory Monteith encontrado morto: canadense ‚GEE, estrela tinha 31 anos
A Al Qaeda suspeita que o oleoduto de exportação de petróleo de bomba no Iêmen	Gunnes da Al Qaeda assumem a base militar no Iêmen
O ator de comédia Felix Dextor morre com 52 anos	O comediante britânico Felix Dexter morre de câncer
O primeiro -ministro do PM do PM do Líbano ', o Primeiro Ministro do Líbano, formou um gabinete mais de 10 meses depois de assumir o cargo, assumindo uma ampla gama de grupos políticos após a ponte de divisões graves AM	Beirute: O primeiro -ministro do Líbano formou um gabinete mais de 10 meses depois de assumir o cargo ontem, incluindo uma ampla gama de grupos políticos após a ponte de graves divisões entre elas principalmente sobre
O Irã tem 18.000 centrífugas, 10.000 operando	O Irã tem 18.000 centrífugas, 10.000 já ativos
Presidente iraniano faz estréia no cenário mundial	O candidato presidencial do Irã diz que as sanções ocidentais devem ser quebradas
Os corredores da maratona de Londres honram as vítimas de Boston	A Maratona de Londres observa o silêncio para as vítimas de Boston
2 mortos, múltiplos feridos em tiro em Miami	Três mortos, cinco feridos em tiroteios na praia de Myrtle
pontuações mortas em protestos egípcios	PM da Turquia alerta contra protestos
EUA, China preparou o terreno para a cúpula Obama-Xi	EUA, China preparou o cenário para Obama-Xi Meet
Departamento Estadual. Questões amplas alertas de viagem, diz o ataque terrorista possível	Alerta de viagem global dos EUA, cita a ameaça da Al Qaeda
Cameron 'não tem preocupações' sobre carne halal	Veterans Health Probe confirma o encobrimento dos atrasos nos cuidados
O Irã recebe o primeiro debate presidencial de TV	A mídia iraniana elogia o debate presidencial acalorado
A Irmandade Muçulmana formou 'Asa Militar': Egito	O Egito declara a Irmandade Muçulmana um "grupo terrorista"
Michelle Obama para estrelar parques e recreação	Michelle Obama para aparecer em 'Parques e Recreação'
Israel para liberar prisioneiros palestinos	Israel lança 26 prisioneiros palestinos
Tropas quenianas Storm Westgate Mall para terminar o cerco	As forças do Quênia lutam para acabar com o cerco do shopping
UE condena ataques terroristas na China	O Paquistão condena o ataque terrorista na China
EUA dizem que a RPDC não tem capacidade de mísseis nucleares	Casa Branca diz que a RPDC não tem capacidade de mísseis nucleares
As ações de Cingapura terminam 0,11 pct	As ações de Cingapura terminam 0,45 %
O homem mais velho do mundo morre aos 116	O homem mais velho do mundo morre com 116 anos
GM devagar nos recalls, o registro do Congresso mostra	Mobile World Congress Future Smartphone
10 mortos no acidente de ônibus do Sri Lanka	Sete mortos em Karachi Twin Blasts
declaração conjunta dos Estados Unidos e Ucrânia	Declaração do Presidente na Ucrânia
Toll de mortal em atentados ao Líbano sobe para 47	1 suspeito preso após carros -bomba do Líbano matar 45
Líder de extrema-direita grega prenda o julgamento pendente	Líder de extrema-direita grega prenda o julgamento pendente
Proprietários de fábrica de Bangladesh presos quando o número de mortos se aproxima de 350	Proprietários de fábrica de Bangladesh presos
3 bombas explodem no sul da Tailândia, ferindo 27	3 bombas explodem no sul da Tailândia; 27 mágoa
Israel facilita a proibição de importações de materiais de construção para Gaza	Israel facilita a meio -fio em materiais de construção para Gaza
Ariel Castro se declara inocente	Ariel Castro se declara inocente de estuprar e sequestrar
Os afegãos minimizam as ameaças do Taliban, continuam votando para eleger o presidente	Os afegãos se alinham para votar no escoamento presidencial
4 soldados egípcios mortos na emboscada do Sinai	3 soldados egípcios mortos no bombardeio de carros do Sinai
BlackBerry aberto à venda	BlackBerry perde US $ 965 milhões no 2º trimestre
O porta -aviões de Pequim retorna do Mar da China Meridional	A China envia portadora para o Mar da China Meridional
Os tribunais do Egito ouvem casos contra Mubarak, islâmicos	O Tribunal do Egito libera temporariamente Mubarak sobre ganhos ilícitos
Bartoli vence o título de Wimbledon, vence Lisicki em 2	Bartoli derruba Lisicki para ganhar o título de tênis de Wimbledon
O sucesso da Crimeia de Moscou pode levar a redefinir a fronteira oriental da Ucrânia	Merkel: as ações russas podem levar a uma catástrofe
Nelson Mandela morre com 95 anos	Nelson Mandela morre aos 95 anos
um morto, 77 doer em tumulto no PNG Immigration Center	Um morto, 77 doeu em tumulto no Centro de Imigração de Papua Nova Guiné
O rei belga Albert II para renunciar a favor do filho	Bélgica rei Albert II 'para abdicar'
Chefe nazista Gestapo 'enterrado no cemitério judaico'	Chefe nazista enterrado no cemitério judaico
A bomba na estrada mata 7 soldados afegãos	A bomba na estrada 'mata oito soldados afegãos'
Doze mortos em explosão de bombas no trem paquistanês	11 mortos quando o ônibus cai em ravina no norte do Paquistão
Os militares do Egito reprimem a irmandade muçulmana	O Exército do Egito se move contra a irmandade
voto suíço sobre o maior salário mínimo	cédulas de elenco suíços no maior salário mínimo do mundo
Kevin Rudd jurou como primeiro -ministro australiano	Rudd jurou como o novo primeiro -ministro da Austrália
Os manifestantes da região de Donetsk detêm caminhões que carregam munição de foguete do governo	Venha me pegar, diz o líder de protesto tailandês como tumultos antigovernamentais crescem
Os casais se dão o nó como o casamento entre pessoas do mesmo sexo se torna lei	Cameron vem os primeiros casamentos do mesmo sexo na Grã-Bretanha
aluno estrelado esfaqueado até a morte por gangue	turista britânico pisoteado até a morte por elefante
Israel encontra corpos de três adolescentes desaparecidos na Cisjordânia	As forças israelenses detêm 5 palestinos na Cisjordânia
Conferência Nacional sobre Economia Estabelecido para o final de maio de 2014	Eleições nacionais marcadas para 7 de maio de 2014
Easy Rider Star Karen Black Dies com 74 anos	A atriz Easy Rider Karen Black Dies de Câncer
O que dizem os jornais, 25 de junho de 2013	O que dizem os documentos, 19 de julho de 2013
Bill Roache, da Coronation Street	As estrelas da rua coronação são novos set 'Amazing'
Tóquio para sediar os Jogos Olímpicos de 2020	Tóquio ganha correr para sediar os Jogos Olímpicos de 2020
A Rússia alerta a Ucrânia contra o acordo da UE	Rebeldes em helicópteros da Ucrânia
Oscar Pistorius 'acidentalmente disparou bala no restaurante movimentado - depois pediu ao amigo que assumisse a culpa'	Oscar Pistorius 'pediu ao amigo que assumisse a culpa por arremessos de restaurante, vídeo
Mandela 'respondendo ao tratamento'	Esposa: Mandela está respondendo ao tratamento.
Dois presos na Índia depois de ter turístico perdido estuprado	Dois presos na Índia por estupro de gangue de turistas dinamarqueses
As ações de Cingapura terminam 0,37 PCT	As ações de Cingapura fecham 0,25 pct mais baixo
Red Sox venceu os tigres para alcançar a World Series	Red Sox Beat Tigers 5-2 para avançar para a World Series
Voltas de jato de guerra israelense no norte de Gaza	Golpe aéreo israelense na cidade de Sourthern Gaza mata sete
pelo menos 22 mortos após o terremoto da China	Pelo menos 89 mortos na China terremotos
Pistãos matam nove turistas estrangeiros, guia no Paquistão	pistoleiros matam nove turistas no Paquistão
Presidente francês encontra licitantes para jóias industriais Alstom	navio de guerra de fabricação francesa destinada a Rússia
China yuan enfraquece para 6.1559 contra USD	China Yuan se fortalece para 6.1767 contra o USD
Seis soldados dos EUA mortos no acidente de aeronave no Afeganistão	seis EUA Soldados mortos no acidente de helicóptero no Afeganistão
Bomber de caminhão suicida mata 11 no norte do Iraque	Carros -bomba suicidas mata 12 no norte do Iraque
Notícias são meus negócios	Um novo iPad está chegando
Hernandez Double dá a vitória do México	Hernandez Double dá a vitória do México sobre o Japão
Os advogados de direitos assediados quando a China é o estado de direito	Os advogados de direitos da China assediaram cerca de 200 bandidos
Ativistas: Syrian Airstrike mata 21 em Aleppo	Novos ataques aéreos sírios matam pelo menos 15 em Aleppo
Rosberg emula o pai com a vitória de Mônaco	Fórmula 1: Rosberg permanece modesto, apesar da vitória do Mônaco
Helicóptero de Glasgow Toll Toll sobe para nove	Tolling Toll Toll aumenta para 260
Outro buraco no GPO como o chefe do Bureau da PM desce	O chefe do departamento de Netanyahu desce
Enorme explosão após descarrilar o trem de petróleo no Canadá	Enorme explosão como trem de carga descarrila perto de Baltimore
David Beckham para se aposentar no final da temporada	David Beckham se aposenta do futebol
Afeganistão: Bomber Suicide mata oito na explosão de ônibus militar	A bomba na estrada 'mata oito soldados afegãos'
China sacia o principal funcionário econômico	A China FM hospeda altos funcionários da ASEAN
Mortes em atentados e tiroteios pelo Iraque	atentados e um tiroteio 8 no Iraque
n. Kim da Coréia é a execução de tio poderoso	Kim da Coréia do Norte visto por trás de demitir tio poderoso
George Zimmerman não é culpado de menino, assassinato	Blog ao vivo: George Zimmerman não culpado
UE, Mianmar trabalha em direção ao contrato de proteção de investimento	China não é mais o principal destino de investimento: enquete
Editor de Tehelka envolvido em golpe de agressão sexual	O editor de Tehelka desce após alegações de má conduta sexual
Iron Lady Margaret Thatcher morre aos 87 anos	A ex -primeiro -ministra britânica Margaret Thatcher morre aos 87 anos
Quatro apoiadores de Morsi mortos nos confrontos do Egito	Milhares de apoiadores de Morsi se reúnem no Egito
un. condena assassinatos étnicos na cidade petrolífera do Sudão do Sul	ONU condena assassinatos étnicos no Sudão do Sul
Coronel de Israel morto em Jordan Valley	israelense morto no ataque da Cisjordânia
Feds Drop 'Morning-After Pill' apelo	nós permitirmos pílula de manhã após as meninas de qualquer idade
Police Fire Limke Gas para manifestantes em Bangkok	Police Fire Limke Gas para manifestantes
Tiro, protestos Mar Thai votando	Os manifestantes tailandeses interrompem o voto avançado
Futuros do índice de ações da China Fechar mais baixo - 23 de abril	Futuros do índice de ações da China Close mais alto - dez. 4
Coréia do Norte pede estrangeiros no sul a evacuar	A Coréia do Norte alerta estrangeiros na Coréia do Sul para evacuar
O Canadá aprova o oleoduto para a costa do Pacífico	O governo canadense aprova o oleoduto controverso para o Pacífico
Hollande permanece firme para combater o terrorismo após explosões do Níger	Hollande diz que a estudante pode retornar à França após a expulsão
Sete filipinos mortos no ataque do Iêmen	soldados sírios mortos em ataque de bomba
tempestade enterra o nordeste; 16 polegadas de neve em NJ	Fórum pede relações estáveis ​​para a China, Japão
Israel termina o caso de ataque aéreo; Palestinos críticos	canhoneiras israelenses disparam com pescadores palestinos
Diana Nyad completa o recorde nadar na quinta tentativa	'Nunca, nunca desista': Diana Nyad completa a natação histórica de Cuba-to-Florida
Foco esportivo de Bernie 1 de julho de 2013	Foco esportivo de Bernie em 2 de janeiro de 2014
Manifestantes derrubaram a estátua de Lenin em Kiev	Os manifestantes da Ucrânia derrubaram a estátua de Lenin em Kiev
Explosões mortais atingem a maratona de Boston em nós	Duas bombas atacam a maratona de Boston
O presidente do Sudão do Sul declara o estado de emergência em dois estados	Sudão do Sul (República de): Sudão do Sul, Kiir declara um estado de emergência em Jonglei e Unity States
Putin, Merkel se encontra na crise da Ucrânia	Ministros das Relações Exteriores para se reunir sobre a crise da Ucrânia
Brooks se declara inocente de acusações de hackers	Dave Lee Travis se declara inocente de todas as acusações
O petróleo cai abaixo de US $ 102 no aviso de desligamento dos EUA	Os preços do petróleo se estendem em meio ao desligamento dos EUA
41 mortos, 22 feridos em ataques violentos no Iraque	35 mortos, 138 feridos em onda de ataques no Iraque
respeitado entrevistador britânico David Frost morre de um ataque cardíaco	A emissora David Frost morre
O Irã 'frustra as tentativas de sabotagem nuclear'	O Irã diz que detecta sabotagem em instalações nucleares
as ações pouco mudaram nas negociações antecipadas	As ações dos EUA escorregam cedo antes dos relatórios de ganhos
Tribunal para ouvir Bo Xilai Appeal	O Tribunal Chinês concorda em Bo Xilai Appeal
conexão jamaicana na vitória do Liverpool	Eleição do Japão: Shinzo Abe coma vitória no deslizamento de terra
Polícia turca de incêndio com gás lacrimogêneo em manifestantes	Turquia: Police Fire Limke Gas para manifestantes
China Yuan se fortalece para 6.1184 contra US $ terça -feira	China Yuan se fortalece para 6,168 contra USD na segunda -feira
três mortos após o colapso do edifício de Nova York	Treze mortos depois que Nari bate nas Filipinas
Netanyahu fala duro no Irã antes das negociações do Vaticano	Netanyahu encontra Pope, fala duro com o Irã
O homem acusado de assassinato do professor, um homem de 22 anos, será acusado do assassinato de um professor de viveiro que foi morto a tiros enquanto comemorava seu aniversário.	Sabrina Moss: Homem, 22, acusado de assassinar o professor de viveiro tirado enquanto comemorava o aniversário
Especialistas em armas internacionais deixam a Síria, Obama, para fazer a declaração	Especialistas em armas deixam a Síria, EUA prepara o ataque
Os manifestantes se reúnem no Brasil, apesar das concessões	Os protestos continuam na Ucrânia, apesar das concessões
O colapso do canteiro de obras mata 7 em c. China	O colapso do guindaste mata 4 na China
FTSE Bursa Malaysia Atualização: 15:00	FTSE Bursa Malaysia Atualização: 9h.
França para fechar o grupo de extrema direita ...	França para fechar o grupo de extrema direita após a morte do aluno
Tornado mata cinco em Oklahoma	New Tornado Emergency in Oklahoma City
Rainha visita a cena de ataque de soldado de Londres	A rainha Elizabeth II visita quartéis de soldado britânico morto na semana passada
19 doer no tiroteio de Nova Orleans	17 ferir no tiroteio de Nova Orleans
As tropas da Índia e da China se retiram para a fronteira de fato no negócio de confronto	A Índia diz que a China concorda em retirada para a fronteira de fato no acordo de confronto
alívio em Boston como segundo suspeito capturado	A polícia confirma como o suspeito foi capturado
O exército sírio retém o castelo de cruzados de rebeldes	O exército sírio retém o castelo histórico de cruzados
O Tribunal Chinês concorda em ouvir Bo Xilai Appeal	Tribunal para ouvir Bo Xilai Appeal
n. Coreia teste-fogo 30 mísseis de curto alcance no mar: yonhap	O Irã diz que testa-fogo novo míssil terrestre ao mar no Golfo
Saudita para dar ao exército libanês US $ 3 bilhões	Arábia Saudita para conceder exército libanês US $ 3 bilhões
Ovadia Yosef, rabino e rei israelense, morre	Rabino Ovadia Yosef, rei da política israelense, morre aos 93
As vendas domésticas dos EUA caíram 5,1 % em janeiro	Mergulho de vendas existentes nos EUA em fevereiro
Trabalhadores da Cruz Vermelha libertada na Ucrânia	Membros da Cruz Vermelha sequestrados na Síria
A condição de Mandela agora é crítica	A condição de Mandela 'ainda crítica'
Enviado da Síria diz que nenhuma paz fala sem oposição	Síria: Cameron e Obama se aproximam do oeste da intervenção
Rainha para citar a maior transportadora de todos os tempos	Nomes de rainha portador de aeronaves gigantes
Os militantes de Bangla escapam da van da prisão em emboscada de bomba	Van da prisão de Bangladesh emboscada
Naufrágios do avião argelino de ar que transportam 116 pessoas encontradas no Mali	Naufrágios do voo Airalgerie AH5017 encontrado no Mali
Hamas concorda com a trégua de 24 horas em Gaza	O Hamas concorda com a trégua de férias de 24 horas na guerra de Gaza depois que Israel retoma a luta
unidade da ONU sobre a Síria	Cúpula G20 termina dividida sobre a Síria
Palestinos influentes buscam um estado democrático	A Liga Árabe apoia postura palestina em negociações de paz
dezenas mortas no acidente de avião russo	Dez mortos no acidente de avião do Alasca
Jato sudoeste atingiu o nariz primeiro	A engrenagem do nariz do jato do sudoeste pousou primeiro
nós. Os varejistas concordam com o Pacto de Segurança da Planta de Bangladesh	70 varejistas concordam com o New Bangladesh Factory Safety Pact
O desligamento do governo dos EUA começa - atualizações ao vivo	O desligamento do governo começa com a briga de saúde
Mulher perde braço no ataque de tubarão Maui	Mulher perde braço no ataque de tubarão fora de Maui
Território palestino ocupado: pare de atirar em civis de Gaza	Território palestino ocupado: Proteção de Relatório Semanal de Civis
O presidente francês Hollande condena os referendos da Ucrânia como 'nulo e vazio'	Hollande condena os referendos da Ucrânia como 'nulo e vazio'
Obama nomes de arroz franco como seu consultor de segurança	Obama nomeia Susan Rice como consultor de segurança nacional
Estoques indianos fecham mais baixo	Estoques indianos abrem mais baixo
O ex -primeiro -ministro israelense Sharon morre aos 85	O ex -primeiro -ministro israelense Ariel Sharon morre, com 85 anos
Índia tinta: Imagem do dia: 25 de fevereiro	Índia tinta: Imagem do dia: 21 de abril
Bomber suicida mata 14 no Afeganistão	A explosão suicida mata 1 na capital afegão
A China lança sonda e rover para a lua	A China lança a First Moon Rover Mission
Todos os olhos em Khurshid, äôs Trip ...	Ministros das Finanças da UE, conversas B ...
Austrália reduz as taxas para registrar baixos	A Austrália reduz a taxa de juros para registrar baixos 2,75 %
A agência de notícias chinesa bate atrasos em busca de jato	Dez embarcações chinesas em espera para pesquisa de jato
Lesão coloca o Neymar do Brasil da Copa do Mundo	Neymar fora da Copa do Mundo
Palavra cruzada clássica - sábado, 1º de junho	Palavra cruzada clássica - sábado, 20 de abril
n Coréia testar-se de 30 mísseis de curto alcance	n. Coréia dispara mísseis de curto alcance
A oposição síria define a condição de partida de Assad para as negociações de Genebra	A oposição da Síria concorda com as negociações de paz de Genebra
15 mortos como a polícia do Egito dispersam campos pro-mursi	'15 matou 'como forças egípcias clare campos pró-Morsi no Cairo
Diplomata palestino morre em Praga Blast	Diplomata palestino morto em explosão em Praga
Os manifestantes se chocam com a polícia em Caracas	Os manifestantes se chocam com a polícia no Brasil
nós. fecha a embaixada na Líbia, evacua os funcionários	Nós evacuamos a embaixada na Líbia em meio a inquietação
Novice 'dirigiu a Ferry da Coréia do Sul'	Capitão de balsa da Coréia do Sul preso
N Coréia adia reuniões familiares com o sul	A Coréia do Norte adia reuniões familiares com o sul
Presidente chinês encontra vice -presidente indiano	Presidente chinês encontra os EUA Secretário de Estado
Os estoques de Taiwan fecham 0,56 pct mais alto	Estoques de Cingapura fecham 0,5 pct mais alto
Doze mortos em explosão de bombas no trem paquistanês	Pistãos matam nove no sudoeste do Paquistão: Polícia
A adolescente morta no leste de Londres Shereka Marsh foi baleada no pescoço, diz a polícia	Hackney Shooting: Teenager Shereka Marsh 'Bled até a morte depois de ser baleado no pescoço'
Toll Toll em Nairóbi Ataque sobe para 59	Toll de morte da violência do Egito aumenta para 638
Estoques de Cingapura fecham 0,5 pct mais alto	Os estoques de Taiwan fecham 0,34 pct mais baixo
A Rússia responde ao cessar -fogo da Ucrânia	A luta continua apesar do cessar -fogo da Ucrânia
A tempestade tropical Fernand se forma na costa do México	A tempestade tropical Fernand atinge o México, despeja a chuva
A Peace Ark da China sai para as Filipinas na quinta -feira	A China envia uma equipe de ajuda para as Filipinas
A polícia turca luta contra manifestantes, Clear Square	A polícia turca se chocou com os manifestantes pelo 2º dia
A França limpou para impor controverso 'imposto milionário'	Manila para aumentar a equipe de contra-terror
Irã dissidentes 'mortos no Iraque'	França perde influência na Europa
James Gandolfini morre com 51 anos	Nelson Mandela morre com 95 anos
China questiona a revisão do Japão da Constituição Pacifista	Austrália apóia a revisão da Constituição japonesa
quase nove milhões de pessoas em 'dívida severa'	Timebomb da dívida da Grã -Bretanha: nove milhões estão em 'dívida grave'
Egito prende o líder da Irmandade Muçulmana Badie	O Egito aparece para mais violência, como a Irmandade Muçulmana chama de 'marcha da raiva'
Atualizado - duas explosões próximas à linha de chegada da maratona de Boston	Relatório de duas explosões na linha de chegada da maratona de Boston
Doze mortos em explosão de bombas no trem paquistanês	Cinco mortos pela explosão de bombas na Índia Oriental
O ator Mickey Rooney morre com 93 anos	Ariel Sharon morre com 85 anos
A nova Guerra Fria	Uma nova Guerra Fria?
Onze morrem em confrontos em Trípoli do Líbano	Soldado e civil mortos em confrontos em Trípoli do Líbano
Brasil em negociações para contratar 6.000 médicos cubanos	Brasil contrata 4.000 médicos cubanos
As forças quenianas causaram colapso do shopping	Oficial diz que as forças quenianas causaram colapso do shopping
Quake poderoso atinge o leste da Indonésia	6.6 Mag Quake atinge o leste da Indonésia
motorista de trem espanhol acidentado mantido suspeita de homicídio negligente	motorista de trem espanhol mantido por suspeita de homicídio negligente
O Fed está pronto para começar o duplicação? Os mercados dizem que sim	O Fed está pronto para começar o grande cone? Os mercados dizem que sim
N.Korea cancela as reuniões da família	A Coréia do Norte adia reuniões familiares com o sul
Os cientistas cultivam "mini cérebros humanos" de células -tronco	Os cientistas crescem mini 'cérebro humano' no laboratório
Ex-Gov da Virgínia. Bob McDonnell, esposa acusada de corrupção	França ex-presidente Sarkozy acusada de corrupção
'S' Sadies 'de Cuba para obter o Prêmio UE 8 anos	'S Ladies' de Cuba para obter o Prêmio UE 8 anos depois
Boeing 787 Dreamliner Fire fecha Heathrow	Boeing 787 Dreamliner pega fogo no aeroporto de Londres Heathrow
Quatorze mortos no acidente de ônibus do Brasil	Dois mortos no acidente de paraquedismo do Arizona
Funcionário afegão diz que cerca de 2.000 pessoas desaparecem após o deslizamento de terra enterra uma vila do nordeste	Funcionário afegão diz que 2.000 desaparecidos após deslizamentos de terra
Snowden ofereceu asilo em três países	A última oferta de asilo de Snowden vem da Bolívia
O gabinete de Israel aprova a libertação do prisioneiro palestino	Israel aprova a liberação de 104 prisioneiros palestinos
EUA: Assad usou armas químicas nos rebeldes da Síria	Assad concorda em entregar armas químicas
Toll Toll em Bangladesh colapso em 194	Pelo menos 200 mortos no colapso do prédio de Bangladesh
Assalto ao funeral do Iraque, outros ataques matam 92	Assalto ao funeral do Iraque, outros ataques matam 96
Planos de guerra sírios supostamente atacam no Iraque, matando 57	Síria e Irã intensificam o envolvimento no conflito do Iraque
nove mortos na cidade de Oklahoma após os tornados atingidos	Aeroporto de Oklahoma City evacuado durante o tornado ...
Adolescentes israelenses desaparecidos na Cisjordânia	Israel encontra corpos de três adolescentes desaparecidos na Cisjordânia
Presidente lamenta a morte de Mandela	Passando World Lamens de Mandela
Israel concorda em liberar prisioneiros palestinos	Israel para libertar 104 palestinos em negociações de paz: PM
Diplomata palestino morre em Praga Blast	Enviado palestino morto em Praga Blast
Rogers contrata o chefe da Vodafone UK Laurence como CEO	Rogers nomeia o chefe da Vodafone UK como novo CEO
A UE acrescenta a ala militar do Hezbollah em sua lista terrorista	UE colocou o Hezbollah Military Wing on Terrorism Blacklist
Toll de mortal em atentados ao Líbano sobe para 47	Toll de mortal em atentados turcos sobe para 46
Duas explosões perto da embaixada iraniana em Beirute, 7 mortas	explosão perto da embaixada do Irã em Beirute
Israel expande subsídios aos assentamentos	Israel amplia subsídios a assentamentos
Bomber suicida mata nove policiais no norte do Iraque	Bomber suicida mata oito forças de segurança curdas no Iraque
Norte, Coréia do Sul concorda em primeiro reuniões	Norte, Coréia do Sul concorda em negociações
As ações de Cingapura abrem 0,31 % maior na segunda -feira	As ações de Cingapura abrem mais baixo na segunda -feira
SA Duo morto em ataque terrorista	Pontuações mortas em ataques do Iraque
Bomber suicida mata 23 recrutas do Exército iraquiano	Bomber suicida mata 13 recrutas do Exército iraquiano em Bagdá
Apoiante da Irmandade Muçulmana morta em Clash no Egito: Fontes de Segurança	Apoiadores da Irmandade Muçulmana, os oponentes se chocam em todo o país
As forças sírias atingiram a mesquita com bomba de barril, mate 5	Caçando pistas no bombardeio de Boston
Mandela na condição ‚‚ €, mas estável	Mandela na condição ė äėcritical, mas estável
Obama, Hollande Discuta a resposta ao suposto uso de armas químicas na Síria	Inteligência dos EUA ainda indecisa se as armas químicas foram usadas nos subúrbios de Damasco
O que dizem os papéis, novembro. 19, 2013	O que os papéis dizem setembro. 26, 2013
Wall Street Dips como impasse nas negociações de orçamento quebra -cabeças investidores	Wall Street sobe em aberto em dados, Washington Eyed
Os clientes surdos procuram Starbucks, dizem que são ridicularizados	Os patrocinadores surdos da Starbucks Sue, dizem que são ridicularizados
milhares evacuados no Moscow Metro Fire	milhares evacuados após o incêndio quebra no metrô de Moscou
NSA Whistleblower Edward Snowden deixa Hong Kong em vôo para Moscou	Snowden 'deixa Hong Kong para Moscou'
Os ataques aéreos matam 20 civis no Damasco da Síria	ataque aéreo mata um civil na Síria Deraa
38 mortos em chuvas, inundações repentinas no Paquistão	Três mortos no colapso do estádio Brasil
7 mortos por combatentes xiitas al-Houthi no norte do Iêmen	Pelo menos 5 mortos em conflito sectário no norte do Iêmen
Líbano Pins Hope na Conferência de Genebra II sobre a Síria	O Líbano espera que a Conferência de Genebra II inicie a solução política na Síria
Nadal, Djokovic para se encontrar em semifinais do Aberto da França	Djokovic, Nadal para disputar a semi -bengala francesa
Irã excluído das negociações de paz da Síria: ONU	Muitos mortos no ataque aéreo sírio
Nova incerteza sobre a falta de avião da Malásia	T.B Joshua revela o destino do avião da Malásia desaparecida
O vôo de Boston Marathon Bombing suspeitos terminou no caos	Imagens de suspeitos de bomba de maratona de Boston divulgados
A Líbia pede ajuda ao Conselho de Segurança da ONU	Kerry chama o Conselho de Segurança da ONU para agir na Síria
A polícia alemã frustrar	A polícia alemã frustrar
Evacuação das forças de incêndio da Califórnia	Os incêndios florestais da Califórnia fortalecidos pelos ventos como centenas são evacuados
Kerry chama o Congresso para encerrar o desligamento	O Congresso do Brasil aprova a legislação da Internet
As ações da China se aproximam da quarta -feira	Futuros de títulos do Tesouro da China Close Misted quarta -feira
Berlusconi disse para pagar as testemunhas de 'Bunga Bunga'	Berlusconi acusado de subornar testemunhas em julgamento de prostituição
EUA condenam explosões do Líbano	Nós condenam a libertação do prisioneiro afegão
Super Typhoon atinge as Filipinas	O tufão mais poderoso de 2013 atinge as Filipinas
As leituras obrigatórias da nota para segunda-feira, 2 de dezembro de 2013	As leituras obrigatórias da nota para terça-feira, 8 de outubro de 2013
prisão sobre a facada do soldado francês	França prende o homem na facada do soldado
Suspeitos de trama de trem do Canadá, cobranças rejeitadas	Os canadenses lançados no Egito, ainda não indo para casa
Quase 1.900 mortos na Síria durante as negociações de paz	1.900 mortos na Síria, enquanto as negociações de Genebra permanecem em um impasse
Os separatistas da Ucrânia Oriental pedem para se juntar à Rússia	Votos do Parlamento da Crimeia para ingressar na Rússia
Rudd jurou como novo PM australiano	muçulmanos se escondem como sectário ...
A Coréia do Norte bloqueia os trabalhadores do sul da zona industrial de Kaesong	A Coréia do Norte bloqueia os sul -coreanos da zona da fábrica
As rochas da lua indicam a esfera da Terra nascida de colisão	Ministro Indiano morto em colisão frontal
Obama ataca a Coréia do Norte como estado de Pariah	Obama ataca a Coréia do Norte como fraco, estado de pariah,
Abbas aceita renúncia do PM palestino	Abbas aceita renúncia de Rami Hamdallah
BlackBerry perde US $ 965M no Q2	BlackBerry perde US $ 965 milhões no 2º trimestre
Colômbia greve três vezes	Colômbia demais para a Grécia
Os ataques aéreos do Paquistão matam 32 militantes	O Paquistão diz que os ataques aéreos matam pelo menos 60 militantes
Casas de nível de Tornados em Oklahoma, 1 morto	Tornados atingiram Kan. , Okla. ; Nenhuma lesão relatada
O Egito se opõe fortemente à ação militar contra a Síria	reações à perspectiva de ação militar contra a Síria
Tony Abbott jurou como novo PM australiano	Tony Abbott jurou como Austrália PM
11 mortos no ataque da delegacia chinesa	9 mortos a tiros no ataque da delegacia de Xinjiang
Rebeldes pró-Rússia derrubou o avião da Malásia: Ucrânia	Rússia preparando contrapropossous sobre a Ucrânia
Nenhuma discussão com Jacarta em barcos: Abbott	Nenhum acordo nas negociações nucleares do Irã
Polícia da Nigéria proibia protestos sobre meninas seqüestradas	Nigéria revisando 'todas as opções' sobre meninas sequestradas
A GM lembra cerca de 60.000 Saturns para consertar turnos	A GM lembra cerca de 60.000 carros aura de Saturn
2 crianças morrem em Long Island depois de serem retiradas do vizinho, piscina	Crianças morrem na piscina de Nova York do vizinho
Nós acreditamos que a Síria provavelmente usou armas químicas	Nós acreditamos que o governo sírio usava armas químicas
Sanford tem a chance de debater Colbert Busch em S.C.	Os eleitores negros são a chave para uma vitória de Colbert Busch na Carolina do Sul
McCain em uma visita surpresa ao Afeganistão	Obama faz uma visita surpresa ao Afeganistão
O primeiro-ministro do Japão Abe escapa da lesão em colisão de cinco carros	PM japonês escapa da lesão em colisão de 5 carros
A oposição do Egito critica o discurso do presidente	O Partido da Oposição do Paquistão boicota as eleições presidenciais
Guerra da Síria vista arrastando por anos	O regime da Síria libera centenas de prisioneiros
Rússia diz que mísseis balísticos dispararam no Mediterrâneo	Israel diz que realizou o teste de mísseis conjuntos conosco no Mediterrâneo
Barack Obama cancela a reunião com Vladimir Putin sobre Edward Snowden	Barack Obama Drops se reunindo com Vladimir Putin sobre o caso de Ed Snowden
O vulcão entra em erupção na Indonésia -100.000 evacuados e os aeroportos fechados	A erupção vulcânica fecha 3 aeroportos
Egito ameaça a proibição da irmandade	Os militares do Egito assumem o controle da Irmandade Muçulmana, apoiadores
49 mortos, 148 feridos em ataques violentos no Iraque	2 mortos, 11 feridos em ataques no Iraque
Yanukovych da Ucrânia diz que não planeja renunciar	A oposição da Ucrânia exige a resignação de Yanukovich
Inundações repentinas matam 58 no Afeganistão Oriental	Feridas de bombas 16 no Afeganistão Oriental
Os investigadores investigam motivos do atirador de aeroporto de LAX	Os investigadores investigam motivos do atirador do aeroporto de Los Angeles
Margaret Thatcher, ex -Reino Unido. pm morto aos 87	Margaret Thatcher morre aos 87 anos
indignação após relatos emergem sobre menina indiana de 6 anos estuprada na escola	indignação depois da Indian Girl, 6 anos, estuprada em sua escola
Irmandade do Egito para segurar a "Marcha da raiva"	A Irmandade do Egito realiza comícios de raiva
O colapso do edifício mata 15 na Índia	colapsos de construção reivindicam vidas na Índia
Janet Yellen para se tornar a primeira mulher a liderar o Federal Reserve	O Senado dos EUA confirma Janet Yellen como chefe do Federal Reserve dos EUA
Nove mataram mais de 40 feridos em vários acidentes de ônibus na Alemanha	Vários mortos e pontuações feridos no acidente de ônibus da Alemanha
2 mortos quando mais tempestades agravam a Grã -Bretanha	Dois mortos como ferozes tempestades durante a noite da Grã -Bretanha
Poderes mundiais, Irã sob Rouhani Revive as negociações nucleares	As potências mundiais buscam raros progressos nas negociações nucleares do Irã
Tymoshenko pede que a UE tome fortes medidas na Crimeia	Crise da Ucrânia: Esta é a anexação de fato da Crimeia
A Alemanha nos convoca enviado sobre supostos espionagem da NSA	Alemanha convoca EUA Enviado sobre reivindicações de espionagem por telefone Merkel
Irmandade muçulmana banida no Egito	militar mantém vantagem no Egito
A calma desconfortável desce na praça da Turquia	Retornos calmos inquietos à Praça de Protesto da Turquia
Mais mortes esperadas na explosão do trem de petróleo do Canadá	Cinco mortos no Canadá Crash Train
Aimee Copeland recebe mãos biônicas	Bactérias que comem carne amputada Aimee Copeland usa novas mãos biônicas
O chefe de assuntos de Taiwan, do continente, completa	O chefe de assuntos de Taiwan, do continente
Filipinas adiadores comentam o ataque de Taiwan Fisher	O domínio contínuo de Bin Laden mostrado no ataque do shopping da Quênia
Marinheiros mortos na Índia Submarine Blast	Todos os marinheiros a bordo do submarino indiano 'temido morto'
multidões, dignitários se reúnem para o serviço memorial de Mandela	Obama tira 'selfie' no serviço funerário de Mandela
Toll de mortal de Bagdá Bombs aumenta para 19	Toll de mortal dos confrontos do Egito aumenta para 57
3 palestinos liberados das prisões israelenses	Dois canadenses libertados da prisão no Egito
Dois mortos enquanto os egípcios se chocam antes dos compostos da oposição	Dois mortos, enquanto os egípcios colidem antes dos comícios
Crianças e adultos feridos em um acidente de carro 'muito grave' fora da escola primária Novos, várias crianças ficaram feridas depois que um carro capotou perto de uma escola primária hoje.	Crianças e adultos feridos em acidente de carro fora da escola primária Novo nove feridos depois que o carro derruba perto da escola no País de Gales.
Obama pede restrições de israelenses, palestinos	Obama conhece israelense, negociadores palestinos
O principal ativista egípcio se entrega	O principal ativista egípcio se vira no Cairo
Rússia lança médico Greenpeace	O Tribunal Russo libera o médico do navio Greenpeace sob fiança
Naufrágios de aeronaves russas encontradas após um ano	A Rússia evacua a embaixada na Líbia após o ataque
17 mortos no ataque dos drones americanos na festa de casamento do Iêmen	nós. drone por engano mata 14 no comboio de casamento do Iêmen
Índice de fabricação da China a 11 meses baixa: HSBC	A China Manufacturing se expande em setembro
Série de atentados mata 15 no Iraque	Onda de atentados mata 50 no Iraque
PM sírio sobrevive ao ataque de bomba	PM sírio sobrevive ao ataque de bomba em capital
França para proibir concursos de beleza infantil	Facebook para testar o serviço de pagamentos móveis
Hoje na história, dez. 2	hoje na história, 23 de abril
Lord Palumbo oferece esperança para um relacionamento com seu filho James	Oscar Pistorius enviou avaliação mental: o que isso significa?
Três mulheres desaparecidas por uma década encontradas vivas em Cleveland Home	Três mulheres desaparecidas por uma década encontradas vivas em nós
A Nova Zelândia Botulismo Scare Gatses Global Recall	Recordação de gatilhos de susto de botulismo
Em segundo ataque, Pak Taliban Ataque Karachi Airport Academy	Segundo ataque no aeroporto de Karachi
Navios treinam para transporte de armas químicas sírias	A ONU adota resolução de armas químicas sírias
O número de mortos sobe para 29 no colapso do edifício de Mumbai da Índia	O número de mortos aumenta para 12 na Indonésia, colapso
Israel responde friamente ao resultado da eleição presidencial iraniana	na eleição presidencial do Irã e além
Os ataques aéreos matam 20 civis no Damasco da Síria	Ataque aéreo mata oito civis no Homs da Síria
Os extremistas assumem a responsabilidade pelos ataques do Níger	Grupo Militante Grego reivindica a responsabilidade por assassinatos de Golden Dawn
nós. Tribunal: Casamentos gays de Utah podem continuar	A luta de casamento gay da Califórnia pode continuar
O desemprego da zona do euro sobe para 12,1 %, um novo recorde	Desemprego de zona do euro atingiu o recorde de 12,2 % em setembro
Fromer Pakistani Exército Chefe Musharraf acusado em 2007 Bhutto Assassination	Ex -chefe do Exército do Paquistão acusado de morte de Bhutto
Briefing mundial | As Américas: Brasil: disputa na Bolívia derrama	Briefing mundial | As Américas: Brasil: as prisões começam no caso Fraud de Votação
Forças pró-russas entram na base naval ucraniana na Crimeia	As forças da Crimeia tempestadem a sede da Marinha Ucraniana
Corpo de Maldição de transporte sul -coreano ausente encontrado em campo	Desastre de Ferry de Sewol: Corpo de Tycoon de transporte sul -coreano encontrado
New Boko Haram Video reivindicações para mostrar alunos da nigeriana desaparecidas	O vídeo do Boko Haram disse para mostrar garotas nigerianas sequestradas
O ator Philip Seymour Hoffman encontrou morto	O ator dos EUA Philip Seymour Hoffman encontrou morto em Nova York
Tribunal do Egito sentenças 10 apoiadores da Irmandade até a morte - fontes	Tribunal do Egito sentenças 529 apoiadores de Morsi até a morte
Nenhuma atualização sobre a condição de Nelson Mandela	A condição de Nelson Mandela melhora
um morto em nós, edifício colapso	Seis mortos no colapso dos edifícios dos EUA
Ucrânia: Nove pessoas morrem em confrontos de Kyiv	Ucrânia pressionou os confrontos de Kiev
Os atacantes do shopping usaram 'menos é mais' estratégia	No Quênia, os atacantes usaram 'menos é mais' estratégia
Os islamitas nos protestam contra ataques de drones no Paquistão	Os islâmicos lideram protestos contra greves de drones nos EUA no Paquistão
Missões de vigilância voadora dos EUA para ajudar a encontrar garotas nigerianas sequestradas	Aeronaves de vigilância dos EUA Junte -se a Hunt para meninas nigerianas sequestradas
6.4 Quake de magnitude ataca a Indonésia	6.9 Quake de magnitude atinge as Ilhas Kuril da Rússia
Vice -orador enfrenta novas reivindicações de sexo	vice-presidente Nigel Evans re-preso
Três mortos em Crash na Praça Tiananmen	Crash SUV perto de Tiananmen Square mata 5
Button atinge o chefe da McLaren	Button atinge as críticas de Dennis
2 mortos, 2 feridos no tiroteio na escola de Nevada	Nevada: 2 Dead, 2 doeu no tiroteio no ensino médio
Toll Toll in India Building Collapse Hits 42	O número de mortos no colapso do edifício Goa aumenta para 17
Chefe da CIA visita Israel para negociações na Síria	Chefe da CIA em Israel para discutir a situação na Síria
Príncipe George é batizado no palácio de St. James	Príncipe George batizado em Londres
Monty Python para se reunir para o novo show	Monty Python para se reunir no palco
Ministro das Relações Exteriores italiano Confira com vice -presidente de Gana	O primeiro -ministro belga envia condolências às vítimas
Ministros das Relações Exteriores da UE para discutir como pressionar o Egito sobre o derramamento de sangue	Ministros das Relações Exteriores da UE para discutir o Egito na quarta -feira
O atirador que mantinha os bombeiros do subúrbio de Atlanta reféns agora mortos, diz a polícia	The Lede: Video: Gunman leva os bombeiros reféns na Geórgia
O estojo Bradley Manning-WikiLeaks se transforma em sentença	Caso do WikiLeaks de Manning se transforma em fase de sentença
Helicóptero policial colide com pub em Glasgow - várias baixas	Helicóptero colide com o telhado do Glasgow Club
Pesquisa do Egito: 98 % de votação 'Sim' para a nova Constituição	Egito segurando a votação importante na Constituição
Irã, seis potências globais assinam acordo nuclear de referência	Irã, as potências mundiais concordam
Citações de líderes, família no Mandela Memorial	Obama aperta a mão do Castro de Cuba no Mandela Memorial
A China diz que o número de mortos por gripes de aves sobe para 14	China abate as aves à medida que o pedágio da gripe aumenta para 6
China, Israel vote para aprofundar ainda mais a cooperação	China, Vow de Cingapura para aprofundar ainda mais a cooperação
Oposição de Bangladesh marcada para março em massa contra pesquisas	Oposição de Bangladesh definida para rali em massa
Em uma visita surpresa ao Afeganistão, Obama diz às tropas 'você me inspira'	Obama faz uma visita surpresa ao Afeganistão
Forças israelenses prendem 6 palestinos em ataques noturnos da Cisjordânia	Israel classifica os nativos de Jerusalém como não -cidadãos
As preocupações de Haia sobre a conduta 'da eleição do Zimbábue	Zimbábue: 'grave preocupações' sobre a eleição
Os estoques de Hong Kong terminam mais alto	Estoques indianos abrem mais alto
Dignitários prestam homenagem a Paul Desmarais	As estrelas prestam homenagem a James Garner
5 coisas que você precisa saber terça -feira	5 coisas que você precisa saber na sexta -feira
Voos do Southwest Grounds devido a falha no computador	Voos do sudoeste atrasados, cancelados após falha no computador
Embaixada do Vaticano na Síria atingida por morteiros	Embaixada do Vaticano na Síria atingida por argamassa; Sem ferimentos
Guia da Irmandade do Egito enfrenta novos assassinatos	O vice -líder da Irmandade do Egito
As ações da China fecham na sexta -feira mais alta	As ações chinesas fecham na segunda -feira
A Coréia do Norte bloqueia o acesso à zona industrial conjunta	A Coréia do Norte bloqueia o acesso à zona industrial -chave
pistoleiros 'mata 10 turistas' na Caxemira	Pistãos matam quatro no ataque da igreja do Quênia
Militantes islâmicos matam 9 turistas estrangeiros, 1 paquistanesa	pistoleiros matam 11 turistas estrangeiros no Paquistão
Blaze que matou 19 bombeiros agora continham	Arizona Wildfire que matou 19 hotshots agora continha
Presidente do Irã Rouhani pronto para negociações nucleares	Presidente iraniano pronto para negociações nucleares
As forças 'ocidentais' atacam a base militante islâmica na Somália	As potências ocidentais lutam para fazer amizade com Modi
Filipinas detém 11 chineses sobre taxas de pesca	Filipinas detém 11 pescadores chineses
Hong Kong preparado para uma grande manifestação de democracia no aniversário de entrega	Hong Kong preparado para uma grande manifestação de democracia
O general israelense diz que as forças do governo da Síria usavam armas químicas	Israel acusa a Síria de usar armas químicas
Bomber suicida mata 20 no Iraque	A Escola Primária Bomber Ataques no Iraque, mata 15
O grande incêndio começa no Secretariado JK em Srinagar	O incêndio começa perto da Secretaria em Srinagar
Cinco mortos no acidente de treinador belga	onze mortos no acidente de avião belga
O Musharraf do Paquistão ataca após a prisão	Musharraf do Paquistão em fuga após o pedido de prisão
Cinco crianças enterradas vivas em Bohol Landslide	Nove crianças morrem em ataque no ataque do Afeganistão
6 mortos por lava quente enquanto o vulcão da Indonésia entra em erupção	cinco mortos na erupção indonésia
pelo menos 11 mortos na Índia colapso do edifício	Pelo menos 66 mortos em explosões de bombas no Iraque
Príncipe George batizado, encontre os padrinhos	Príncipe George batizado em Londres
A eleição presidencial do Egito começa	Egito emite a lei eleitoral presidencial há muito esperada
O filho dos EUA evangelista se mata, filho do popular evangelista dos EUA, Rick Warren, se matou.	filho do popular evangelista dos EUA, Warren se mata
Pelo menos 45 mortos no acidente de trem da Espanha	Atualização 2: 78 mortos no desastre de trem espanhol
Soldado francês esfaqueado perto de Paris	Soldado francês esfaqueado no pescoço em Paris
Nicarágua, Venezuela oferece asilo a Snowden	Venezuela oferece "asilo humanitário" para Snowden
Agenda estratégica da China-UE 2020 para cooperação divulgada na 16ª cúpula da China-UE	Texto completo: Agenda estratégica da China-UE 2020 para cooperação
Parlamento italiano apóia o novo PM	O descarrilamento do trem mata 4 em Nova York
Os legisladores russos passam por uma nova lei restringindo a Internet	Rússia diz
A bomba suicida mata 4, prejudica 13 no Paquistão	Twitter bloqueia o conteúdo no Paquistão
Ucrânia Rebeldes 'Fue fortaleza oriental'	Ucrânia reivindica rebeldes liberados da fortaleza principal
Movimentos militares russos na Crimeia são a declaração de guerra, diz o PM ucraniano	Rally pró-Rússia, realizado em Simferopol, capital da Ucrânia
Super Typhoon Haiyan, mais forte da temporada, bate as Filipinas	Super Typhoon Haiyan se aproxima das Filipinas
A OTAN condena a repressão da Ucrânia	Bonds tailandeses melhores na região
explosão perto da embaixada do Irã em Beirute	duas explosões perto da embaixada iraniana em Beirute
China para investigar as exportações de vinho da UE	Christie Investigation aquece
As ações chinesas se aproximam da terça -feira	As ações chinesas se aproximam na quarta -feira
Bangladesh Building colapso Death Toll Hits 362	Bangladesh Factory colapsou a morte de um tolo de morte de 1.021
Nelson Mandela hospitalizado em estado grave com infecção pulmonar	Nelson Mandela hospitalizado com infecção pulmonar
Ariel Sharon em estado crítico	Hospital: a saúde de Ariel Sharon piora
O anúncio de demissão dos ministros do Partido Berlusconi lança a Itália em crise política	Os ministros de Berlusconi renunciam; Itália Gov 't em crise
Conan O 'Brien no jantar dos correspondentes da Casa Branca	Obama e O 'Brien lançaram suas versões de D.C. Jantar dos correspondentes da Casa Branca
PRÓXIMO	Irã: acordo nuclear a ser implementado em 20 de janeiro
um morto como mais de um milhão de protestos no Brasil	Um milhão de protestos nas cidades do Brasil
Suspeito de Boston Bomb, acusado; motivo religioso visto	Suspeito de bombardeio de Boston acusado na cama do hospital
UE condena a violência no Iraque	Casa Branca condena a violência no Egito
Mercados asiáticos misturados nos dados comerciais da China	Os mercados asiáticos caem nos medos do estímulo do banco central
A pessoa mais velha do mundo morre no Japão aos 116 anos	Jiroemon Kimura: a pessoa mais velha do mundo morre com 116 anos
Taxas de câmbio na Índia	Taxas de câmbio em Cingapura
O incêndio do Colorado destrói mais de 90 casas à medida que os ventos pioram	O Colorado Wildfire pode ser o maior destruidor de propriedades da história do estado
O ministro das Finanças da Cipriota, Michalis Sarris, renuncia	Ministro das Finanças de Chipre renuncia
A transcrição de partir o coração revela a indecisão quando a Ferry da Coréia do Sul afundou	Ferry da Coréia do Sul: a transcrição revela o pânico de evacuação
Toll Toll na Índia Temple Stampede sobe para 109	Toll de morte no templo de Madhya Pradesh Stampede sobe para 115
Man incendeia -se no National Mall de Washington.	O homem se chama fogo no National Mall, levado para o hospital
Dois mortos na explosão de Karachi	4 mortos nas explosões do Paquistão
Putin envia a lei constitucional federal na Crimeia, a integração da Rússia para a Duma State Duma	Putin assina um tratado para a Crimeia se juntar à Rússia
Progresso global observado no fim da pena de morte	Diplomata Irã: Progresso que está sendo feito em palestras em nível de especialista
Terremoto de 6,3 magnitude atinge a Ilha da Indonésia	Terremoto de 6 ataques de magnitude
Presidente XI lamenta Mandela	Presidente lamenta a morte de Mandela
nós, afegão Govt para manter conversas de paz com o Taliban	O Paquistão mantém conversas diretas com o Taliban
suspeito preso em ataque ao soldado francês	homem preso por ataque ao soldado francês
O chefe de assuntos de Taiwan, do continente, encontra o prefeito de Taipei	O chefe de assuntos de Taiwan, do continente
nós 'profundamente perturbados' pela morte de ativistas chineses	nós 'profundamente perturbados' pela morte de dissidente chinês
Notícias de terrorismo e conflito israelense-palestino (22 de janeiro de 28 de 2014)	Notícias de terrorismo e conflito israelense-palestino (31 de julho, 6 de agosto de 2013)
A maioria das vítimas de acidente de ônibus de fogo identificou	38 corpos de vítimas identificados
Os estoques de Tóquio fecham 0,75pc	Os estoques de Tóquio fecham 0,49pc mais baixo
nós aguardam julgamento do Tribunal Superior sobre o casamento gay	arca. Supremo Tribunal novamente suspende o casamento gay
'É tarde demais ou muito cedo para intervir na Síria'	Chefe da ONU: os inspetores precisam de 4 dias para concluir a investigação na Síria
A polícia grega prende alemão por suspeita de espionagem	Israel Press Bemoans Preço das negociações
As ações chinesas abrem mais alto - 2 de abril	Estoques chineses abrem na quinta -feira inferior
05: 26 Bo Xilai condenado por corrupção	Bo Xilai indiciado por corrupção
A equipe de negociação nuclear do Irã sai para o Cazaquistão	A busca nuclear do Irã 'custou a Teerã mais de US $ 100 bilhões'
Pedidos de fábrica dos EUA em queda de 0,7 PCT em janeiro	Ordens de fábrica alemã se recuperam em janeiro
4 estrangeiros entre 9 mortos no ataque de Kabul Hotel	estrangeiros entre mortos no ataque de hotel de Kabul
Kerry na Indonésia para falar sobre mudanças climáticas	Kerry alerta a Indonésia sobre a mudança climática
O Irã 'nunca vai construir armas nucleares'	Irã, poderes mundiais prometem novas negociações nucleares
A Rússia alerta de catástrofe se o reator da Síria atingido pelos EUA batida	A Rússia alerta de "catástrofe" se a N Coréia reiniciar o reator
homens armados cercam o Ministério das Relações Exteriores da Líbia para pressionar as demandas	homens armados cercam o Ministério das Relações Exteriores da Líbia para aumentar as demandas
Mortes confirmadas após o helicóptero colidir com o pub escocês	Helicóptero policial colide com pub escocês
Tolho de Typhoon Toll sobe para 3633	O número de mortos egípcios aumenta para 638
O presidente de Uganda assina a conta anti-gay	O presidente de Uganda assina duras leis anti-gays
O parlamento russo permite que Putin use militar na Ucrânia	A Rússia não tem intenção de incorporar o sudeste da Ucrânia: FM
Bradley Manning absolvido de ajudar o inimigo	O soldado do WikiLeaks Bradley Manning absolveu de ajudar o inimigo
Toll de mortal da violência do oeste da China sobe para 35	10 mortos como violência insurgente retorna ao Paquistão
nós, Rússia para pressionar por novas negociações de paz na Síria	A Rússia duvida de meados de novembro para as negociações de paz na Síria
G7 'para intensificar as sanções da Rússia'	Ucrânia teme invasão russa
drone atinge um seminário no Paquistão	A Greve dos Drones dos EUA mata 8 no noroeste do Paquistão
O avião das bandas de rock faz o pouso de emergência no Ill.	O avião das bandas de rock faz o pouso de emergência no Ill.
A Malásia está data para as eleições marcantes	Malásia definida para eleições gerais marcantes
A Irmandade do Egito perde o controle quando a raiva ferve	A Irmandade do Egito exige o 'Dia da Raiva'
Primeiro Ministro Russo no segundo dia da visita à Crimeia	A Rússia alerta contra o estabelecimento de pré -condições para a Síria
Caça a mais para mais pings na falta de busca de avião da Malásia	Australian Ship Arras
Todos os pistoleiros em ataque ao palácio presidencial afegão mataram	Argélia: Belaid diz que continuará a campanha presidencial
Juiz Oks que alimenta os presos da Califórnia	nós. O juiz aprova os presos californianos que alimentam a força no Strik da Hunger
A violência de gangue mata 16 na prisão venezuelana	Dezesseis mortos na prisão da Venezuela
6.7 Terremoto de magnitude Jolts Taiwan: CENC	7.7 Terremoto de magnitude atinge o SW Paquistão
pontuações mortas em conflitos frescos do Egito	Pelo menos 64 mortos em todo o país em confrontos do Egito
ONU especialistas em armas químicas para visitar a Síria	EUA dizem armas químicas usadas na Síria
Os bombeiros batalham no incêndio florestal na China SW	Bombeiros lutando contra o incêndio em Hokianga
Os palestinos se lembram de Mandela como uma inspiração	3 palestinos liberados das prisões israelenses
Mortes militares dos EUA no Afeganistão em 2.153	nós. mortes militares no Afeganistão
Israel, os palestinos buscam outra reunião na segunda -feira: EUA oficial	Palestinos: não queremos que a missão Kerry falhe
Síria concorda em entregar armas químicas	Síria FM: Vamos parar de produzir armas químicas
A tempestade tropical Karen tem como alvo a costa do Golfo dos EUA	Tempestade tropical Karen preparou para atingir o desembarque
Explosões Mate 29 fora de duas mesquitas na Trípoli do Líbano	Blasts matam 27 fora de duas mesquitas na Trípoli do Líbano
Pit Bull Dog mata a menina em Blackburn	cachorro mauls, menina até a morte em Blackburn
Casal de Roma no tribunal sobre ‚äėlonde Girl‚ äô	Casal da Roma acusado de sequestrar 'Anjo Loiro'
A China promete intensificar a luta contra o Dalai Lama	A China promete continuar lutando contra o terrorismo
ataques aéreos do Paquistão no norte do Waziristão 'Mate 80 militantes'	Paquistão: dezenas mortas em greves em militantes
Seamus Heaney, poeta irlandês de solo e conflito, morre em 74	Seamus Heaney, poeta irlandês e vencedor do Nobel, morre em 74
O Egito se afasta do plano para dissolver a Irmandade Muçulmana	Mesquita invadiu como os generais do Egito planejam proibir a Irmandade Muçulmana
KL compartilha mais fácil no meio da tarde	As ações da KL continuam a tendência de alta no meio da tarde
Os islâmicos de Bangladesh se reúnem contra os blogueiros ateus	Os islâmicos de Bangladesh se reúnem para exigir ação contra blogueiros ateus
Crash of Malaysia Airlines Flight MH17 no leste da Ucrânia	Malaysia Airlines acidem na fronteira da Ucrânia-Rússia
Bomber suicida mata 13 no restaurante no centro da Somália	Bomber suicida mata pelo menos 4 em Cabul
Anthony Weiner desliza para o quarto lugar em uma nova enquete	Weiner cai para o quarto lugar na nova pesquisa de prefeito de Nova York
O primeiro -ministro japonês irrita os vizinhos em oferecer ao Santuário da Segunda Guerra Mundial	Dois ministros japoneses visitam o santuário de Yasukuni
Forças iraquianas, militantes lutam pela refinaria de petróleo	Forças iraquianas, militantes lutam pela refinaria do Iraque
Milhares protestam contra o orçamento de austeridade em Portugal novo	Milhares protestam contra a austeridade na Itália, Portugal
Blog ao vivo da Copa do Mundo: Brasil vs. Alemanha	Copa do Mundo LIVE: França 0-0 Alemanha
Os ataques aéreos israelenses agitam Gaza enquanto o Hamas persiste com ataques de foguetes - vídeo	Israel libra Gaza como Hamas Flexes Rocket Reach
As primeiras lojas de maconha da América abertas no Colorado	Os primeiros varejistas de maconha licenciados pelo estado do mundo abrem portas no Colorado
A tragédia do canal como nadador de captação de recursos morre a uma milha da costa francesa, uma mulher que morreu enquanto tentava nadar no Canal da English para instituições de caridade desabou a apenas 1,6 km da costa francesa.	Channel Tragedy 'One Mile From End' Uma mulher britânica que morreu enquanto tentava nadar no Canal da English para instituições de caridade desabou a apenas 1,6 km da costa francesa.
4 mortos após o incêndio da polícia do Camboja contra manifestantes	três mortos como a polícia do Camboja abriu fogo contra manifestantes
A Índia acusa a China de cruzar a fronteira de fato	Senado, Câmara de Casa em Colisão sobre Dinheiro de Fronteira
Mulher do Sudão grávida que se casou com um cristão condenado à morte por 'apostasia'	O Sudão libera a mulher cristã condenada à morte por apostasia
A esposa do diplomata principal dos EUA Kerry correu para o hospital	Secretário de Estado dos EUA John Kerry, a esposa correu para o hospital
Os conservadores varrem para a vitória das eleições da Austrália	Oposição conservadora vence a eleição australiana
Hassan Rouhani ganha a eleição presidencial do Irã	Maduro vence a votação presidencial venezuelana
O governo da Índia rejeita a proposta de fechar as bombas de gasolina à noite	O ministro do petróleo da Índia criticou o plano para fechar os postos de gasolina à noite
Kerry perseguindo 'estratégia silenciosa' no processo de paz do Oriente Médio	Kerry conhece os líderes israelenses para empurrar a paz no Oriente Médio
maratona de rock bastões gêmeos	Duas bombas atacam a maratona de Boston
Mulher prevista a morte da criança que uma mulher foi presa sob custódia acusada de assassinato depois que uma menina de oito anos foi encontrada morta em um bloco de apartamentos.	Mãe manteve a morte da filha que uma mãe foi presa sob custódia acusada de assassinato depois que sua filha de oito anos foi encontrada morta em um quarteirão de apartamentos.
A Coréia do Norte diz para reiniciar o reator nuclear	A Coréia do Norte oferece palestras: o complexo pode reabrir
as ações se aproximam mais à medida que o setor de serviços melhora	As ações são mais altas à medida que o setor de serviços americanos melhora
Tribunal Egípcio considera Mubarak ‚äôs	O Tribunal do Egito ordena a libertação de Mubarak
O homem -bomba mata oito, feridas 13 na capital afegã - Polícia	A bomba suicida mata 4 na cidade antiga da capital síria
Israel para não liberar prisioneiros palestinos	autoridades israelenses Raze Raze Palestinian Home em Arraba
Destaques do acordo EUA-Rússia em armas da Síria	Acordo de alcance dos EUA-Rússia sobre armas da Síria
Israel aprova a liberação do primeiro grupo de prisioneiros palestinos antes das negociações de paz	Israel aumenta os assentamentos, alimentando os medos palestinos
Suspeito de bombardeio de Boston acusado na cama do hospital	Uma semana depois: Boston homenageia vítimas de bombardeio; suspeito incapaz de falar
Mais chuva dificulta o resgate indiano de inundação	US TURIST GANGED CLOUSED no norte da Índia: Polícia
Forte tempestade de inverno atinge os EUA nordeste	O clima de inverno explode os EUA nordeste
Uma olhada em grandes ataques terroristas na África Oriental	O Conselho de Segurança da ONU bate ataque terrorista mortal na capital queniana
Sobrevivente podia ver a pista através do buraco na cauda	CASH
A Rússia responde ao cessar -fogo da Ucrânia	Chipre investiga ativos da Ucrânia
O Banco Central Europeu mantém as taxas inalteradas	O Banco Central Europeu mantém a taxa de juros em 0,5 %
Líder de camisa vermelha não se opõe ao exército	Spat: Pequim para não enviar exército
Kim Jong-un executou seu tio 'pior que um cachorro'	Nkorea executa Kim Jong Un 'tio
Apoio colorido na Copa do Mundo no Brasil	Merkel para participar da final da Copa do Mundo
A Rússia elogia a idéia de prestar assistência de direitos à Ucrânia	Rússia detém suspeitos militantes islâmicos em Moscou Raid
O Fatah endossa a recusa em reconhecer Israel	Paquistão denuncia o último ataque de drones
O ataque mata 12 no Afeganistão	OTAN: 3 tropas mortas no ataque do Afeganistão
As ações chinesas fecham mais baixa na segunda -feira	As ações chinesas se aproximam na quarta -feira
Mandela permanece no hospital	Mandela permanece em 'terapia intensiva'
Os membros da equipe da Ferry da Coréia do Sul estão julgando	Sewol Ferry Crew enfrenta julgamento
Aliado do PM da Geórgia para se tornar presidente - pesquisa de saída	Ally of Georgia Bilionaire PM para ser presidente da exposição
Egito vota na nova Constituição	egípcios votando em nova constituição
Briques de notícias mundiais, 14 de junho, 14 de junho	World News Briefs, compilado 1 de maio
A Greve dos Drones dos EUA mata seis funcionários do Paquistão	nós. drone mata 4 militantes no Paquistão
O Vietnã detecta sinais do plano ausente	A China expande a área de busca por um avião ausente
66 Falta após o barco afunda da Malásia	61 pessoas desaparecidas depois que o barco afunda fora da Malásia ocidental
Sete explosões de bombas matam 27 pessoas na capital iraquiana Bagdá	Bombas de carro matam 26 na capital iraquiana
A oposição da Síria pressionou para participar de negociações	A oposição da Síria faz frustração com os apoiadores internacionais
Cricket-Inglaterra contra a Austrália Quarto placar de teste	Cricket-Inglaterra 155-4 contra Austrália, quarto teste-chá
Aniversário da RPDC para ser comemorado no Peru	Curiosity Rover comemora 1 ano em Marte
poderoso 7,6 terremoto atinge Salomões	poderoso 6,9 Quake atinge a costa da Califórnia
Índia tinta: Imagem do dia: 21 de maio	Índia tinta: Imagem do dia: 16 de janeiro
Chasers de tempestades morrem em tornado de Oklahoma	caçadores de tempestades entre os mortos em Oklahoma
pontos de vista: Armar os rebeldes sírios	Estados da UE para decidir sobre armar rebeldes sírios
O FMI corta a previsão de crescimento mundial para 2013, 2014	A zona do euro corta previsão de crescimento para 2014
O líder da Austrália demitiu o voto de liderança SNAP	O primeiro -ministro australiano Gillard demitiu a votação de liderança
Obama condena a violência do Egito, cancela exercícios militares	Paquistão condena a violência no Egito
5 mortos na Índia colapso do edifício	Toll Toll in India Building Collapse Hits 42
A Rússia diz que os mísseis detectados disparados do mar do Mediterrâneo	Rússia diz que mísseis balísticos dispararam no Mediterrâneo
Mickey Arthur disparou como treinador da Austrália	Darren Lehmann substitui Mickey Arthur como treinador de cinzas da Austrália
MH17 Caixas pretas chegam à Grã -Bretanha para análise	CASH MH17: Caixas pretas chegam ao Reino Unido da Ucrânia para análise
Os estudantes islâmicos se chocam com a polícia da Universidade Al-Azhar do Cairo	Pelo menos um aluno morto em confrontos com a polícia no Cairo
Argentina declara o luto por vítimas de inundações	Os pais exigem formas comuns para admissão de berçário
O envenenamento alimentar mata pelo menos 20 crianças na Índia	O bombardeio de Bagdá Cafe mata pelo menos 38
batizado de príncipe uma mistura de antigos e novos	Quando é o batizado do príncipe George? Plano de batismo, padrinhos do bebê real e todos os detalhes
O que dizem os documentos, 20 de maio de 2013	O que dizem os papéis, novembro. 19, 2013
China Yuan enfraquece para 6.1651 contra US $ terça -feira	China Yuan se fortalece para 6.1767 contra o USD
Austrália rejeita a solicitação da Qantas por empréstimo de US $ 2,7 bilhões	Austrália rejeita a solicitação de empréstimo Qantas
Investigadores da Malásia concluem o voo seqüestrado	Malaysia Airlines: os investigadores concluem o voo MH 370 sequestrado
Google libera o telefone Nexus 5 com kit kat	Resultados da pesquisa do Google Redesigns em PCs
Egito condenam 26 sobre Suez Canal Terror Plot	O Tribunal do Egito absolve 155 presos após protestos do Cairo
A bombardeio destinado ao Hezbollah atinge o sul de Beirute	Explosão atinge a área de Hezbollah ao sul de Beirute
Kerry: rei saudita apoia o empurrão israelense-palestino	John Kerry diz
Putin inimigo Navalny Defiant enquanto julgamento é aberto na Rússia	O líder de protesto Navalny é julgado na Rússia
Egito: A Irmandade Muçulmana exige 'levante'	AMB egípcio: a Irmandade Muçulmana deve 'ingressar no processo'
As leituras obrigatórias da nota para sexta-feira, 6 de dezembro de 2013	As leituras obrigatórias da nota para terça-feira, 8 de outubro de 2013
nós. , aliados para adicionar sanções contra a Rússia sobre a Ucrânia	UE dá um tapa em novas sanções sobre a Rússia sobre a Ucrânia
Bombas de carro matam pelo menos 16 na capital iraquiana	Bombas de carro matam pelo menos 47 na área de Bagdá
Alerta de viagem em problemas dos EUA sobre a ameaça da Al Qaeda	Us Probles Global Alert, citando ameaças da Qaeda
As fábricas que foram executadas na cooperação coreana ficam em silêncio	Coréia do Norte e Sul quebra seu silêncio com conversas
Palácio presidencial de ataque do Taliban no Afeganistão	Todos os pistoleiros em ataque ao palácio presidencial afegão mataram
Premier chinês conhece vice -presidente indiano	O Hezbollah pede eleger um novo presidente libanês
A Arábia Saudita se senta no Conselho de Segurança da ONU	A Arábia Saudita rejeita o assento no Conselho de Segurança da ONU
Crash para treinador do sul da Itália mata 38	O número de mortos aumenta para 39 no acidente de treinador da Itália
Presidente da Argélia na França para exames médicos	Presidente da Argélia na França para exames médicos após derrame menor
3 mortos, 10 inseridos em ataque à Igreja queniana	Gunidos matam dois em ataque à Igreja queniana
Os islamitas ainda mantêm cerca de 30 reféns, enquanto o stoff de shopping do Quênia continua	O número de mortos aumenta à medida que o cerco do shopping do Quênia continua
Manchester City ganha o segundo título da Premier League em três anos	Manchester City vence o título da Premier League inglês
Greve de drones nos EUA mata 11 no Paquistão	O drone dos EUA mata 16 no Paquistão
Corpos de vítimas de acidente de MH17 voam para a Holanda	MH17 Dead voou de volta para a Holanda
Policial do Egito morto no ataque do Sinai	Soldados egípcios mortos no ataque do Sinai
Extensão provavelmente para negociações nucleares do Irã	O petróleo desliza abaixo de US $ 108 à frente das negociações nucleares do Irã
O fogo mata 38 na instituição psiquiátrica russa	38 Temido morto no incêndio do Hospital Psiquiátrico Russo
5 snowboarders mortos em colo. Avalanche identificada	5 snowboarders mortos no Colorado Avalanche
Ordens do Egito prisão do chefe da irmandade Badie	Egito prende o líder da Irmandade Muçulmana Badie
A Rússia alerta que não pode assinar Landmark On Arms Tratado	ONU se fecha no tratado de armas marcantes
Didier Reynders na Síria	Dia de Obama: horário nobre na Síria
O Google começa	O Google lança balões que causam a Internet
Coréia do Norte: os especialistas pedem diálogo, e dizem que a China deve desempenhar um papel	A Coréia do Norte corta os últimos laços com o sul, exceto o parque industrial conjunto
Estoques da China abrem na segunda -feira superior	As ações da China se aproximam da quinta -feira
Obama adia a visita da Malásia para lidar com o desligamento do governo	Obama adia a viagem na Ásia sobre o desligamento do governo
Sony Xperia Z2 e Nokia ‚äôs x Série revelada	O tribunal ordena a proibição política na Itália, äôs berlusconi
Cannes Hotel Raid Nets, 40 milhões de gemas	jóias que valem jóias, 40m roubadas em Cannes
A oposição da Ucrânia pede a trégua contínua	A oposição da Ucrânia pede mais impasses
Os manifestantes pró-russos invadiram a nova delegacia de polícia no leste da Ucrânia	Os manifestantes pró-russos assaltam a delegacia de polícia na Ucrânia, pois Kiev pede à ONU. acima da agitação
Novo coronavírus provavelmente pode ser passado uma pessoa para a pessoa- que	quem: novo vírus provavelmente pode passar a pessoa para a pessoa
Estoques chineses abrem na segunda -feira superior	As ações chinesas fecham na segunda -feira
Mandela de volta ao hospital em ‚‚ äėserious, mas estável, condição	Nelson Mandela retorna ao hospital em 'äėserious, mas estável, condição
24 mortos 77 feridos no bombardeio de mesquita do Iraque	Pelo menos 18 mortos no bombardeio da mesquita do Iraque
East Harlem Explosion Death Toll Rises	México Storm Death Toll continua a subir
Pesquisa currículos para o jato da Malásia	Pesquisa currículos para desaparecer o jato da Malásia
O primeiro -ministro ucraniano renuncia em meio a protestos	O primeiro -ministro britânico condena o assassinato de adolescentes
Royal Hoax DJ toma medidas contra a estação	Base dos Bombas do Talibã no Afeganistão
Reino Unido Sky News Cameraman morto no Egito	Sky News Cameraman morto em confrontos do Egito
Arsenal v Stoke City, ao vivo!	Tottenham contra Manchester City, ao vivo!
Os indonésios queimam bandeiras australianas sobre relatórios de espionagem	A Indonésia enfrenta o embaixador da Austrália em relatórios de espionagem
Notícias e mercados de negócios: como aconteceu, 17 de abril de 2013	Notícias e mercados de negócios: Como aconteceu, 20 de junho de 2013
O trabalhador do zoológico morre após o ataque do tigre	Professor de origem indiana morre após ataque na Nova Zelândia
Ariel Sharon, ex-primeiro-ministro israelense, morre após coma de oito anos	Ariel Sharon morre com 85 anos: o ex-primeiro-ministro israelense falece após a falha de órgãos após o coma de oito anos
China se preparando para o conflito de Diaoyutai: especialista	China em busca de especialistas em contraterror estrangeiros
Votos do gabinete de Israel na libertação do prisioneiro palestino	Israel aprova a liberação de prisioneiros palestinos, negociações de paz
Os acusadores do prefeito de San Diego Bob Filner	Trabalhador: prefeito de San Diego fez comentários sugestivos
Alemanha para assinar a declaração do G20 na Síria	A Alemanha apóia a declaração do G20 sobre a Síria um dia de atraso
Irã, as potências mundiais começam a nova rodada de negociações nucleares	Irã, poderes mundiais prometem novas negociações nucleares
36 militantes mortos em ataques afegãos	35 militantes mortos em ataques afegãos: oficial
10 coisas para saber	10 coisas para saber para terça -feira
Julgamento do Oscar Pistorius: adiar até terça -feira	Avaliação psiquiátrica de Oscar Pistorius para começar segunda -feira
As conversas na Ucrânia continuam em meio a uma crescente agitação	Ucrânia enfrenta mais violência à medida que o ultimato se aproxima
Israel pode libertar prisioneiros palestinos na próxima semana	Israel para libertar prisioneiros palestinos sobre as negociações de Kerry
Bombas na estrada matam 5 no Afeganistão	Governador provincial de feridas na estrada no norte do Afeganistão
A tempestade tropical Karen tem como alvo a costa do Golfo dos EUA	Tempestade tropical Karen enfraquece quando se aproxima dos EUA Costa do Golfo
Manifestantes se chocam com a polícia na Turquia	Os manifestantes se chocam com a polícia de Riot em Kiev
O ator da Coronation Street, Michael Le Vell, liberou as reivindicações de estupro infantil	A estrela da Coronation St, Le Vell, limpou o ator da Coronation Street Michael Le Vell, não foi considerado culpado por um júri de crimes sexuais infantis.
trabalhadores mortos na Índia colapso do edifício	76 mortos no colapso do prédio de Bangladesh
Seis mortos em Drone Strike em N Waziristan	12 mortos em acidente de ônibus no Paquistão
Nove crianças morrem em ataque no ataque do Afeganistão	10 morrem em ataques no Afeganistão
20 mortos em ataque de bomba na base paquistanesa	8 soldados mortos em ataque de bomba no Paquistão NW
Coréia do Norte dispara três mísseis de curto alcance	n. Coréia dispara mísseis de curto alcance
Bursa Malaysia Atualização: 11h30	FTSE Bursa Malaysia Atualização: 17:00
17 funcionários do governo mortos no bombardeio de ônibus do Paquistão	Pelo menos 78 mortos no bombardeio da igreja do Paquistão
carro bomba mata 37 no noroeste do Paquistão	A bomba mata três no noroeste do Paquistão
A Malaysia Airlines perde contato com o avião transportando 239 para Pequim	O avião da Malaysia Airlines desaparece em voo para Pequim
A Microsoft diz para cortar até 18.000 empregos	Microsoft para cortar 18.000 empregos em revisão
Primeiro -ministro líbio apreendido por homens armados	Primeiro -ministro líbio relatado sequestrado por homens armados
Os malaios votam em pesquisas por estabilidade ou mudança	Eleições da Malásia: os malaios votam com o poder em jogo pela primeira vez
China yuan enfraquece para 6.1705 contra USD	China Yuan se retira para 6.1729 contra o USD quarta -feira
O Google lança balões que causam a Internet	O Google começa
O fogo destrói a cidade tibetana antiga na China	O incêndio destrói a cidade tibetana na China
Yahoo concorda em comprar o Tumblr por US $ 1,1 bilhão em dinheiro	Yahoo para comprar o Tumblr por US $ 1,1 bilhão
A Índia começa a votar nas maiores eleições do mundo	Os eleitores da Índia iniciam o mundo, a maior eleição
carro bomba no norte da Síria mata pelo menos 12	Os ataques aéreos sírios matam pelo menos 18 em Aleppo
Philippine Quake Death Toll Salts para 73	O número de mortos nas Filipinas Salta para 85
A polícia de Bangladesh prende o blogueiro ateu proeminente	Polícia de Bangladesh prenda 3 blogueiros ateus
Os índices de estoque Shenzhen fecham na segunda -feira	Os índices de estoque Shenzhen fecham mais baixo - out. 31
Filipinas, rebeldes atingem o negócio de compartilhamento de riqueza	Filipinas e rebeldes alcançam 'acordo de riqueza'
Senador do Texas ainda Filibustering Abortion Bill	O senador do Texas Filibusters contra a conta do aborto
Margaret Thatcher, ex-premier do Reino Unido, morre aos 87 anos	Margaret Thatcher morre aos 87 anos
Líderes turcos pedem intervenção Int no Egito	FM turco bate a intervenção militar no Egito
termina a pesquisa por falta de asilo-requerentes	Pesquisa estreitou -se por um homem desaparecido
Os manifestantes pró-russos invadiram a nova delegacia de polícia no leste da Ucrânia	Os manifestantes pró-russos Storm Storm Donetsk Promotor's Office no leste da Ucrânia
Presidente ucraniano ordena cessar-fogo de 7 dias no leste	O presidente do Uganda, Museveni, concorda em assinar a conta do Anti-Gays
Pelo menos 12 mortos em Washington ...	Pelo menos 150 mortos como forte terremoto atinge o sudoeste do Baluchistão
Troféu dos Campeões da ICC: Índia vs África do Sul	Champions Trophy: India contra South Africalive
Papa Francisco para fazer a primeira visita à Terra Santa	O papa Francisco anuncia a primeira visita à Terra Santa
A Suprema Corte assume ações afirmativas no caso de proibição de Michigan	Supremo Tribunal para ouvir o caso de ação afirmativa de Michigan
manchetes nos principais jornais iranianos em 30 de setembro	Manchetes nos principais jornais iranianos em 21 de novembro
Bomber suicida mata 15 na Somália Central	Explosão suicida na Somália Central mata 15
Ciclone Folhas Trilha de destruição na Índia	A evacuação de phailina de ciclone manteve vivos os aldeões indianos
Talibã mata 15 policiais no Afeganistão Ocidental	O drone dos EUA mata dois no leste do Afeganistão
milhares de reúne para apoiar o governo da Tunísia em apuros	milhares se reúnem para apoiar o governo islâmico na Tunísia
O príncipe Harry presta homenagem à guerra dos EUA mortos	Os presidentes dos EUA prestam homenagem a Mandela
O governador do distrito afegão defende o Taliban	Político afegão defende o Taliban
Mandela da África do Sul levada ao hospital	Nelson Mandela levada para o hospital
Atualizado - duas explosões próximas à linha de chegada da maratona de Boston	Duas explosões na linha de chegada da Maratona de Boston
Stuntman se prepara para atravessar o Grand Canyon na corda bamba	Wallenda para atravessar o desfiladeiro perto do Grand Canyon no Wire
pelo menos dois mortos no confronto do sul do Egito	Pelo menos 18 mortos no norte da estação de trem do Cáucaso
Três mortos, 21 feridos em dois contratempos de estrada	3 mortos, 24 feridos na explosão do treinador da NW China
Cameron do Reino Unido seriamente preocupado com Gibraltar / Spain Row	Cameron 'seriamente preocupado' com os eventos de Gibraltar
Ion de tempestade de inverno: estado por estado ...	Storm de inverno Janus: Estado por estado ...
Principais candidatos na eleição presidencial do Afeganistão	A votação termina no Afeganistão, eleições presidenciais e municipais
Bombas de carro matam nove na província de Bagdá	Bombas de carro matam 54 nos distritos de Shi 'Ite de Bagdá
China Yuan se fortalece para o novo alto contra o USD	China Yuan se fortalece para 6.1542 contra USD
cadáveres de 53 homens encontrados ao sul de Bagdá	Oficiais iraquianos: 50 corpos encontrados ao sul de Bagdá
soldados sírios mortos em ataque de bomba	Soldados mortos por carro -bomba do Líbano
Os rebeldes provavelmente derrubaram o jato da Malásia 'por engano' - EUA funcionários	Os rebeldes provavelmente derrubaram o jato 'por engano'
Pacquiao sai para Samar ajudar as vítimas do tufão	Boxing: Pacquiao passa a noite com vítimas de tufões filipinos
Ataques de bomba matam 20 nas áreas cristãs de Bagdá	Bombas matam 35 na área cristã de Bagdá
A China define a data do teste bo xilai	Julgamento da China Bo Xilai no quarto dia
A ONU lança US $ 300 mil. apelo para as Filipinas	Reino Unido envia um navio de guerra para ajudar as Filipinas
Os muçulmanos se preparam para o início do Ramadã	muçulmanos oram pelo fim das divisões
Tornados violentos atingiram Oklahoma City, st. Louis ...	Tornado de milha de milha vai em direção a Oklahoma City
Japão luta jatos contra aviões militares russos	Separatistas no avião militar da Ucrânia, vários mortos
Milhares de britânicos afirmam Dole na Alemanha	Milhares de Amsterdammers vestidos brancos março para MH17
Lei de Cuidados de Saúde de Obama em uma encruzilhada	Lei de Cuidados de Saúde de Obama em uma encruzilhada
Egito militar expulsa o presidente Morsi	Irã tenta impedir greve militar na Síria
suspeito dos EUA Drone Strike mata 5 no Paquistão	Suspeita -se dos alvos de drones nos EUA
Obama para se inscrever no Obamacare	Obama visita o tornado atingido Oklahoma
15 mortos em ataques no Iraque, bomba no campo de futebol	46 mortos no Iraque ataque Blitz
Obama alerta de novas sanções da Rússia	Ucrânia ameaça apreender ativos russos
Conferência da Síria para abrir em Montreux, continue em Genebra	Síria de longa data negociações de paz para abrir em Montreux
Geral Electric Post 9 % Lucro Drop no terceiro trimestre	GE Publica 9 % de queda de lucro no terceiro trimestre
Ordens do líder nigeriano pressionam para as colegas sequestradas livres	Pressão monta para meninas sequestradas livres
10 coisas a saber: os tocados desta semana	10 coisas para saber para hoje
China yuan enfraquece para 6.1535 contra USD	China Yuan se fortalece para o novo alto contra o USD
Autoridades israelenses distribuem ordens de demolição em Jerusalém Oriental	Forças israelenses Pedidos de demolição em Jerusalém
12 migrantes afogados da ilha grega, o governo exige ação da UE	Discurso: Internet e pornografia: Primeiro -ministro pede ação
Putin abre paraolímpicos como protesto encenado	Putin abre paraolímpicos de inverno
Israel 'bombas' Síria, enquanto o enviado pressiona as negociações de paz lances	Fieros confrontos no leste da Síria enquanto nós empurra as negociações de paz
A Rússia considera o advogado morto Magnitsky culpado em julgamento póstumo	A Rússia condena o advogado morto Magnitsky em julgamento póstumo
Soldado dos EUA libertado por Taliban em troca de prisioneiros	Soldado americano libertado no Afeganistão, 5 prisioneiros do Taliban deixam Guantánamo
'Trayvon poderia ter sido eu'	Trayvon Martin poderia ter sido ...
Mianmar prende 44 por violência sectária	Ban adverte os ataques da Síria podem piorar a violência sectária
Louis Zamperini, herói 'invasor' da Segunda Guerra Mundial, olímpico, morre aos 97	nós. O herói de guerra Louis Zamperini, inspiração para 'ininterrupto', morto aos 97
A China envia a maior frota ainda para as ilhas disputadas	Os navios da China entram nas águas das ilhas disputadas
O Banco da Inglaterra mantém as taxas de juros em espera	O Banco da Inglaterra mantém baixas taxas de juros para apoiar a economia nova
Nós, Rússia, entram no terceiro dia das negociações da Síria	EUA e Rússia concordam
A Coréia do Norte afirma	n. A Coréia é o teste de míssil guiado de 'avanço'
O plano de Kerry para reiniciar as conversas exige o lançamento de 103 presos palestinos	Kerry planeja incluir libertação de prisioneiros, congelamento de assentamentos
Polícia: Explosão no Bairro da Catedral de Belfast	Explosão em Cabul Um ataque suicida na área diplomática
A Microsoft finalmente revela o escritório do iPad da Apple	Microsoft e Office em um mundo multiplataforma
Polícia turca de incêndio com gás lacrimogêneo em manifestantes	Polícia turca do gás lacrimogêneo como curdos protestam contra a parede da Síria
Police Fire Limke Gas para manifestantes em Bangkok	Gas de fogo da polícia em manifestantes na Tunísia
Os sírios protestam contra Erdogan em Paris, os venezuelanos enfatizam o apoio à Síria	O Erdogan da Turquia no Irã para consertar os laços após se separar da Síria
Egito Mubarak ordenou em prisão domiciliar se libertado	O Mubarak do Egito a ser liberado, colocado em prisão domiciliar
Primeiro ministro para buscar um acordo nuclear, investimentos durante a visita do Japão	Manmohan espera conquistar o acordo nuclear com o Japão
EUA adiem o teste de mísseis sobre as tensões da coreia	Embaixadas permanecendo colocadas em n. Coréia, apesar da tensão
Obama para se encontrar em particular com a família de Nelson Mandela	Obama para se encontrar com a família Mandela
Pelo menos seis mortos em nós atirando tumulto	Pelo menos 20 mortos nos ataques da Somália
Margaret Thatcher: Kinnock para perder o funeral	Procissão Funeral de Margaret Thatcher em andamento
Prince William aborda o vídeo do Parlamento Australiano	Visita real: Prince William e Catherine visitam o Parlamento em Canberra Tour
Dois feridos no tiroteio em Bangkok	Dois feridos em tiro na escola dos EUA
pistoleiros matam 10 na violência política filipina	Cinco mortos nas Filipinas erupção do vulcão
Pelo menos 14 mortos em bombardeios de Bagdá	Pelo menos 40 mortos por 11 bombas de carro de Bagdá
Israel Downs Drone do Líbano	Israel atira no drone do Líbano
'Um não contabilizado para' no acidente de avião de São Francisco	Dois mortos no acidente de avião de São Francisco 'eram chineses'
As ações européias deslizam sobre tensão sobre a Síria	Os futuros de ações deslizam sobre a tensão da Síria, J.C. Penney ações caem
Oficial do Irã: a negação de visto dos EUA para o enviado iraniano não afetará as negociações da nuclear	Negociador iraniano otimista sobre as últimas negociações nucleares
Everest Avalanche mata seis sherpas	Everest Avalanche mata 12 guias
Israel aprova a liberação do primeiro grupo de prisioneiros palestinos antes das negociações de paz	A oposição síria confirma a participação em negociações de paz
Classões mortais como aniversário do Egito	Violentos conflitos de Mark Anniversary of Egypt Uprising
Rupert Murdoch divorcia a terceira esposa	News Corp. Rupert Murdoch arquivos para o divórcio da esposa Wendi
Austrália reduz as taxas para registrar baixos	Austrália reduz as taxas de juros para registrar baixos
OTAN: 5 americanos mortos no sul do Afeganistão	A bomba na estrada mata 3 policiais no sul do Afeganistão
Primeiro Ministro da Líbia Interina para renunciar	Violência força o primeiro -ministro da Líbia a renunciar
Candidato de MEP morto na explosão de Cabul	Rep do FMI entre 14 mortos na explosão de Cabul
vigaristas vestidos como mulheres roubam dinheiro	CCTV: York Conmen se vestiu como mulheres para enganar os pensionistas
Sisi jurou como presidente do Egito, Recepção Cool do West	El-Sissi inaugurado como presidente do Egito
O seqüestrador de Cleveland, Ariel Castro, encontrado na cela da prisão	O seqüestrador de Cleveland, Ariel Castro, encontrou pendurado em sua cela
Rússia retira acusações contra ativistas do Greenpeace	Rússia para registrar acusações de pirataria contra o Greenpeace
Síria Oposição Unidade Tome Spectre Spectre of Collapse	A Síria dividiu as lutas da oposição dentro da luta síria mais ampla
O Google revela o protótipo de carro autônomo	O Google revela o carro de direção conceitual
Bangladesh Garment Factory Fire 'Kills 8'	O colapso da fábrica de roupas de Bangladesh mata 149
Fieros confrontos no leste da Síria enquanto nós empurra as negociações de paz	Chega a raiva na Síria enquanto nós empurra as negociações de paz
A oposição da Síria vota para ingressar em negociações de paz	A Síria oferece concessões antes das negociações de paz de Genebra
Nós buscam tranquilizar aliados cautelosos do Golfo sobre o negócio do Irã	Hagel procura tranquilizar aliados do Golfo, depois do negócio do Irã
Vídeo mostra o Quênia Jihadis matando casualmente no shopping	Vídeo de segurança mostra soldados quenianos saqueando shopping
A Ucrânia hospeda as negociações	Pope bate na äėwar para vender armas, na Síria
O número de mortos aumenta no colapso de Dhaka Building	Toll Toll atinge 72 no colapso do edifício de Mumbai
Gov 'ts, grupos prometem milhões para alívio do tufão	O Canadá promete US $ 5 milhões em alívio do tufão
Oficial sênior investigado por suspeitas de violações disciplinares	O chefe de ativos estatais da China, regulador sob a investigação por "violação da disciplina"
A crise do poder do Paquistão paira em grandes pesquisas	A crise do poder do Paquistão paira em grande parte da eleição
China HSBC Manufacturing PMI atinge a baixa de sete meses em fevereiro	A fabricação atinge a baixa de sete meses na China
O Líbano coloca raiva durante a noite; 12 soldados mortos	O Líbano coloca a raiva perto da mesquita; 16 soldados mortos
Mãe de dois, 25 anos, encontrada morta em sua casa por ex-namorado como investigação de assassinato de lançamento da polícia	Mãe de dois, 25 anos, encontrada morta em sua casa por parentes como nome da polícia Hunt para ex-namorado depois de lançar o inquérito de assassinato
A Grécia suspende emissora estatal	Grécia para fechar a emissora estadual para economizar dinheiro
O Musharraf do Paquistão é preso no assassinato de Bhutto	Musharraf do Paquistão chega ao tribunal pela primeira vez
10 coisas para saber para hoje	10 coisas para saber para quarta -feira
Data do julgamento definida para o chefe da Irmandade Muçulmana do Egito	A Irmandade Muçulmana da Síria enfrenta uma batalha difícil
Nações em desenvolvimento: o Catar insiste na promessa da Copa do Mundo	Reivindicações de corrupção frescas na Copa do Mundo do Catar
Tribunal Guatemalteca considera o ex -ditador culpado de genocídio	O ex -líder da Guatemala considerado culpado de genocídio
panda vermelha ‚äôs escapa de zoológico de curta duração	Índia, março para Marte
Médicos israelenses poderiam ser julgados no exterior por prisioneiros palestinos que alimentam a força	Controle da Cisjordânia de Israel 'Custando Bilhões de Economia Palestina'
As ações chinesas fecham na terça -feira alta	As ações chinesas se reúnem na quarta -feira
As morteiras sírias teram terra em Golan, Israel retalia	As morteiras sírias terminam em alturas de Golan, ocupadas por Israel, Israel retalia
Toyota, Honda, Nissan e Mazda recordam 3 milhões de carros japoneses após falha	Toyota, outros 3 montadoras do Japão para recordar veículos de 3,4 milhões de airbag
Muitos mortos na Índia Hotel Building Collapse	Seis mortos, dezenas presas no colapso do edifício indiano
Washington Pot Shops Prepare -se para vendas históricas	Washington Pot Shops Prepare -se para vendas históricas
Vítima de estupro de gangue da Somália fala	A vítima de estupro de gangues da Somália acusa Au Force
Trabalhadores do aeroporto do Rio ataque na véspera da Copa do Mundo da FIFA	Rio de Janeiro Trabalhadores do aeroporto Greve na véspera da Copa do Mundo
Equipes forenses internacionais se juntam à sonda de carnificina do shopping Kenyan	preso britânico 'não significativo' para a sonda de ataque do Quênia
filho do principal líder da Irmandade Muçulmana Matada	Egito prende o líder da Irmandade Muçulmana Badie
6.3 Magnitude Quake atinge Kepulauan Barat Daya, Indonésia-USGS	5.2 Quake de magnitude atinge Papua, Indonésia
Nós acreditamos que o governo sírio usava armas químicas	EUA dizem que a Síria pode ter usado gás sarin em armas químicas
Irã, seis potências globais assinam acordo nuclear de referência	Irã, seis potências mundiais conquistam o negócio nuclear de avanço
Fatalidades após a explosão de plantas de fertilizantes do Texas	Auxílio adicional aprovado para a explosão de plantas de fertilizantes do Texas
O balão de ar quente pega fogo na Virgínia	Balão de ar quente 'pega fogo e bate'
Mourinho culpa Moyes por Rooney Saga	Mourinho para levar a 1ª rodada
Citações de líderes, família no Mandela Memorial	World Unita para Mandela Memorial
Os índios de Mumbai colocam T&T em seu lugar	Os indonésios votam no presidente em corrida apertada
Futuros do índice de ações da China fecham na quarta -feira	Índice de ações da China Futuros Open Mixed Friday sexta -feira
As ações da KL permanecem mais altas no meio da tarde	As ações da KL continuam a tendência de alta no meio da tarde
Quake da China: o número de mortos aumenta	Raiva em Dhaka como um número de mortos sobe
O que dizem os papéis, novembro. 20, 2013	O que dizem os papéis, outubro. 10, 2013
3 mortos, 6 feridos em explosões afegãos	três mortos, seis feridos em explosões afegãos
2 pilotos turcos sequestrados no Líbano	2 pilotos de companhias aéreas turcas sequestradas por pistoleiros no Líbano
Amazon lança um novo dispositivo para streaming de vídeo	Amazon revela uma nova caixa de vídeo de streaming de TV Fire TV
Presidente palestino recebe ministro das Relações Exteriores da Jordânia	Palestino preso por assediar sexualmente meninas jovens
Forte terremoto atinge Papau Nova Guiné	Forte terremoto sentido em Los Angeles
O ex-PM Ariel Sharon de Israel morre	ex -primeiro -ministro israelense Sharon morre
A China exorta o Japão a respeitar as preocupações de segurança regional	A China exorta o Japão a manter a paz regional
Obama nomeia um novo secretário de transporte	Obama para encontrar o secretário de veteranos em apuros
China yuan enfraquece para 6.1059 contra USD	China Yuan se fortalece para 6.1070 contra US $ sexta -feira
Tornado enorme mata pelo menos 51 em Oklahoma City	enormes ataques de tornado perto de Oklahoma City
Jogadores de pedras causam danos a carros israelenses perto de Belém	6 feridos em confrontos com forças israelenses perto de Belém
Cellar de vinho francês para leilão de austeridade	Nós louvam o acordo da Ucrânia; exige ação concreta
Obama assina a lei que visa impedir o enviado do Irã da ONU	Obama não pede novas sanções ao Irã
Nós, Rússia, concordam com a apreensão de armas químicas da Síria	Rebeldes sírios céticos sobre o negócio de armas químicas
Adolescente espancado da Flórida lançado em Israel	Palestina adolescente matrizes de feridas sustentadas em tiro israelense
Grupos de rivais libaneses se aproximam de lidar com a Premiership	Os rivais do Camboja se aproximam de negociar a pesquisa disputada
Cinco pessoas presas por desastre da Costa Concordia	Cinco homens condenados ao desastre de naufrágio da Costa Concordia
S MPS da Coréia para visitar o complexo Kaesong	s. A Coréia exige negociações com n. Coréia em fábrica fechada
acordo no Irã Nuclear Drive a partir de 20 de janeiro	Acordo restringindo o impulso nuclear do Irã para entrar em vigor em 20 de janeiro
Sacerdote argelino para palestrar sobre a herança cristã em n. África	Telstra se aplica a listar o site da China em NY
manchetes nos principais jornais iranianos em 5 de abril	Manchetes nos principais jornais iranianos em 18 de agosto
implicações da reconciliação palestina	rei belga para abordar a nação em meio à especulação de abdicação
incêndio no hospital psiquiátrico russo mata 38	38 Temido morto no incêndio do Hospital Psiquiátrico Russo
seqüestrador preso após terras de avião no aeroporto de Genebra	Terras de aeronaves seqüestradas em Genebra
PCB nomeia Waqar Younis como treinador	Waqar Younis de volta como treinador do Paquistão
EUA defendem a ação contra a Síria	Saudita pede que a ONU. ação contra Israel greves na Síria
A França fornece imagem de possíveis detritos	Malásia: a França tem imagens de possíveis detritos a jato
Quatro mortos no carro -bomba de Bagdá	Nove mortos em ataques de carro -bomba de Bagdá
Os manifestantes de Ancara se chocam com a polícia	Os manifestantes do Peru se chocam com a polícia
Arquivos Alibaba para IPO em nós	Arquivos Alibaba para IPO de Nova York
O líder da RPDC exige melhores laços com S.Korea	Coréia do Norte pede estrangeiros a deixar a Coréia do Sul
49 mortos, 148 feridos em ataques violentos no Iraque	15 mortos, 90 feridos em novos ataques no Iraque
O Iraque realiza a primeira eleição desde a retirada dos EUA	O Iraque realiza as primeiras pesquisas desde a saída dos EUA à medida que os ataques aumentam
Irã, Sextet para retomar conversas de especialistas	Irã otimista sobre conversas de bombas nucleares de nível de especialista 'úteis'
Porto -riquenho preso por produção de pornografia infantil	Guru indiano preso por suspeita de estupro
Ucrânia assina o pacto comercial da UE quando a Rússia finaliza a anexação da Crimeia	O principal tribunal da Ucrânia descarta a independência da Crimeia como "inconstitucional"
nós. Pasta apoio à oposição síria	ONU pede apoio à oposição da Síria
Bangladesh colapsa pesquisar; Tollo de morte 1.127	Bangladesh colapsa mortes no topo 620
Ganhos que seqüestram funcionários da embaixada do Irã no Iêmen	homens armados seqüestram trabalhadores da embaixada iraniana no Iêmen
Chinês, russo FMS troca opiniões sobre a crise da Ucrânia	Presidente chinês chega à Argentina para visita de estado
Comentários de Bernanke mantêm mercados em ascensão constante	Bernanke Stimulus Boost para os mercados
Bomba no sul da cidade afegã mata pelo menos 5	Explosão na popular cafeteria de Bagdá mata pelo menos 15
Assad adverte a Turquia sobre o 'preço alto' para apoiar os rebeldes sírios	Gabinete em guerra por armar rebeldes sírios
Presidente afegão para visitar em breve o Paquistão	Presidente afegão para pressionar por atraso no acordo dos EUA
Estoques indianos fecham mais baixo	Os estoques de Hong Kong fecham 2,33 % mais altos
IRAN NUCLELEM PRASSE para dominar a reunião do conselho da IAEA	Irã Nuclear Impasse to Dominat ...
19 mortos, 42 feridos em ataques violentos no Iraque	43 mortos, 86 feridos em ataques no Iraque
Estupro indiano acusado enfrenta veredictos	Estupro indiano acusado considerado culpado
A oposição síria reflete a participação em negociações de paz	A oposição síria confirma a participação em negociações de paz
Enquete: Cory Booker assume a liderança antecipada para N.J. senado	Nigella Lawson 'tomou cocaína todos os dias por uma década'
carro -bomba mata pelo menos 30 norte da capital síria	carro bomba mata pelo menos 10 no centro da Síria
O acordo nuclear do Irã concordou em negociações	Deal nuclear do Irã selado após décadas de disputa de décadas
O porta -voz militar egípcio denuncia o incitamento contra o exército	Anúncio do Ministério do Trabalho com vencimento na segunda -feira
Snowden vê 'sem chance' para nós, justo julgamento	Snowden vê "sem chance" de fazer julgamento justo nos EUA.
manchetes nos principais jornais iranianos em 30 de dezembro	Manchetes nos principais jornais iranianos em 6 de julho
Dezenas feridas na colisão do trem de Connecticut	Ministro Indiano morto em colisão frontal
A polícia de Nova Orleans prende o segundo suspeito no desfile do dia da mãe	Irmãos presos no tiroteio no dia da mãe
Explosão no trem indiano mata um	Estado: Não há fundos para a Yeshiva que incite a violência
As ações de Hong Kong abrem mais alto	As ações de Hong Kong fecham 0,72 % mais altas
Queen visita o novo príncipe da Grã -Bretanha	Queen Meets New Baby Prince da Grã -Bretanha
Egito, äôs Sisi preparou para anunciar a oferta de presidência	Egito, äôs sisi abre o caminho para a oferta presidencial
Os ganhos da Microsoft prejudicam a aquisição da Nokia	A Microsoft vê as perdas do Nokia, as ações aumentam após o horário
Biden alerta a hora da Rússia parar de falar e começar a agir 'na Ucrânia	Biden: Hora da Rússia 'parar de falar e começar a agir' para reduzir a tensão na Ucrânia
nós para implantar Patriots, F-16s para a Jordânia	Jordan: EUA implantando patriotas, F-16s
Ucrânia: Três mortos nos protestos do Parlamento	Presidente da Ucrânia chama negociações para encerrar os protestos
Presidente chinês encontra o chefe da ONU	Vice -presidente chinês encontra os EUA delegação
Operador de passeio cobrado em N.C. Acidente justo	N.C. Operador de passeio justo estadual preso após acidente
Ministros das Relações Exteriores da UE para discutir a violência do Egito	Ministros das Relações Exteriores da UE para discutir o Egito na quarta -feira
Saudita empurra a resolução da ONU sobre o abuso da Síria	Cameron empurra a ONU. Resolução em armas químicas sírias
Tunísia suspensa da Davis Cup para evitar o tenista israelense	Tunísia suspensa da Davis Cup por se recusar a interpretar israelense
Egito diz líder da irmandade em boa saúde na prisão	O vice -líder da Irmandade do Egito
A transcrição revela confusão sobre a evacuação da balsa sul -coreana	A transcrição revela confusão sobre evacuação de balsa
Us bombeiros caídos trazidos para casa	Wall Street termina um pouco mais baixa
O Tribunal do Egito absolve 169 apoiadores da Irmandade	Tribunal do Egito sentenças 100 apoiadores da Irmandade
O regime da Síria concorda em participar da conferência da paz	Rússia: a Síria concorda em participar da conferência
Aung San Suu Kyi faz um empurrão presidencial	Aung San Suu Kyi para presidente em 2015?
O voto do Reino Unido rejeita ação militar	Grã -Bretanha rejeita ação militar da Síria
Nova Zelândia preparada para legalizar o casamento gay	Votos da Nova Zelândia para legalizar o casamento entre pessoas do mesmo sexo
Desmond Tutu presta respeitos finais a Mandela	África do Sul se prepara para enterrar Mandela
As ações de Cingapura terminam 0,37 PCT	As ações de Cingapura fecham 0,41 pct mais alto
Coréia do Sul propõe conversas com o norte	A Coréia do Sul diz as negociações com o norte descartado
Presidente venezuelano para visitar a China	Presidente senegalês para visitar a China
Cinco presos por desastre de naufrágio da Costa Concordia	Cinco funcionários presos por Costa Concordia naufragando
Os manifestantes do Cairo desafiam a ameaça de repressão	Nos campos do Cairo, os manifestantes cavam e vivem
A pesquisa de avião ausente se volta para as ilhas vietnamitas	A falta de avião da Malaysia Airlines cai 'fora do Vietnã'
soldado da OTAN morto no ataque do Taliban	Cinco soldados mortos no ataque do Iêmen
O Irã ameaça desencadear guerra ao preço do petróleo	O homem admite ameaçar matar o príncipe Harry
Funcionário da Malaysia Airlines resmatam parentes dos passageiros de voo ausentes sobre o progresso da pesquisa	A Malaysia Airlines Investigating Co-Pilot no voo ausente
As estrelas prestam homenagem a Cory Monteith	As estrelas prestam homenagem a James Garner
Oficial sênior investigado por suspeitas de violações disciplinares	A China investiga o chefe de comissão de supervisão
Vendas e lucros para ingressos do Manchester United	O proprietário do Manchester United, Malcolm Glazer, morre aos 85 anos
Trabalhador do aeroporto de Los Angeles acusado de fazer ameaças de 9/11	O trabalhador do aeroporto de Los Angeles cobrou mais de 9/11 ameaças
Exército, Governo de Leggerheads sobre negociações do Taliban	Exército Paquistanês, governo de Leggerheads sobre negociações do Taliban
O Egito prende o principal líder da Irmandade Muçulmana	O Egito prende os apoiadores da Irmandade Muçulmana sob a lei terrorista
As leituras obrigatórias da nota para sexta-feira, 24 de maio de 2013	As leituras obrigatórias da nota para sexta-feira, 23 de agosto de 2013
Plano solar Terras em Washington na Tour	Terras planas movidas a energia solar perto de Washington
Os rebeldes pró-russos abrem o avião ucraniano, 49 mortos	Os rebeldes da Ucrânia abrem o avião carregando 49
O novo rei Felipe VI da Espanha jurou em uma cerimônia suave	O rei Felipe VI deve ser empos
Cristiano Ronaldo Hat-Trick dispara Portugal às finais da Copa do Mundo de 2014	Ronaldo hat-trick demitir Portugal para a Copa do Mundo
Israel para libertar prisioneiros palestinos sobre as negociações de Kerry	Israel concorda em libertar 104 prisioneiros palestinos como parte de um possível acordo para reiniciar as negociações de paz
nós. soldado livre após quase cinco anos cativeiro no Afeganistão	Soldado dos EUA libertado após 5 anos em cativeiro no Afeganistão
A Malaysia Airlines perde contato com o avião transportando 239 para Pequim	A Agência de Notícias da China diz que o avião da Malaysia Airlines perdeu o contato sobre o Vietnã
Neymar Powers Brasil nos últimos 16 anos	Neymar Powers Brasil para a Copa do Mundo nos últimos 16 anos
Ucrânia para implementar cessar -fogo unilateral	Ucrânia oferece cessar -fogo unilateral
O príncipe Philip da Grã -Bretanha está definido para cirurgia "exploratória"	Prince Philip do Reino Unido hospitalizado
O Japão começa a ouvir sobre o imposto sobre vendas, ex-deputado do Bank pede aumento gradual	O Japão inicia audiências sobre o aumento de impostos propostos
A Malásia está data para as eleições marcantes	Malásia PM definido para eleição geral
Três ataques de bomba matam seis soldados, um civil	O ataque da bomba escolar mata dois no sul da Tailândia
Dois soldados da Otan mortos no Afeganistão	Cinco soldados líbios mortos em confrontos de Benghazi
Stones Adicione o segundo concerto do Hyde Park	Rolling Stones Adicione o segundo Hyde Park Data
Os peregrinos italianos morrem em mergulho de ônibus	passageiros mortos na Itália Bus
Coréia do Norte nos pede a tomar 'ações reais'	A Coréia do Norte nos pede a tomar ações de real
Novo PM australiano Tony Abbott em sua bicicleta aguardando a contagem final de votos	Tony Abbott, do PM australiano, enfrenta seu novo emprego
O que dizem os papéis, agosto. 19, 2013	O que dizem os papéis, dez. 30, 2013
A Malaysia Airlines perde contato com o avião com destino a Pequim, ao vivo	O avião da Malaysia Airlines desaparece em voo para Pequim
Os consumidores dos EUA aumentam os gastos 0,2 PCT. mês passado	gasto de consumidores 0,2 % em maio
Bateria de Scorpions na prisão de Dubai por 'insultar o Islã'	Drummer Scorpions preso em Dubai por "insultos do Islã, äô
5 nações se encontram em neblina	O casamento de Putin no fim
Novos acertos fortes do terremoto quebraram a região de Pak	poderosos novos acertos de terremoto quebraram a região do Paquistão
A oposição síria oferece trégua de Assad em Homs por duração do Ramadã	A oposição síria oferece a trégua das forças de Assad por duração do Ramadã
nós. Para liberar informações sobre a Síria, uso de armas químicas	Nós acreditamos que a Síria usava armas químicas, mas diz que os fatos necessários
As tropas do Paquistão se movem contra o Taliban	Exército Paquistão começa ofensivo contra militantes
Pelo menos 20 mortos nos ataques da Somália	Pelo menos 60 morrem no ataque da prisão do Iraque
Os atacantes do Westgate Mall passaram quatro meses planejando em Nairobi	Os atacantes de Westgate passaram quatro meses planejando em Nairobi, diz oficial
un. Conselho de Segurança pede cessar -fogo humanitário em Gaza	un. O Conselho de Segurança pede cessar-fogo incondicional em Gaza
O prefeito de Toronto, Rob Ford, em extraordinária confissão de crack	O prefeito de Toronto, Rob Ford, nega alegações de crack
6.3 Quake de magnitude Hits Honshu, Japão: CENC	6.7 Terremoto de magnitude Jolts Taiwan: CENC
As ações chinesas fecham na terça -feira alta	As ações chinesas se aproximam na quarta -feira
bombas de carro matam 58 na capital iraquiana	Carros -bombardeios matam 13 civis na capital iraquiana
Empresas estrangeiras de olho na nova 'abertura'	Mais operadoras provavelmente na China
Manifestantes ucranianos de volta às ruas para manifestação antigovernamental	Os manifestantes da Ucrânia derrubaram a estátua de Lenin em Kiev
Líder sênior do Taliban preso em s. operação afegã	4 Membros do Taliban presos em operação noturna de invasão: Polícia afegã
Trem canadense de frete explosão A morte de mortos atinge três, para subir	Situação de explosão de trem do governo canadense
Diana Nyad progredindo em Cuba para nadar na Flórida	Diana Nyad completa
Nós envia consultores militares para o Iraque	EUA implantam consultores militares para a Somália
nós. Os trabalhadores de fast-food planejam ataques em todo o país sobre o salário mínimo	Trabalhadores de fast-food greve por salários mais altos
Coréia do Norte dispara 18 foguetes no mar do Japão	n. Coreia teste-fogo 16 foguetes no mar
Nigel Farage chama o governo para deixar refugiados sírios no Reino Unido	'sem planos' de reinstalar os refugiados sírios no Reino Unido
oposição síria para encontrar conversas sobre paz	Oposição síria: Won's participam de negociações de paz, a menos que o objetivo seja a saída de Assad
Peres de Israel pede que retorne às negociações de paz	Gonsalves mantém pressão sobre o DOM Rep
Austrália para liderar a busca do sul por MH370	Austrália PM Abbott alerta de longa pesquisa por MH370
Líder britânico perde votar na resposta da Síria	Cameron perde a votação parlamentar sobre ação militar da Síria
China Yuan enfraquece para 6.1651 contra US $ terça -feira	China Yuan se fortalece para 6.1696 contra USD na quinta -feira
Todos os olhos no novo chefe do exército Pak, Raheel Sharif	Alertas de inundação na França à medida que os níveis dos rios aumentam
China Yuan se fortalece para 6.1184 contra US $ terça -feira	China yuan enfraquece para 6.1510 contra USD
Dezenove feridos em tiroteios na Mother, desfile do Dia	A polícia promete resolver tiroteios de 19 em Nova Orleans
Os manifestantes tailandeses atrapalham a votação antecipada para a eleição disputada	Líder de protesto tailandês matou tiros fora da estação de votação
Forças israelenses detêm 18, ferirem adolescentes de Belém	Forças israelenses atiram, ferir adolescentes de Belém
Rádio: Israel definido para aumentar a libertação do prisioneiro palestino	EUA: Israel para adiar a libertação do prisioneiro palestino
Os apoiadores de Morsi rejeitam o plano	Os apoiadores de Morsi marcam no Egito
Austríacos votam nas eleições gerais	Os argelinos votam nas eleições presidenciais
Tribunal do Egito sentenças 10 apoiadores da Irmandade até a morte - fontes	PM turco diz aos apoiadores para se preparar para comícios
Obama condena o assassinato de 3 adolescentes israelenses	Corpos de adolescentes israelenses desaparecidos encontrados na Cisjordânia
A morte do demonstrador leva protestos na Turquia	Discursos frescos em erupção na Turquia
Explosão na fazenda de um líder da Irmandade Muçulmana no Egito mata 4	O Tribunal Egípcio condena o líder da Irmandade Muçulmana à prisão perpétua
Os rebeldes sírios têm como alvo aeroportos militares	Tropas sírias enfrentam ataques ferozes por rebeldes no aeroporto militar
Os homens tentaram decapitar o soldado na London Street, o tribunal ouve	Austrália espionou o presidente da Indonésia: relatórios
O prefeito de Toronto, Rob Ford, em extraordinária confissão de crack	O prefeito de Toronto, Rob Ford: afirma que ele tentou comprar o vídeo crack 'uma mentira direta'
China Quake deixa dezenas de mortos	Quake da China mata pelo menos 179
Mulher presa em conexão com danos da escultura no aeroporto de Changi	Mulher presa por intrusão na escultura de chuva cinética no aeroporto de Changi T1
Os manifestantes da Ucrânia reconstruem barricadas	Putin fala sobre a Ucrânia, os manifestantes reconstruem barricadas
Kerry retorna ao Delta do Mekong do Vietnã como os principais EUA diplomata	Kerry retorna ao Vietnã, agora como Top Us Diplomat
Mel Smith morto aos 60 e Reino Unido lamenta um favorito de comédia	Griff Rhys Jones: Mel Smith era 'uma força para a vida'
Três mortos, 63 doer quando os edifícios de Nova York entram em colapso	Dois mortos, nove feridos no colapso do prédio francês
As ações chinesas fecham na terça -feira alta	As ações chinesas fecham na quinta -feira
oposição síria para encontrar conversas sobre paz	A oposição síria se espalhou à frente das negociações de paz
pistoleiros matam nove estrangeiros no Paquistão	pistoleiros matam 10 turistas estrangeiros no norte do Paquistão
Índia tinta: Imagem do dia: 2 de julho	Índia tinta: Imagem do dia: 4 de março
BOEING 777 PLANO PERDADOS NO AVERIOR DO SAN FRANCISCO	Crash de avião terras no aeroporto de São Francisco
NSA Whistleblower Edward Snowden ofereceu asilo na Venezuela	NSA Whistleblower Edward Snowden ofereceu asilo pela Venezuela, Nicarágua e agora Bolívia
Reivindicações militares da Nigéria, matando o extremista superior	militares nigerianos dizem que não há operação estrangeira por aliados
ONU passa o tratado global de comércio de armas	un. para regular o comércio global de armas
Exército israelense mata palestina em Ramallah	Ferida israelense de dois ativistas palestinos em Gaza
Os muçulmanos asiáticos comemoram o Eid como 14 mortos no Afeganistão	Os muçulmanos asiáticos comemoram o Eid como 52 morrem no Paquistão, Afeganistão
Bomber suicida mata 12 no Iraque Cafe	Bomber suicida mata 15 no norte do Iraque
O Paquistão nos condena greves com drones	O Paquistão condena a greve dos drones nos EUA na área de Shawal
O ex-Gov do SC. Sanford vence o segundo turno, enfrentará Colbert Busch	O ex-Gov do SC. Sanford limpa o obstáculo na oferta de retorno
carro bomba no Consulado Sueco no Benghazi da Líbia, sem baixas	O carro -bomba atinge o consulado sueco em Benghazi, nenhum doeu
Nelson Mandela permanece em estado crítico	Presidente da SA: Mandela permanece em uma condição crítica '
Oito mortos na violência do Iraque	6 mortos na violência do Iraque
O tribunal anula a condenação por assassinato do ex -agente do FBI ligado ao mafioso	O Tribunal de Apelações da Flórida derruba a condenação por assassinato do ex -agente do FBI
51 mortos, 191 feridos em ataques violentos no Iraque	35 mortos, 138 feridos em onda de ataques no Iraque
As minas de carvão russo procuram novos pontos de venda na China	Ministro das Relações Exteriores russo para se encontrar com o chefe da ONU
AUST SCOLIÇÕES EM TODA ALTA	As ações da Aust se aproximam
Casa Branca em ofensiva para frustrar sanções do Irã	Wall Street sobe na proposta de evitar greves na Síria
Ucrânia, os manifestantes pró-Rússia exigem maior autonomia	manifestantes sudaneses exigem a deposição do regime
O Exército do Iraque luta para retomar o Tikrit	O Exército do Iraque reivindica a vitória no Tikrit
O Irã condena a alegada ataque aéreo israelense na Síria	Os democratas enfrentam se dividir sobre uma greve na Síria
Israel concorda em estender a trégua de Gaza por quatro horas	Israel, o Hamas teria concordado com a trégua de 12 horas
O número de mortos aumenta para 51 no colapso do supermercado letão	Toll Toll atinge 63 no colapso do edifício de Mumbai
Drag queen barbudo vence o concurso de músicas do Eurovision	'S' barbudo dama 'da Áustria vence o concurso de músicas do Eurovision
O incêndio no terminal de ônibus sul -coreano mata 5	s Coréia da Coréia Fire mata sete
Israel para libertar prisioneiros palestinos como acordo para retomar as negociações de paz surge	Israel para liberar prisioneiros palestinos
Obama pede a calma após a absolvição de Zimmerman no caso de Martin	Obama pede calma após a absolvição de Zimmerman; protestos mantidos
A Coréia do Norte diz para reiniciar o reator nuclear	Coréia do Norte para reiniciar o reator nuclear de Yongbyon
Os bombeiros combatem o incêndio florestal da Califórnia	Os bombeiros fazem o progresso do progresso em um enorme incêndio na Califórnia
Bomber Strikes perto da sede do Exército do Paquistão	Bombardeio para fora do restaurante no Paquistão 15 feridas 15
Brasileiros ruas multifuncionais para cumprimentar o papa	No Brasil, milhares acabam de cumprimentar o papa Francisco
Quatro civis, três soldados da Otan mortos no Afeganistão	Três soldados da Otan mortos no Afeganistão
A pressão aumenta na Casa Branca sobre Benghazi	A pressão aumenta na Casa Branca sobre os pontos de discussão de Benghazi
um morto, 40 feridos na explosão de fábrica de doces do México	Três mortos, 21 feridos em dois contratempos de estrada
ONU Voices Alarme com ataques israelenses na Síria	Oficial israelense confirma o segundo ataque aéreo na Síria
A China facilita a política de um filho	A China formaliza o alívio da política de um filho
A contagem antecipada de votos no Irã dá uma ampla liderança do reformador	A contagem de votos do Irã dá a Rowhani Wide Lead
Manifestantes Swamp Streets para recuperar a revolução	Egito: os manifestantes assumem a sede da Irmandade Muçulmana
Os estoques de Tóquio abrem 0,24 %	Os estoques de Tóquio abrem 0,52 %
Austrália retorna os requerentes de asilo ao Sri Lanka na transferência do mar	Austrália: a Austrália entrega os requerentes de asilo de volta ao Sri Lanka
Palavra cruzada clássica - sábado, 20 de abril	Palavra cruzada enigmática - sábado, 20 de abril
vítimas de explosão de Shankill para serem lembradas	O corpo da vítima de crocodilo recuperou
Afghan Landslide Toll 2.000, o local pode se tornar grave enorme	O número de mortos de deslizamento de terra afegão é improvável que se suba acima de 500
Typhoon Haiyan mata 1.774 nas Filipinas	Typhoon Haiyan: Ventos de 195 mph Batter das Filipinas
118 pessoas mortas em explosões gêmeas na Nigéria	Dez mortos em nova explosão na Rússia
Ministros iranianos e afegãos conferem	Ministros das Relações Exteriores britânicas e iranianas para se encontrarem na ONU
Coréia do Norte dispara mísseis como EUA , Japão, líderes da Coréia do Sul se encontram	Ameaça de mísseis da Coréia do Norte: mais recente
A estrela de Glee Cory Monteith encontrada morta no quarto de hotel no Canadá	Estrela 'Glee' Cory Monteith encontrada morta
O Egito anuncia o extremo a estado de emergência	O Egito declara o estado de emergência de um mês
pistoleiros nigerianos matam o noivo, 30 outros no comboio de casamento	Nigéria Oficial: pistoleiros matam 30 em comboio de casamento
A Croácia começa a contagem regressiva para a entrada histórica da UE	Countdowns da Croácia para se juntar à UE
Yolanda Death Toll sobe para 3.621	Cruz Vermelha do Quênia diz que o número de mortos aumenta para 68
Os estoques de Tóquio fecham 0,13pc	Os estoques de Tóquio fecham 0,75pc
Pyongyang propõe conversas de fim de semana com Seul	Pyongyang se prepara para o próximo teste nuclear - mídia
Cinco pessoas acusadas de crimes terroristas	A polícia britânica cobra dois homens com ofensas terroristas
Diplomata palestino doeu na explosão	embaixador palestino ferido em explosão de apartamento
Cinco mortos, 40 desaparecidos no desastre de trem do Canadá	Cinco mortos, 40 desaparecidos no Canad ...
O Irã diz pronto para uma nova rodada de negociações nucleares	O Khamenei Renows do Irã apoia as negociações nucleares
Os confrontos continuam entre a polícia e os manifestantes na Turquia	A polícia turca luta contra manifestantes, Clear Square
Aqueles recusou cartões médicos solicitados a entrar em contato com o HSE	HSE Boss defende o plano de cartão médico
O maior edifício do mundo, o maior edifício inaugurado no oeste da China	Itália, lascas de centro-esquerda na votação presidencial
incêndio no centro de detenção de imigração	incêndio no centro de detenção de imigração de corrida privada
Hassoun para a delegação da Mauritana: a conspiração imposta à Síria tem como alvo suas posições, particularmente sobre a Palestina	Mufti: Conspiração Aginst Síria tem como alvo suas posições, principalmente em direção à Palestina
As ações de Cingapura fecham 0,7 pct mais alto	As ações de Cingapura terminam 0,16 PCT
israelense levemente ferido por pedras na margem oeste	As tropas israelenses matam palestinas na operação
O número de mortos dos protestos do Egito aumenta para 49	Toll de morte da violência do Egito aumenta para 638
Hong Kong pronto para a democracia março	Hong Kong preparado para uma grande manifestação de democracia
O Senado confirma Janet Yellen como presidente do Federal Reserve dos EUA	O Senado dos EUA confirma Janet Yellen como novo chefe do Banco Central
Tehran-London laços para melhorar, Afkham	Teerã-London laços para melhorar
A oposição síria concorda com as negociações de paz marcantes	A oposição da Síria pressionou para participar de negociações
O ataque suicida mata oito em Bagdá	Ataques suicidas matam 24 pessoas em Bagdá
Até 19 bombeiros desaparecidos no Arizona	Wild Fire mata 19 bombeiros no Arizona
Estatísticas da pobreza duvidam das reivindicações de desenvolvimento de Modi	GM para começar a receber reivindicações de compensação de recall
rebeldes pró-Rússia para realizar votação na Ucrânia	Rebeldes da Síria: Matamos homens do Hezbollah no Líbano
Os georgianos votam em novo presidente	Ally of Georgia Bilionaire PM para ser presidente da exposição
Fatos sobre o míssil Musudan da Coréia do Norte	Coréia do Norte dispara outro míssil
Doença respiratória MERS encontrada nos EUA , as autoridades confirmam	Primeiro caso de Mers, uma doença respiratória semelhante a SARS, relatada na América do Norte
Sobre criminosos e heróis de guerra: a lavagem de Ariel Sharon ŕä	Sobre criminosos e heróis de guerra: a lavagem de Ariel Sharon
Obama para se encontrar com a China, äôs xi na Califórnia, de 7 a 8 de junho	Obama para conhecer o primeiro -ministro ucraniano na Casa Branca
UE declara o grupo de terror de asa militar do Hezbollah	A UE coloca o Hezbollah Wing Military na lista de terror
Rogers, VideoTron estende o alcance com negócios de compartilhamento de rede	Rogers, VideoTron Reach de compartilhamento de rede, acordo de espectro
greve dos drones nos EUA 'mata 4 militantes no Paquistão'	Suspeito que o drone dos EUA mata 2 militantes no Paquistão
protestos para meninas sequestradas proibidas na capital nigeriana	Pontuações 'mortas' em Boko Haram Raid na Nigéria
A Alemanha recebe o acordo nuclear do Irã	A Síria recebe o acordo nuclear do Irã
Pesquisadores proeminentes da Aids mortos no acidente de avião da Malásia	Pesquisador de Top Aids morto no acidente de avião da Malásia
O que dizem os jornais, 25 de junho de 2013	O que dizem os papéis, agosto. 19, 2013
Wing Walker, Pilot Die in Biplane Crash no Ohio Air Show	dois mortos em um pequeno acidente de avião nos EUA show aéreo
pistoleiros matam nove estrangeiros no Paquistão	pistoleiros matam nove turistas no Paquistão
Líderes de protesto da Ucrânia Nome dos Ministros, tropas russas em alerta	A Ucrânia diz que não vai se curvar às "provocações" russas na Crimeia
Dois jornalistas franceses mortos no Mali	Dois jornalistas franceses mortos após o seqüestro do Mali
2 comerciantes indianos presos na China enviados de volta para casa	46 enfermeiras indianas presas no Iraque retornam para casa
ASIÁTICA ACARIA MAIORES SINAIS DE FED	As ações asiáticas sobem antes da decisão do Fed
Carta com Ricin enviado ao senador	Reid: carta com ricina ou veneno enviado ao senador
O governador da Califórnia declara emergência de seca	O governador da Califórnia declara a emergência da seca, à medida que os incêndios florestais continuam a queimar
As negociações de paz com os palestinos levariam meses: Israel Oficial	Garota palestina 3yo morta em Israeli Raid
17: 02 23 Morto no Iraque Bombings	11 crianças mortas em atentados na Síria
China yuan enfraquece para 6.1559 contra USD	China Yuan enfraquece para 6.1818 contra US $ terça -feira
Dois mortos, mais presos no último colapso do edifício de Mumbai	Dois estão presos como colapsos de construção de nós
Greves aéreos mata dezenas no norte da Síria	Ucrânia não dará 'polegada' sobre a Crimeia
Israelenses e palestinos pretendem negociar um acordo de paz 'final' após palestras positivas	Exército israelense mata 3 militantes palestinos em confrontos da Cisjordânia
Man United diz que Moyes sai como gerente	Man United contrata moyes para substituir Ferguson
turista chinês sequestrado da Malásia	A China retorna 10 crianças sequestradas do Vietnã
A tempestade tropical Barry se forma na costa do México, trazendo fortes chuvas enquanto se dirige em direção a Veracruz	Tempestade tropical Barry enfraquece, despejar chuva no México
O político japonês pede desculpas pelo comentário de sexo	O prefeito do Japão pede desculpas aos EUA , nega palavras erradas em "mulheres com conforto"
4 mortos, 6 feridos em ataques no Iraque	43 mortos, 86 feridos em ataques no Iraque
Os inspetores da ONU têm progresso sobre as armas químicas da Síria	nós. não concluiu que a Síria usou armas químicas -casa branca
Diplomata dos EUA morto no Afeganistão queria ajudar	Diplomata dos EUA morto no Afeganistão trabalhou com John Kerry
A irmandade muçulmana do Egito se recusa a recuar	A prisão do Egito do Guia Supremo da Irmandade Muçulmana aproxima a proibição
Irã ‚äôs rouhani admite armas químicas mataram pessoas na Síria	sonda alegada uso de armas químicas na Síria
Duas prisões feitas após protestos contra Nigel Farage	Kerry promete o progresso após a última viagem intensiva do Oriente Médio
explosão perto do consulado iraniano em Peshawar mata um	ataque suicida no consulado iraniano em Peshawar mata dois
pistoleiros matam 15 soldados líbios	pistoleiros matam 3 tropas libanesas perto da Síria
As imagens mostram a operação da Costa Concordia concluída	TimeLapso da operação da Costa Concordia
As negociações nucleares do Irã entram no terceiro dia	As negociações nucleares do Irã entram no terceiro dia crucial
Texas Won 'T Switch Execution Drug	Texas Won 'T Switch Execution Drug
Twitter compartilha foguete na abertura	O Twitter compartilha o foguete quando o comércio começa
Paquistão ‚äôs Musharraf concedeu fiança	O ex -ditador paquistanês Musharraf concedeu fiança
Os manifestantes se reúnem no Brasil, apesar das concessões	protestos varrem o Brasil, apesar da concessão
FTSE Bursa Malaysia Atualização: 11h30	FTSE Bursa Malaysia Atualização: 9h.
Super Typhoon atinge Taiwan, Filipinas	Super Typhoon chicoteia as Filipinas e Taiwan e segue para a China
Pontuações mortas, 1.000 feridos no terremoto da China	Dezenas mortas, 1.000 feridos no terremoto da China
China relata 5 novos casos H7N9, 33 Total	A China relata 4 novos casos H7N9
O primeiro -ministro australiano Kevin Rudd liga para a eleição para 7 de setembro	O primeiro -ministro australiano Rudd liga para setembro. 7 Enquete
Bomber suicida mata 15 no norte do Iraque	Carros -bomba suicidas mata 12 no norte do Iraque
Rudd jurou como PM australiano	Rudd jurou como o novo primeiro -ministro da Austrália
As negociações nucleares do Irã esperam retomar esta semana	Reino Unido: negociações nucleares no Irã em um ponto sério
Oficiais do Iêmen: o drone dos EUA mata 2 militantes	Greve de drones do Iêmen mata militantes
sub -pias indianas com 18 a bordo	Submarino indiano explode com 18 marinheiros a bordo
Susan Boyle revela que tem Asperger,	Susan Boyle diz ao British Paper que tem Asperger's
Bangkok tenso na véspera eleitoral tailandesa	Bangladesh: a repressão aumenta antes da eleição
Israel chama o acordo nuclear do Irã de 'erro histórico'	Avanço de acordos de alimentação do Irã, a atividade nuclear do Irã
Estoques chineses abrem na quinta -feira inferior	As ações da China se aproximam da quinta -feira
Forças de Israel matam 2 militantes palestinos	Exército israelense mata militantes palestinos em ataque
China, protegerá os interesses, de negócios estrangeiros	Obama em äėdirect, confronto com Putin na Ucrânia
O número de mortos sobe para 17 'depois que o tufão atinge o Japão	O número de mortos aumenta para 84 nas inundações do Paquistão
Ucrânia oferece cessar -fogo unilateral	Poroshenko da Ucrânia declara cessar -fogo
A condenação por fraude fiscal de Silvio Berlusconi confirmada	Berlusconi ataca a condenação por fraude fiscal
D.C. votos para descriminalizar a maconha	DC Votos para descriminalizar o pote
Muitos mortos enquanto o barco de asilo afunda da Austrália	Mandela passa o terceiro dia no hospital
Obama diz que os veteranos da Guerra da Coréia, melhoram melhor	Obama: veterinários de guerra coreana, melhor
6 policiais mortos em pistoleiros no norte do Iraque	3 policiais egípcios mortos por pistoleiros no ataque do Cairo
Kim da Coréia do Norte é a execução de tio poderoso	Intriga norte -coreana: a execução do poder
A Rússia oferece garantias sobre a remoção de armas químicas sírias	A Rússia diz à Síria para remover armas químicas este mês
Margaret Thatcher morre após o derrame	Margaret Thatcher morre aos 87 anos
Presidente chinês chega à Holanda para visita estatal, cúpula nuclear	Presidente chinês chega à Venezuela para visita estatal
soldado da OTAN morto no ataque do Taliban	Quatro soldados mortos no Iêmen
Israel sanciona os palestinos em novas negociações de paz para a paz	Israel para liberar prisioneiros palestinos como parte do acordo para reviver as negociações de paz
Reino Unido Sky News Cameraman morto no Egito	Sky News Cameraman morto no Egito
Pistãos matam nove turistas estrangeiros, guia no Paquistão	pistoleiros matam 9 turistas estrangeiros, 1 paquistanês
Rudd jurou como o novo primeiro -ministro da Austrália	Rudd em juramento como primeiro -ministro australiano
Os protestos continuam em tenso capital da Ucrânia	Os protestos continuam na capital da Ucrânia
As ações aumentam no comércio inicial	estoques centímetros mais altos nas negociações antecipadas
O especialista em áudio do FBI testemunha em Zimmerman Trial	A seleção do júri começa no julgamento de Zimmerman
Brasil zumbindo com antecipação para o Papa Francisco	multidões do Brasil cumprimentam o papa Francisco
As negociações nucleares iranianas para serem estendidas a novembro	As negociações nucleares do Irã se estendiam a 24 de novembro
A polícia do Egito não inicia a operação para dispersar campos pro-mursi	O Egito adia o dispersando campos de protesto pró-Morsi
Dois jornalistas franceses mortos após o seqüestro do Mali	Dois jornalistas franceses sequestrados, mortos no norte do Mali
Bangladesh Building Collapse Death Toll Pass 600: Exército	Bangladesh Building Collapse Death Toll Tops 1.000
manchetes nos principais jornais iranianos em 14 de dezembro	Manchetes nos principais jornais iranianos em 29 de julho
Suspeito de bombardeio de Boston para comparecer ao tribunal	Suspeito de bombardeio de Boston enterrado
Irã alerta sobre a transbordamento da possível guerra na Síria	A delegação iraniana vai para o Líbano, Síria
Toll Toll in India Building Collapse Hits 42	Toll do colapso do edifício da Índia hits 25
O vazamento de amônia líquida mata 15 em Xangai	O vazamento de amônia mata 15 em Xangai
Tymoshenko da Ucrânia pede manifestantes a continuar	O chefe de oposição da Ucrânia quer mais protestos
Pelo menos 20 mortos nos ataques da Somália	Pelo menos 8 feridos em grande incêndio em Boston
Obama anuncia a criação de hubs de fabricação gêmea	REGUTO DE ACESSOS DE US OUTROS NO
Cinco acusados ​​de crimes terrorismo	Cinco pessoas acusadas de crimes terroristas
O presidente Obama revela planos de retirar tropas do Afeganistão até 2016	Desligamento do governo dos EUA: Obama diz aos republicanos para levantar ameaças à economia dos EUA se quiserem conversas
EUA, OTAN Raise dúvidas Rússia recuou da fronteira da Ucrânia	Nenhum sinal de retirada russa da fronteira da Ucrânia, diz o funcionário
O ex -presidente do Paquistão, Pervez Musharraf, preso novamente	O ex -governante militar do Paquistão Pervez Musharraf concedeu fiança
A adolescente sobrevive ao voo pelo Pacífico em roda plana bem	A adolescente sobrevive ao voo de cinco horas para o Havaí 'na roda do avião'
Rahul compara Modi com Hitler	Rahul Gandhi compara Narendra Modi a Hitler
Estrelas do Arsenal prontas para usar camisetas na luta de Pat Rice contra o câncer	Arsenal Grande arroz no hospital com câncer
FTSE Bursa Malaysia Atualização: 11h30	FTSE Bursa Malaysia Atualização: 15:00
27 mortos, 22 feridos no colapso da mina de carvão do Afeganistão	um ferido no colapso da construção da igreja metodista
A campanha eleitoral da Índia entra no último dia	Campanha eleitoral da Índia lutada amargamente entra no último dia
46 enfermeiros da Índia libertados no Iraque retornam para casa	46 enfermeiras indianas presas no Iraque retornam para casa
Sisi para concorrer a presidente egípcio	O projeto de constituição do Egito vai para o presidente interino
Abdullah Abdullah aumenta a liderança na votação presidencial afegã	No meio do caminho: Abdullah Abdullah lidera Ashraf Ghani em 11 % após a contagem parcial
A Greve dos Drones dos EUA mata seis funcionários do Paquistão	Drone Strike mata dezenas no Paquistão
Glasgow Helicopter Crash Search termina	Crash de helicóptero de Glasgow: Mulher PC é vítima
O Irã apoia a proposta de reunião sobre conflitos na Síria	O Irã diz Israel mentindo sobre foguetes
O vôo de Boston Marathon Bombing suspeitos terminou no caos	Raid no Suspeito de bombardeio de maratona de Boston capturado no filme
Os estoques de Taiwan fecham 1,11 pct mais baixo	As ações de Taiwan terminam 0,68 pct mais baixo
Três adolescentes israelenses desaparecidos na Cisjordânia	adolescentes do exército israelense desaparecidos na Cisjordânia
6 mortos, 26 doer na explosão da bomba das Filipinas	Seis mortos nas Filipinas Bomba de bomba
Helicóptero policial colide com pub em Glasgow - várias baixas	Helicóptero policial cai no topo do bar em Glasgow
Munidos de pistolas assassinam vice -ministro da indústria da Líbia	Mungeiros matam vice -ministro da indústria da Líbia
Citações nas notícias	Citações do dia
Taxas de câmbio em Cingapura	Taxas de câmbio na Índia
greve dos drones nos EUA 'mata 4 militantes no Paquistão'	Greve de drones nos EUA mata 10 no Paquistão
Philip sai do hospital após 11 dias	Mandela sai do hospital após 10 dias
fragmento ósseo 'poderia ser rei alfred'	permanece em Winchester pode ser o rei Alfred, o Grande
Israel libera o segundo grupo de prisioneiros palestinos	Israel lança 26 prisioneiros palestinos
O governo tailandês diz que as eleições de fevereiro. 2	O governo das Filipinas diz que as negociações de paz com os comunistas falharam
Ucrânia revoga a lei anti-protest, PM renuncia	Ucrânia para revogar as leis anti-protestos
dois paraquedistas mortos depois de colidir durante o salto	dois paraquedistas mortos depois de colidir durante o salto no Arizona
Quake sacode o nordeste do Japão, sem risco de tsunami	Quake atinge o Japão, sem aviso de tsunami
Margaret Thatcher, ex-premier do Reino Unido, morre aos 87 anos	A ex -primeiro -minia britânica Margaret Thatcher morre
O Parlamento Alemão aprova o pacote de ajuda de Chipre	Crise da zona do euro ao vivo: o parlamento alemão aprova o resgate de Chipre
Jetpacks 'Homem de Ferro' Spark preocupações no Havaí	Jetpacks de 'Homem de Ferro' façam preocupações
Israel libera prisioneiros palestinos	Israel lança 26 prisioneiros palestinos
A França diz que as responsabilidades de Won 'T' Shirk 'na Síria	A França pede que a UE seja unida na Síria
Suspeito de bombardeio de Boston identificado em vídeo de vigilância, sem prisão	O suspeito de bombardeio de Boston estava sob vigilância do FBI, diz a mãe
'Centenas ausentes' como deslizamentos de terra atingem aldeias afegãs	Centenas morrem em enorme deslizamento de terra afegão
Abdullah à frente na corrida eleitoral do Afeganistão	Abdullah liderando nas eleições presidenciais afegãs
A raiva da China em n. A Coréia supera se preocupa com nós	A raiva da China na Coréia do Norte supera a preocupação com os EUA voos furtivos
Ucrânia Presidente interino chama a reunião de emergência de ...	O presidente interino da Ucrânia convoca o Conselho de Segurança sobre agitações no sudeste
Estoques da China abrem na sexta -feira inferior	As ações da China se aproximam da quinta -feira
A Maratona de Londres observa o silêncio para as vítimas de bomba de Boston, o vídeo	A Maratona de Londres observa o silêncio para as vítimas de Boston
China Yuan se fortalece para o novo alto contra o USD	China yuan enfraquece para 6.1705 contra USD
homens armados cercam o Ministério das Relações Exteriores da Líbia para pressionar as demandas	O Ministério das Relações Exteriores da Líbia cortado por homens armados, diz o funcionário
Hom	Homem, 40 anos, preso após o tiro
Voo 370 Descobramentos de área de pesquisa à medida que avistamentos de satélite aumentam a esperança	Pesquisar MH370 ainda para segmentar o site de falha provavelmente, diz a empresa britânica Inmarsat
O crescimento do PIB Q2 da China diminui para 7,5 pct	O crescimento da China diminui para 75 em abril june Govt
A polícia interrompe a eleição presidencial das Maldivas	Keita ganha eleição presidencial do Mali
Kerry para se juntar às negociações nucleares do Irã em meio a esperanças de acordo	Kerry se junta às autoridades européias nas negociações nucleares do Irã
Exército indiano Mate 3 militantes na Caxemira controlada na Índia	Tropas indianas matam comandante militante na Caxemira controlada pela Índia
N Coréia adia reuniões familiares	A Coréia do Norte adia sindicatos da família devastados pela guerra
Palavra cruzada rápida - sexta -feira 31 de maio	Palavra cruzada clássica - sexta -feira 31 de maio
Neymar envia o Brasil para a Semis da Copa Confed	Neymar Powers Brasil para a Copa do Mundo nos últimos 16 anos
carro bomba mata 20 no noroeste da Síria	carro bomba mata 40 no noroeste do Paquistão
OMC atinge o primeiro acordo de reforma comercial	AMC alcance o acordo comercial histórico em Bali
O governador do Colorado visita a vítima de tiro na escola	O governador do Colorado visita a vítima de tiro na escola
troca de petróleo do Irã UPS com vizinhos orientais	Irã pede liberação rápida de diplomata
Presidente da Turquia apela para calma	Texas House aprova provisoriamente a lei do aborto
Teste da Coréia do Norte dispara 30 mísseis no mar	N Coréia 'dispara 100 conchas' no mar
nós. O Senado redigem a resolução de greve militar contra a Síria	Painel do Senado dos EUA aprova o uso da força contra a Síria
Homem morre em Conegal House Fire	Mulher morre em Conc Cork House Fire
A explosão de gás doha mata 12, machuca dezenas	míssil Síria mata 26, incluindo 8 crianças
O DNA do urso polar 'pode ajudar a combater a obesidade'	O estudo de urso polar pode aumentar a luta contra a obesidade
42 mortos, 63 feridos em violência no Iraque	44 mortos, 133 feridos na violência do Iraque
junta espera nas próximas eleições tailandesas em outubro de 2015	junta espera nas próximas eleições tailandesas em outubro de 2015
Pelo menos 350 mortos enquanto deslizamentos de terra atingem aldeias afegãs	Pelo menos 350 mortos como deslizamentos de terra Village
Assembléias de votação são abertas nas eleições presidenciais ucranianas	Nomeações abertas para e.tv Gana mais influentes prêmios
Índia tinta: Imagem do dia: 21 de abril	India Tint: Imagem do dia: 2 de maio
Bachelet viu o escoamento presidencial vencedor do Chile	Bachelet definido para uma grande vitória no confronto da pesquisa de 2 mulheres do Chile
Até 21, principalmente estrangeiros, mortos no ataque de suicídio de Cabul	13 estrangeiros entre 21 mortos no restaurante Kabul Attac ...
'Fast & amp; A estrela furiosa Paul Walker morre em acidente de carro	Paul Walker Dead: Fast and Furious Star, 40 anos, morto em acidente de carro
A Greve dos Drones dos EUA mata três no noroeste do Paquistão	A Greve dos Drones dos EUA mata 4 no noroeste do Paquistão
Equipe de armas químicas sequestradas na Síria, reivindicações de relatórios	A equipe de armas químicas atacou na Síria; Todos os membros seguros
Índice Hushen 300 fecha na quarta -feira alta	Índice Hushen 300 termina na segunda -feira
Dois jornalistas franceses mortos no Mali	França confirma dois jornalistas franceses mortos no Mali
Ataque aéreo mata um homem no hama da Síria	A greve dos drones nos EUA mata onze no Paquistão
Morsi, Exército pronto para confronto em 'Horário Final'	Mursi, Exército do Egito, pronto para morrer no confronto de 'horas finais'
O Irã precisa de mais usinas nucleares	Irã para construir a 2ª usina nuclear
Hakimullah Mehsud, chefe do Talebano Paquistão, morto em Drone Strike	O talibã paquistanês 'eleito novo chefe', voto 'sem precedentes' vingança
As ações chinesas fecham na sexta -feira	As ações chinesas abrem na sexta -feira inferior
PM turco, presidente colidem com a resposta aos protestos	O presidente turco pede calma em meio a protestos em todo o país
pistoleiros matam nove turistas no Paquistão	Gunmen Attack Hotel na província remota paquistanesa
Israel e Hamas para observar uma breve trégua de Gaza	Israel e Hamas 'aceitam trégua temporária'
África do Sul se une em oração e música para Mandela	Os sul -africanos embarcam no dia de ė äėprayer e reflexão, para Mandela
A China apressou o alívio depois que Sichuan Quake mata 180	A China apressou o alívio depois que Sichuan Quake mata 188
Equipe de armas químicas para começar conversas com a Síria	ONU especialistas em armas químicas para visitar a Síria
A Rússia diz que a Síria envia armas químicas enquanto civis fogem de bombas	A Rússia diz à Síria para remover armas químicas este mês
Onda de atentados, tiroteios matam 38 no Iraque	Onda de bombas de carro, outros ataques matam 31 no Iraque
O conturbado Xinjiang da China atingiu mais violência	A população on -line da China sobe para 618 mln
Cinco mortos em confrontos muçulmanos-cristãos no Egito	5 morre em confrontos cristãos-muçulmanos no Egito
Tony Blair rejeita 'Bizarre' afirma que a invasão do Iraque causou a crise	Crise do Iraque: Tony Blair rejeita as reivindicações de 'bizarro' em 2003 invasão causou uma situação atual
Quatro mortos na indústria de petróleo Crash Helicopter na Escócia	Quatro mortos no acidente de helicóptero da indústria de petróleo do Mar do Norte
Parentes se espalham com a polícia após a China Mate 120	Famílias irritadas exigem respostas depois que a planta da China mata 119
O Irã rejeita a reivindicação de bombas de cloro	O Irã rejeita a reivindicação da MKO no local nuclear
A esposa do ministro da Índia morreu 'morte não natural' após rumores de caso	A morte da esposa do ministro 'não natural'
A China nos supera como a maior nação comercial do mundo	A China deve nos ultrapassar como o maior comerciante de mercadorias do mundo
Erdogan critica a decisão judicial depois de levantar a proibição do Twitter	Erdogan bate o Top Court para levantar a proibição do Twitter
3 mortos, 1 doeu no tiro no São Carolina Oceanfront Motel	4 mortos, 30 feridos em colisão de trem perto de Moscou
O Egito adia os campos de dispersão pró-Morsi	O Egito adia o dispersando campos de protesto pró-Morsi
Enterro do Suspeito de Boston Bombing parece legal	'Pronto para ir para casa:' Last Boston Bombing Vítima deixa o hospital
5 mortos na caverna de rodovias da China	02: 41 156 mortos na China terremoto
Presidente da África do Sul: Mandela está melhorando	Presidente afegão atrasa a assinatura dos EUA
Atualização do World News, o que você precisa saber	Taxa de imposto de 50p do trabalho: o que você precisa saber
Guerra Civil Síria em Fotos	Síria Guerra Civil fala sobre negociações em risco do convite do Irã
As negociações nucleares iranianas para serem estendidas a novembro	NEW IRAN NUCLELEL KOLESS Provavelmente em novembro: Relatório
O Irã alerta contra a intervenção militar no Iraque	porta -voz da FM: Irã contra a interferência militar dos EUA no Iraque
Mianmar ordena que os médicos sem fronteiras suspendam todas as atividades no país	Médicos sem fronteiras expulsos de Mianmar
O avião militar dos EUA cai no Quirguistão	O avião de reabastecimento dos EUA cai no Quirguistão
ASIANA JET CRASC Lands no aeroporto de São Francisco	BOEING 777 PLANO PERDADOS NO AVERIOR DO SAN FRANCISCO
Israel aprova a liberação de 104 prisioneiros palestinos	Israel permite libertação de prisioneiros palestinos
Novos acertos fortes do terremoto quebraram a região de Pak	6.8 Quake na região do Paquistão quebrado
A China lança missão espacial mais antiga de todos os tempos	A China lança com sucesso a espaçonave tripulada
Blaze House mata 7 no norte do Paquistão	A Greve dos Drones dos EUA mata 8 no noroeste do Paquistão
Júri Arias, impulsionado pela pena de morte	Jodi Arias Júri Deadlocks na penalidade
Hoje na história, janeiro. 24	Hoje na história, fevereiro. 19
Desmond Tutu diz que participará do funeral Mandela	Tutu diz que vai participar do funeral Mandela
Abdullah aumenta a liderança na pesquisa presidencial afegã	Explosões ouvidas perto do Palácio Presidencial Afeganistão
Imran culpa o rival por assassinato	Paquistans Imran culpa rival por matar o membro do partido
O líder da oposição venezuelana procurou	Governo da Venezuela, oposição segue para o confronto
California Chrome ganha Preakness; Uma vitória da Triple Crown	California Chrome ganha Preakness, move uma vitória do Triple Crown
Bangladesh homenageia vítimas de fábrica	Pacto de segurança de fábrica de Bangladesh
Homem que incendiou o shopping nacional	O homem se chama fogo no National Mall, levado para o hospital
A polícia usa canhão de água como protesto de estupro de gangues da Índia se torna violento	Police Fire Gas Legic, canhão de água nos manifestantes de Istambul
O Egito muda o local do julgamento do presidente deposto	O Egito muda o local do julgamento do presidente deposto
A polícia diz que um suspeito em Boston Marathon bombardeia morto, um em geral	policial morto perto de Boston, link para bombardear pouco
O Japão defende a caça aos golfinhos após a crítica dos EUA	O Japão defende caçadores de golfinhos após críticas de nós
Shopping Rocks Shopping Rocks na Nigéria, 12 mortos	explosões de bombas antes da oposição indiana Rally Kill 4
Filipinas Typhoon Death Toll em 4.460: ONU	Filipinas Typhoon Death Toll sobe acima de 5.000
O exército sírio retém o castelo histórico de cruzados	00: 00 Tropas sírias Capture Castle Crusader
Terceira vítima do tiro de Santa Barbara identificado	5ª vítima de matrizes de tiro de Santa Monica
Police Fire Gas Legic em manifestantes de voto venezuelano	O herdeiro de Chávez Maduro vence a presidência da Venezuela
Os índices de ações de Xangai fecharam misturados - novembro. 11	Os índices de ações de Xangai fecham mais alto - 23 de julho
Onda de ataques mata pelo menos 95 no Iraque	O ataque suicida mata pelo menos 12 no norte do Iraque
Estreito forte atinge Java Central, Indonésia	Estrelado forte na Indonésia Oriental
A pessoa mais velha do mundo e o homem mais velho de todos os tempos morre aos 116	Japão: o homem mais velho do mundo já morre com 116 anos
A Arábia Saudita recusa o assento do Conselho de Segurança da ONU	A Arábia Saudita recusa o ponto de segurança da ONU
atentados suicidas gêmeos atingiram o acampamento do Iraque	11 mortos em atentados ao suicídio gêmeo do Iraque
O principal consultor político chinês encontra PM grego	O principal consultor político chinês conhece o presidente iemenita
Diplomata palestino ferido em explosão em Praga	embaixador palestino ferido em explosão de apartamento
Líder da Ucrânia promete palestras de crise	Líder da Ucrânia promete palestras de crise
Novo grande terremoto balança no sudoeste do Paquistão	Terremoto moderado atinge o sul do Paquistão
7 mortos em ataques no Iraque	16 mortos em série de ataques no Iraque
Inundações na Europa Central continuam a criar estragos	As inundações da Europa continuam a criar estragos
Presença militar dos EUA no leste da Ásia	Presença militar da OTAN UPS em meio à ameaça russa
As mortes aumentam em ataques aéreos israelenses em Gaza	As mortes aumentam em ataques aéreos em Gaza
Police Fire Limke Gas em manifestantes pró-Morsy	Polícia Turca Fire Gas Legic em manifestantes em Istambul
Grupo: 7 palestinos mortos na Síria	Palestino morto em Israeli Raid
Nós acreditamos que o governo sírio usava armas químicas	EUA suspeitam que a Síria usasse armas químicas
Potências mundiais e Irã para retomar negociações nucleares especializadas em dezembro. 30	Especialistas nucleares do Irã, poderes mundiais para retomar as negociações na próxima semana
A irmandade muçulmana do Egito se recusa a recuar	O Tribunal Egípcio condena o líder da Irmandade Muçulmana à prisão perpétua
Pelo menos 6 mortos no ônibus do Canadá, acidente de trem	Pelo menos 6 mortos no acidente de trem de Paris
Del Bosque inclui feridos Diego Costa na Espanha, esquadrão da Copa do Mundo	Espanha joga na Costa na equipe da Copa do Mundo de 23 homens
Presidente chinês encontra o PM grego, pedindo uma parceria mais forte	Presidente chinês encontra vice -presidente indiano
A AstraZeneca paga US $ 4,1 bilhões para comprar Bristol-Myers Squibb da Diabetes Alliance	AstraZeneca para comprar Bristol do Diabetes Venture por até US $ 4,1 bilhões
fugitivo italiano preso na República Dominicana	Austrália Breaker chega na Antártica Oriental para nova oferta de resgate
Suspeito de bombardeio de Boston permanece no hospital	Suspeito de bombardeio de Boston acusado na cama do hospital
Estoques indianos abrem mais baixo	Estoques indianos fecham mais baixo
Índia, nós para manter conversas na China na próxima semana	Egito para manter mais conversas com o FMI por empréstimo na próxima semana
6.6 Quake de magnitude atinge o Oceano Atlântico Sul-USGS	Magnitude-5.1 Quake atinge o sul do Irã-USGS
FAA eleva a proibição dos EUA Voos para Tel Aviv	FAA eleva a proibição dos EUA Voos para Israel
Taxas de câmbio em Cingapura	Taxas de câmbio em Hong Kong
Israel realizando uma ofensiva terrestre em Gaza	Israel lança ofensiva terrestre em Gaza
PM de Luxemburgo sai em meio a escândalo de espionagem	Votos de Luxemburgo após espionagem
Ehud Olmert, ex -primeiro -ministro israelense, condenado a seis anos de prisão por corrupção	Ehud Olmert condenou a seis anos em Israel
Bezos da Amazon resgatou pela Marinha Equadora	Bezos da Amazon resgatou pela Marinha do Equador devido à pedra dos rins
Brahimi pede desculpas à Síria por falta de progresso da paz	O mediador pede desculpas aos sírios por falta de progresso da paz
Território palestino ocupado: a UE, a Holanda e a Suécia contribuem com 18,9 milhões de dólares para o pagamento da autoridade palestina de salários e pensões da Autoridade Palestina	Território palestino ocupado: a UE, a Dinamarca, a Irlanda, a Itália, o Luxemburgo e a Holanda fazem uma contribuição de 16,4 milhões de 16,4 milhões de salários e pensões da autoridade palestina dos salários e pensões da autoridade palestina de abril
Os manifestantes egípcios emitem a demissão de Morsi Ultimatum	Os manifestantes da Ucrânia combatem a polícia em novos confrontos
Síria fala sobre paz em risco	Síria negociações de paz atrasadas novamente
5 coisas para saber sobre as Olimpíadas de Sochi	7 coisas para saber sobre etanol
China Yuan avança para 6.2035 contra US $ terça -feira	China Yuan avança ligeiramente para 6.1408 contra USD quarta -feira
As ações da China abrem mais baixo na quarta -feira	As ações da China se aproximam da segunda -feira
Atrasa nos EUA o teste de mísseis à medida que as tensões aumentam	William Hague: decisão dos EUA de interromper o teste de mísseis 'sensível'
O fogo em Pequim mata 10	Fogo em Pequim mata dez
A Nigéria oferece recompensa de US $ 300.000 por informações sobre meninas sequestradas	A Nigéria oferece 300000 recompensa por informações sobre meninas sequestradas
O vice -presidente das Maldivas renuncia à medida que as pesquisas são atingidas	O candidato presidencial das Maldivas se recusa a participar do escoamento-chave
O homem mais velho do mundo morre aos 116	Japão: o homem mais velho do mundo já morre com 116 anos
Palavra cruzada clássica - sexta -feira 31 de maio	Palavra cruzada clássica - sábado, 1º de junho
Israel lança ataques aéreos em Gaza após ataques de foguetes	Jets IAF atacam Gaza após fogueira
Vybz Kartel considerado culpado de assassinato	Vybz Kartel: Jamaican Dancehall Star considerado culpado de assassinato
Índia, Pacto de fronteira com tinta da China; 8 outros acordos	Índia, China Ink Acordo sobre rios transfronteiriços
Drone Strike em Hangu mata 8, ferimentos 5	Greve dos drones nos EUA no Paquistão mata cinco
Global Chemical Watchdog ganha o Prêmio Nobel da Paz	O Watchdog de armas químicas ganha o Prêmio Nobel da Paz
regime sírio 'usando armas químicas em pequena escala'	Casa Branca diz que a Síria usa armas químicas em conflito
3 mortos, 4 ausentes no acidente de construção da China Central	um morto, 8 faltando no acidente de barco do Vietnã
voto paquistaneses nas eleições marcantes	O Paquistão realiza eleições marcantes como 29 mortos em ataques
Venezuela expulsa três EUA diplomatas	Venezuela expulsa 3 EUA diplomatas
Boeing 777 acidentes enquanto aterrissam no aeroporto de São Francisco; 2 mortos; pontuações feridas	Boeing 777 acidentes enquanto aterrissam no aeroporto de São Francisco
Microsoft lança Office for iPad	Finalmente: Microsoft Touts Office for iPad, mas há um problema
Smog pesado atinge o norte da cidade da China, os vôos cancelados	Smog pesado atinge o norte da cidade da China, os vôos cancelados
William mais popular que a rainha - enquete	'Príncipe William mais popular que Queen, Charles'
A Índia se prepara como "Super Ciclone" para a costa leste	Índia no Alerta Vermelho como "Super Ciclone" se aproxima da costa leste
A Rússia afirma ter frustrado o possível ato de terror	Rússia diz
Os islâmicos machucados do Egito protestam após a semana sangrenta	Islamitas do Egito desafiador depois de confrontos mortais
A destruição química de armas sírias começa	Equipamentos de produção de armas químicas da Síria destruídas
3 turistas chineses mortos no Paquistão	Sete seqüestradores mortos no sul da Nigéria
Sevens World Cup dentro do Quênia, alcance	Clash of Styles in Tribunal abre julgamento no jovem, morte
EUA, a China não deixa de papel sobre rachaduras em laços	China: alívio em foco como esperança de perder desaparecidos
pistoleiros matam 10 turistas estrangeiros no norte do Paquistão	Militantes islâmicos matam 9 turistas estrangeiros, 1 paquistanesa
Austríaca encontrou acumulação 56 crânios roubados no Museu Home	crânios roubados encontrados no museu doméstico
O clima de inverno chega aos viajantes de Ação de Graças	O mau tempo chega a tempo para a viagem de Ação de Graças
Zeppelin rasgou a escada para o céu?	Led Zeppelin para ser processado por Stairway para o céu
O Egito lança ofensivo contra militantes do Sinai	O Egito lança ofensivo contra os insurgentes do Sinai
A onda de calor sudoeste de setembro é fatal	Pelo menos 1 morto, 40 hospitalizados no sudoeste de onda de calor
George w. Bush passa por procedimento cardíaco	Presidente George W. Bush tem procedimento de stent
Detroit elegível para proteção contra falência: EUA juiz	Detroit elegível para proteção de falência
Presidente da Argélia recebe terapia após derrame: mídia estatal	Presidente búlgaro tenta quebrar o impasse eleitoral
Autor do Nobel Britânico Doris Lessing Dies	O autor vencedor do Prêmio Nobel Doris Lessing Dies
A visita ao santuário de Abe atrai ampla condenação, crítica	Visita do Santuário de Guerra do PM japonês Shinzo Abe
01: 12 fã morre após a partida da Escócia de Rugby	Fã de rugby morre após a partida da Escócia contra Inglaterra
Gap se junta ao Acordo de Segurança de Bangladesh	As marcas globais se comprometem com a segurança de Bangladesh após o colapso
O governo israelense autoriza novos assentamentos antes das negociações	Israel aprova novas casas de assentamento antes das negociações de paz
Os índices de estoque Shenzhen fecham na segunda -feira	Os índices de estoque Shenzhen fecham mais alto - 23 de julho
Copa do Mundo LIVE: França 0-0 Alemanha	Copa do Mundo LIVE: Alemanha 0-0 Gana
Forças de segurança egípcias matam 30 manifestantes: Irmandade	FORÇAS DE SEGURANÇA EGPTIANA FILHO DO LIBRANHO DE IRTRIAÇÃO
Tóquio para hospedar 2020 jogos	Tóquio ganha correr para sediar os Jogos Olímpicos de 2020
Bombeiros não contabilizados para lutar contra Ariz. chama	Os bombeiros perecem no Arizona Blaza
Chefe do Talebano Paquistão morto no greve dos drones dos EUA	Funeral para o chefe do Taliban do Paquistão 'Set to Acto'
Putin assina o Tratado de Anexo da Crimea	09: 32 Sinais de Putin da Anexação da Crimeia
A FAA continua proibindo os vôos dos EUA para Tel Aviv	FAA eleva a proibição dos EUA Voos para Tel Aviv
Modi Condoles as pessoas que morreram em Mumbai Stampede	Relatórios da mídia indiana: 18 mortos em Mumbai Stampede
Mandela permanece em condição crítica, mas estável: Zuma	Mandela na condição ė äėcritical, mas estável
A França alerta de extremistas que se beneficiam da violência do Egito	França teme que os extremistas se beneficiarão da violência do Egito
O líder do Brasil quebra o silêncio sobre protestos	O líder do Brasil quebra o silêncio sobre protestos
O número de mortos aumenta no colapso de Dhaka Building	Dois morrem no colapso do edifício de Mumbai
A China exige respostas de nós por causa de reivindicações de espionagem	A China exige explicação de nós no relatório de espionagem da Huawei
Enviado chinês refuta as acusações vietnamitas e filipinas sobre o Mar da China Meridional	O XI da China diz ao Vietnã que quer paz no Mar da China Meridional
Partido da oposição tailandesa para boicotar a eleição geral	A oposição do Partido Democrata da Tailândia anuncia boicote às eleições gerais de fevereiro
Mais quatro pessoas presas sobre o maior sindicato de importação de tabaco ilegal da Austrália	A polícia tem como alvo o sindicato de tabaco ilegal
9 mortos em ataque ao consulado indiano no Afeganistão	12 mortos em ataque ao consulado indiano na cidade afegã
Iêmen: lutar no norte mata mais de 120	Janet Yellen: Cinco coisas que você pode não saber
Obama se move para preencher a placa do Fed, torneia Fischer para ser não. 2	Obama expressa vontade de conversar com o Partido Republicano com orçamento
Acordo de alcance dos EUA-Rússia na Síria	Acordo de alcance dos EUA-Rússia sobre armas da Síria
Musharraf do Paquistão acusou o assassinato de Bhutto	Musharraf do Paquistão acusado de morte de Bhutto
O presidente do Irã condena o uso de armas químicas na Síria	sonda alegada uso de armas químicas na Síria
uma sociedade se desgastando nas bordas	Alinhamentos de TV antigos racham nas bordas
ONU convida a Conferência de Paz do Irã para a Síria	ONU: Irã convidou a participar da Conferência de Paz Síria
Itália Bus Crash Death Toll Rises	Starbucks limpa o caminho da faculdade para os trabalhadores
ONU retrai o convite do Irã para as negociações da Síria	O chefe da ONU retira convite para o Irã se juntar às negociações de paz na Síria
Ref, perfurados por jogadores morre	Polícia: o árbitro de futebol de Utah socado pelo jogador morre
Angela Merkel se dirigiu para uma vitória estreita nas eleições alemãs	O novo presidente do Malawi emposs
Adolescente britânico morto no outono do Magaluf Hotel	Adolescente britânico morto no Magaluf Hotel Fall
Irã FM confere com o presidente interino iraquiano	Rouhani se torna novo presidente iraniano
Israel detém 37 palestinos à medida que a operação de prisão continua	Israel critica a postura palestina sobre os colonos
Os rebeldes matam 21 civis na Síria Alawite Village	Bomba mata 18 civis no Afeganistão
O mundo envia alívio de emergência para as Filipinas agredidas	Typhoon Haiyan: World envia alívio às Filipinas agredidas
Revisão dos jornais: Abbas, foco de fala dos diários	Revisão dos jornais: Nakba Day Events Focus of Dailies
Israel: a Síria deve ser despojada de armas químicas	Síria concorda em entregar armas químicas
Carrente de fome palestina, Israel Reach Deal	Ativista palestino detido em Israeli Raid
policial da Malásia morto, outro sequestrado em Sabah	Hunt maciça por pistoleiros depois que o policial matou, outro sequestrado durante o tiroteio de Sabah
O número final de mortes no colapso do edifício de Mumbai é de 60	Toll Toll atinge 72 no colapso do edifício de Mumbai
Votos do Parlamento da Crimeia para ingressar na Rússia	O Parlamento da Crimeia se aplica formalmente para ingressar na Rússia
Assad diz que a Síria irá cumprir com a resolução dos braços da ONU	Assad da Síria promete em conformidade com a ONU. resolução
O Parlamento da Crimeia se aplica formalmente para ingressar na Rússia	Votos do Parlamento da Crimeia para ingressar na Rússia
Os apoiadores de Morsi pediram a abandonar os sit-ins	Os apoiadores de Morsi protestam no Egito
Presidente sul -coreano Desculpe pela resposta da balsa	s. Presidente coreano 'Sorry' pelo desastre de balsa
'Inspeção rápida' das defesas de inundação	'Inspeção rápida' das defesas de inundação da Grã -Bretanha
Aumos de preços alimentares levantam preocupações no Irã	American Chris Horner vence o tour pela Espanha
Obama tomou decisão de última hora sobre a aprovação da Síria	Obama Mulls limitou ação militar na Síria