Cão pequeno mastiga em um grande graveto.	Um cachorro mostra em um grande graveto.
Um tenista batendo na bola.	Dois meninos espirrando no surf.
um snowboarder solitário no meio de uma rajada de neve	Um snowboarder está jogando neve enquanto ele monta sua tábua.
Um par de cães brincando com uma bola roxa.	Dois cães brincam com futebol roxo.
Um pássaro pousa na água.	Um barco flutua na água.
Um grupo de jovens canta juntos.	Um grupo de jovens mulheres está juntas.
Um grupo de homens joga rugby.	Um grupo de homens está jogando bola juntos.
Três crianças estão em uma cerca ou perto de uma cerca.	As três crianças estão de pé e por uma cerca.
Um cachorro preto emerge da água com uma bola branca na boca.	Um cachorro preto saindo da água com uma bola branca na boca.
Dois cães profundamente na água.	Dois cães marrons brincam na água.
Um barco flutua na água.	um barco na água.
Uma garota de camisa roxa e bandana rosa posando	Uma jovem usando um chapéu e jeans azul está em um balanço.
Cão marrom e branco com beisebol na boca, campo e construção.	Cão marrom e branco com uma bola de beisebol na boca.
um cachorro marrom cavando um buraco na frente de uma planta	Um grupo de pessoas andando ao lado de uma ferrovia.
Um cachorro marrom e branco está correndo por um campo sem cortes que tem cogumelos.	Cachorro marrom e branco correndo por um campo gramado.
O cachorro marrom e branco nada em uma piscina.	Um cachorro marrom e branco nada em uma piscina no quintal.
Dois cães cinzentos correm juntos sobre a grama verde.	Dois cães cinzentos correndo em grama verde.
Um garoto de trenó vermelho está andando pela colina.	Um cachorro multicolorido em um colarinho vermelho agachado na grama.
Um cachorro correu na água para pegar uma bola na boca.	um cachorro que atravessa a água com uma bola na boca
Os cães estão correndo pela água	O cachorro passa pela neve.
Um cachorro branco e marrom rola as costas na areia.	Um cachorro deitado de costas na areia.
Um cachorro atravessa a grama.	Dois cães correndo pela grama.
Dois cães brincam na grama.	Dois cães brincando na neve.
Um cachorro preto e marrom atravessa a floresta.	Um cachorro correndo pela floresta.
Cachorro marrom e branco brincando na grama.	Cão preto e branco pulando para Frisbee.
Os dois cães estão correndo na grama.	Dois cães estão brincando na grama.
Dois cães estão correndo em um campo gramado	Dois cães correndo por um campo gramado.
O casal está sentado perto da água em cadeiras de gramado.	O garoto pula de uma mesa de piquenique para a outra no parque.
Um jogador de futebol americano está usando uma faixa vermelha e branca.	Um homem vestindo um uniforme de futebol vermelho e luvas cinza olha para a esquerda.
Três pessoas sentam -se em uma mesa de piquenique fora de um prédio pintado como um union jack.	Três pessoas sentam -se em uma mesa ao ar livre em frente a um prédio pintado como o Union Jack.
Um grupo de pessoas em uma varanda em um ambiente muito moderno.	um grupo de pessoas em uma pequena varanda de um grande edifício
Um cachorro branco cheirando ovelhas através de uma cerca.	Dog e fofo branco beijando ovelhas através de uma cerca.
Uma jovem mantém um sinal de paz.	Uma garotinha segura um poste em uma rua da cidade.
Um homem está pendurado por uma linha de um penhasco acima da água.	Homem sentado sozinho em um píer com uma garrafa de água.
Um homem agachado e segurando uma câmera.	O homem agachado está segurando uma câmera grande.
Dois cães correm pela lama.	Dois cães correm pela neve.
Homem andando de bicicleta por um caminho estreito.	um homem andando de uniciclo em uma estrada pavimentada
Um homem vestindo um casaco laranja fala com outro enquanto eles andam na neve.	Um homem e uma mulher vestindo roupas de moda antiga sentam -se do lado de fora à mesa.
Um cachorro nada na água.	Um cachorro vestindo uma capa está correndo pela neve.
Um cachorro marrom e branco correndo na grama.	Um cachorro marrom e branco correndo rápido em um quintal cercado.
Shephard alemão pulando através do arco preto enquanto as pessoas assistem	Um cachorro pula através de um aro.
Uma jovem que usa um collant azul pula no ar.	Uma jovem está no ar fazendo ginástica.
Um cachorro está pulando no ar para pegar um brinquedo.	Um cachorro preto pula no ar para pegar um brinquedo.
Uma jovem garota e um menino estão tocando em um grande tambor.	Uma menina e um menino estão ao lado de um violão e um tambor.
Um garoto com um mohawk roxo tocando violino.	Um garoto com um mohawk azul toca violino.
Um cachorro marrom deitado em uma tampa azul.	Uma pessoa está mergulhando em água azul clara.
Os dois meninos jogam no campo.	As duas pessoas têm a cabeça coberta com lenços.
O cachorro marrom corre na neve com uma bola branca na boca.	Quatro cães brincam na neve com o horizonte da cidade atrás deles.
Um cachorro preto e branco pulando sobre uma barra vermelha e branca.	Um cachorro está pulando sobre uma barra vermelha e branca.
Uma mulher de casaco verde está perto de um telefone paga.	Uma mulher de casaco se reclina ao lado de um telefone paga.
um grupo de pessoas em pé na rua	Uma mulher abordando um grupo diversificado de pessoas em pé na rua.
Uma jovem menina de capacete andando de skate por uma calçada.	Um menino de capacete está fazendo truques em um skate.
Dois cães estão brincando em um hardscape.	Dois cães estão brincando na grama.
pessoas e camelos em uma praia.	Pessoas andando pela calçada em uma praia.
Um cachorro corre na grama marrom.	Um cachorro molhado atravessa a grama amarela segurando uma bola de tênis.
Um homem está escalando em uma rocha natural.	Uma mulher com sapatos brilhantes em um evento ao ar livre.
Um grupo de homens de terno está em frente a uma estátua de um leão.	homens em pé na frente de uma estátua de um leão.
Um cachorro marrom está correndo na neve com um cachorro preto menor correndo atrás dele.	Um cão marrom grande e um pequeno cachorro preto a pé na neve.
Um cachorro preto e branco correndo em um parque de neve.	Um cachorro preto e branco está pulando na neve em um parque.
Os dois cães estão correndo pela grama.	Três cães correm na neve.
Dois cães correndo pela areia.	Três cães correndo por um campo.
O homem e dois meninos pularem em um trampolim.	Um homem e dois meninos pularem em um trampolim.
Um homem comendo uma maçã, sentado em público.	Um homem fica em um local público comendo uma maçã.
Um garoto com um braço quebrado está descansando em uma cama.	Um menino com um braço quebrado está dormindo.
Um cachorro preto segura um pneu e uma bola na boca quando o outro o segue.	Um cachorro nascido carrega algumas frutas na boca, enquanto dois outros cães o seguem.
Um cachorro preto contorna através de um caminho na neve.	Dois filhos e um cachorro brincam na neve.
menino fazendo truques em um skate	Um menino faz um truque em um skate.
Quatro meninos se sentam na lama.	Quatro meninos estão sentados em um riacho lamacento.
Duas garotas se abraçam na grama.	duas meninas se segurando no terreno gramado
Dois cães brancos estão andando pela neve branca profunda.	Dois cães brancos andam por uma enorme margem de neve da montanha.
Quatro garotas em roupas de banho estão jogando vôlei na praia.	Quatro mulheres em biquínis estão jogando vôlei na praia.
Um pássaro voa sobre a água.	Um pássaro voa acima da água.
Três cães correndo em um campo de grama.	Dois cães correm em um campo de grama alta.
Um cachorro está correndo por um lago	Um cachorro pálido está correndo ao longo de um caminho de terra.
Dois cães estão brincando em um cercado no quintal.	Três cães brincando na neve.
O cachorro marrom e preto está no topo do cachorro branco.	O grande cachorro marrom e preto está em cima de um pequeno cachorro branco.
Um garoto pulo começa a uma doca em um lago.	Um menino pulando de uma doca em um lago.
Três cães brincando na neve.	Três cães estão brincando na água.
Uma garotinha com uma fita no cabelo está pegando o nariz.	Uma garotinha de camisa roxa e capacete está andando em uma scooter.
Um cachorro marrom está correndo em uma pedra.	um cachorro marrom correndo.
Um garoto usando óculos de sol parece em frente.	Um garoto usando óculos tem seu cabelo pronto para se levantar.
um grupo de pessoas rafting em uma balsa azul.	Um grupo de pessoas remará sua jangada inflável azul nas corredeiras.
Uma mulher esquia por uma colina nevada.	Uma pessoa esquie em uma colina nevada.
Um homem e uma mulher assistem a dois cães.	Um homem em um maiô marrom oscila em uma corda em um lago.
Um homem fica sentado ao lado de uma doca olhando para a água.	Um homem pula de uma pedra na água
Uma jovem menina descendo um slide de tubo.	uma jovem menina balançando um balanço do pneu
Um grande cachorro preto corre ao longo da grama verde.	Um cachorro cinza corre ao longo da grama verde.
um menino pendurado em uma academia na selva	Um menino balança em uma academia na selva.
As meninas vestidas com roupas vermelhas e pretas mantêm uma pose de luta livre.	Duas garotas vestidas como garçonetes dançam junto com um homem vestido como chef.
Muitas pessoas estão nas corridas de bicicleta, incluindo um homem em uma bicicleta de três rodas.	Um homem andando em uma cadeira de rodas de três rodas.
Uma dalmation está correndo ao longo da praia.	Um cachorro branco está correndo na areia.
Uma jovem menina usando óculos e uma camiseta laranja sopra uma grande bolha clara.	A jovem sopra uma bolha enorme.
Dois homens estão em pé em frente a uma montanha coberta de neve.	Dois homens posam em uma área rochosa em frente a uma montanha nevada.
Um grupo de pessoas está usando orelhas de coelho.	Um grupo de pessoas corre em uma corrida
Um homem de camisa vermelha tira uma foto de meninas usando vestidos e penas.	Um homem tira uma foto de seu amigo com artistas.
Um homem e uma mulher posam na neve com quatro filhos.	Um homem e uma mulher posam para a câmera com lábios presos.
Um cachorro em uma camisa "Superman" dorme em um cobertor.	Um cachorro marrom em uma camisa do Super -Homem está deitado em um cobertor azul.
Um cachorro marrom e branco está correndo pela neve.	Um cachorro marrom e branco está correndo na grama.
Homem vestindo uma boina andando de bicicleta	Um homem em uma boina monta uma bicicleta na rua.
Um cachorro bronzeado está puxando um trenó vermelho na neve.	Um cachorro está puxando um trenó vermelho na neve.
Um cachorro preto correndo com um brinquedo em preto e branco na boca.	Um cachorro preto voa pelo ar enquanto segura um objeto na boca.
O cachorro branco e marrom atravessa a grama.	Um cachorro marrom e branco atravessa a grama.
Um bebê que entra em uma fonte de água.	um bebê tentando pegar água de uma fonte na boca
Dois cães pretos passam por um campo.	Dois cães manchados estão passando por um campo
Um homem e uma mulher estão em frente a um prédio	Duas meninas estão sentadas em um ATV na areia em frente a uma ponte.
Um cachorro preto está perseguindo um frisbee vermelho.	Dog preto perseguindo um frisbee laranja.
Uma jovem menina, em um vestido laranja, segurando uma raquete de tênis.	Uma garota de vestido segura uma raquete de tênis.
Um bebê sorridente está sentado em uma grande banheira de plástico de água.	Um bebê está tomando banho em uma tigela cheia de água.
Um cachorro marrom está descansando as patas em um teclado laptop.	Um cachorro fica com suas patas em um laptop.
Uma jovem menina com óculos senta e segura duas bandeiras americanas.	Uma garota de óculos está olhando sobre duas bandeiras americanas perto de uma área arborizada.
Um pequeno cachorro branco e marrom está pulando sobre um poste horizontal.	um cachorro marrom e branco pulando sobre um poste vermelho e amarelo
Um garoto pula de um sofá para outro.	Um garoto está pulando de uma cadeira para outra.
Dois pequenos cães brancos estão brincando na neve.	Dois pequenos cães laranja e brancos estão na neve.
Um cachorro preto e um cachorro marrom correm ao longo de um caminho de terra.	Um cachorro preto e um cachorro marrom e branco correndo e brincando.
Uma criança monta um cavalo de madeira.	A criança está em um cavalo de balanço de madeira.
um cachorro preto e branco correndo por alguns postes vermelhos e brancos	O cachorro branco está passando por postes brancos em uma pista de obstáculos.
Um cachorro pula em um gramado.	Um cachorro pula de prancha de surf
Dois cães touros brincando no chão.	Dois cães brincando no tapete.
Dois cães estão correndo por uma área gramada.	Dois cães correndo por um campo gramado.
Crianças jogando bola no parque.	Dois cães brincando na costa.
Um homem com um braço elenco filma algo em vídeo enquanto outro homem está olhando para a câmera.	Um homem com um elenco filma algum vídeo enquanto outro homem sorri.
Baby com tranças loiras na sala amarela tentando sair do Playpen Verde.	Uma criança do sexo feminino em Pigtails está tentando sair de um peito verde e branco.
Um cachorro branco olha para um filhote preto na neve.	Um grande cachorro branco e um pequeno cachorro preto sentam na neve.
Um homem está balançando em uma corda acima da água.	Um homem com roupas quentes balançando em barras de macaco à noite.
Um homem em um traje está andando de bicicleta pela estrada pavimentada.	Um homem está usando um poste grande para remover letras de um sinal.
Dois homens asiáticos e mulher asiática sentam -se em cadeiras de massagem negra.	Dois homens asiáticos e uma mulher estão relaxando em cadeiras de massagem.
Um cachorro preto e branco está correndo em um jardim gramado cercado por uma cerca branca.	Um cachorro preto e branco está pulando sobre um obstáculo.
Um homem velho está dormindo em uma mesa em frente a uma prateleira de livro.	Um homem mais velho e careca adormecendo em uma cadeira em frente a estantes de livros.
O grupo de caminhantes está descansando em frente a uma montanha.	Vários caminhantes descansam com o equipamento em frente a uma montanha.
Uma garota tocando é uma pilha de bolas coloridas.	Uma garotinha joga em um poço de bolas coloridas.
Uma mulher faz um pino na praia.	uma garota loira fazendo um pino na praia
Um Golden Retriever está pulando de uma varanda de madeira	Um cachorro de ouro pulando de uma varanda de madeira.
O homem fica ao lado de uma mulher vestida como um policial falso.	Um homem e uma mulher vestidos como prisioneiros e policiais sexy.
Um homem mais velho está do lado de fora em frente a um caminhão.	Uma mulher vestida de verde está patinando do lado de fora em um evento.
Duas meninas estão brincando em um trampolim.	Duas garotas loiras estão brincando juntas.
Homem sorridente com classes reflexivas.	Um cavalheiro sorrindo e mostrando seus óculos de sol reflexivos.
Cinco pessoas em pé em uma calçada	Cinco pessoas em uma calçada.
Um menino fica na piscina no fundo de um escorregador de água azul.	Um garoto espirra em uma piscina, ejetado de um escorregador aquático.
Um homem está trocando uma colina gramada.	O caminhante está seguindo uma trilha em subida.
Dois adolescentes se amontoam em uma porta na chuva.	Duas pessoas vestindo moletons se amontoam em uma porta na chuva.
Duas garotas de vestidos azuis e cercas e chapéus grandes estão parados ao lado de um grande tronco de árvore.	Uma mulher, um menino, e um pequeno bebê estão de pé na frente de uma estátua de vaca.
A criança tem um colar e está na água.	Uma criança em Orange está em uma prancha de boogie nas ondas.
O cachorro branco atravessa a neve.	Um urso branco caminha ao longo do chão coberto de neve e lança uma sombra na neve.
Um grupo de jogadores de futebol correndo pelo campo.	Jogadores de futebol estão em campo.
Um grupo de piqueniques senta -se sob um guarda -chuva.	Um grupo de pessoas está deitado na grama sob um guarda -chuva.
Dois cães marrons lutam de brincadeira na neve.	Dois cães marrons estão correndo na areia.
Um garoto de jaqueta marrom brincando com neve.	Dois cães estão brincando na neve.
Dois meninos estão correndo em torno de um campo.	Dois cães estão correndo no campo.
Um caminhante carregando uma mochila está passando por uma cachoeira.	Um caminhante com uma mochila está andando perto de uma cachoeira.
Um menino de camisa azul e shorts pulando uma bicicleta com uma rampa.	Menino de bicicleta pulando de uma rampa.
Três golfinhos estão pulando de uma piscina na frente de uma multidão de pessoas.	Um homem está fazendo uma apresentação na frente de muitas pessoas.
Um homem pegando uma grande pedra.	Uma mulher pegando uma grande pedra.
Um cachorro branco e marrom está correndo sobre a grama.	Um cachorro marrom e branco está correndo pela grama.
Duas pessoas vestidas como animais perto de uma multidão.	As pessoas em trajes de animais divertem uma multidão.
O cachorro está passando por um campo.	Um cachorro passa por um campo.
Um cachorro preto e branco está pulando na água.	Um cachorro branco atravessa a água.
Dois cães negros brincando na neve.	Dois cães brincando na neve perto de uma cadeira.
O homem está carregando uma caixa de ferramentas na calçada.	Uma mulher está andando de bicicleta azul em um parque.
Um homem usando uma camiseta que diz "Gigolo" fica no balcão conversando com alguém.	Um homem usando uma camisa que diz "Gigolo" está em uma área de recepção com as costas para a câmera.
uma barraca e um acampamento em uma floresta iluminada pelo sol.	Um cachorro branco na praia está carregando um graveto na boca.
Dois cães grandes correndo em um pouco de grama.	Dois cães com tigrado correndo na grama.
Um cachorro nadando com um graveto na boca da sua boca.	Um cachorro correndo com um graveto na boca.
Um grupo de quatro caminhadas através de uma floresta nevada.	Um grupo de pessoas caminha através de uma área arborizada nevada.
Dois cães negros brincando na neve.	Um cachorro brincando na neve.
Um cachorro está correndo pela grama alta.	Uma escavação está caminhando pela neve.
Uma mulher está se sentando dormindo com a cabeça descansando na mão.	Um homem que está descansando a cabeça na mão.
Um garoto pulando em um lago.	O garoto está pulando em um lago.
Um menino, em uma jaqueta de camuflagem, olha para uma exibição de muitos patos de borracha amarela.	Um garoto olha para uma exibição de patos de borracha.
Homem no skate em cima do barril colorido da ferrugem em área escura.	Um homem e um skate em cima de um barril.
Um surfista monta a onda.	O surfista está na onda.
Dois caras estão brincando com dois cães na praia.	Dois meninos brincam com dois cães na costa.
Cão marrom claro correndo em direção a algo na praia.	Um cachorro marrom persegue um loiro na grama.
Um grupo de pessoas perto de uma casa divertida em um carnaval.	Um grupo de pessoas está olhando e tirando fotos de algo fora da câmera.
Um homem jogando buscando dois cães marrons.	Uma mulher brinca com um cachorro marrom.
Um cachorro bronzeado e branco recuperando uma bola em um caminho de cascalho.	Um cachorro grande caminha ao longo de um caminho de cascalho na floresta.
Duas pessoas e um cachorro estão na neve.	Duas pessoas brincando em uma colina nevada.
Um cachorro está correndo sobre a areia com um graveto na boca.	Um cachorro está correndo por um riacho com um graveto na boca.
Um homem está de pé na água perto de uma cachoeira.	Um homem entra na água e observa uma queda de água.
Um cachorro preto está perseguindo dois pássaros na costa do oceano.	Um cachorro está correndo ao longo da praia ao lado do oceano.
Um surfista está andando em uma onda de quebra.	Um surfista está montando uma onda.
um homem e uma mulher em um banco.	Um homem e uma mulher sentam -se em um banco de parque.
Três cães estão brincando na neve branca.	Um cachorro está brincando na neve profunda.
Uma garotinha tira uma foto enquanto mamãe assiste no tédio.	Uma garotinha de pijama tira uma foto com uma câmera
Um galgo pula sobre uma corrente.	Um cachorro pula sobre uma corrente.
Um cachorro bronzeado pula para pegar uma bola de tênis.	Um cachorro vermelho pula e pega uma bola de tênis na boca.
Uma criança em shorts azul está no tornozelo no fundo da água.	Um menino em shorts azuis, óculos e um casaco fica nas ondas.
O homem está pulando na água.	O homem está no ar.
Um cachorro preto e branco está correndo pela grama.	Um cachorro preto e branco está pulando na grama.
Uma mulher de camisa preta fica em frente a bananas em um suporte de frutas.	Uma mulher vestindo estandes pretos na frente de uma caminhonete.
Uma criança está pulando em uma piscina.	Um cachorro pulando em uma piscina.
Dois cães estão roendo uma bola azul e amarela.	Dois cães brincando com uma bola azul e verde.
esqui de homem e criança.	Uma criança vai esquiar.
Dois cães pretos e marrons estão correndo por um campo.	Dois cães estão correndo juntos lá fora.
Um menino pulando de uma cadeira para outra.	um garoto pulando de uma cadeira para outra em sua casa
Uma garota balança seus cabelos compridos e molhados em um lago.	uma pessoa andando de bicicleta de terra.
Dois cães brincando na costa.	Dois cães brincando na neve.
Uma garotinha caminha em um calçadão com cúpulas azuis ao fundo.	um homem que pulando um salto em sua bicicleta com um rio ao fundo
Um cachorro marrom e branco está subindo degraus de neve.	Um cachorro preto e branco brinca na neve.
O cachorro marrom está deitado em um lençol azul.	Um cachorro marrom e dois cães pretos em um campo gramado coberto de vegetação.
um jovem vestindo uma camisa verde em pular no ar	Um cachorro bronzeado assistindo a um cachorro marrom nadando em um lago.
Um cachorro marrom pula sobre o obstáculo com chamas em cada extremidade.	Um cachorro marrom claro pulando sobre um obstáculo que tem fogo em cada extremidade.
Duas mulheres sentadas em um banco, seus rostos obscurecidos, com uma mulher carregando um tigre inflável e a outra mulher em uma fantasia de Branca de Neve da Disney.	Uma garota senta -se em um banco segurando um tigre inflável ao lado de outra garota com uma roupa colorida.
Um cara e duas meninas estão sorrindo para a câmera.	Três cães, um branco e dois marrons, estão correndo juntos em um campo de grama.
Um cachorro nadando com um graveto na boca da sua boca.	Cachorro nadando na água com um graveto na boca.
uma pessoa snowboard e pulando sobre um sinal de construção.	Um longo snowboarder pulando sobre uma barricada lá fora na neve.
Um poodle preto toca na neve.	Uma brincadeira preta de poodle na neve.
Dois oficiais com jaquetas laranja ficam do lado de fora de uma barraca branca com espectadores.	Homens com chapéus em pé do lado de fora de uma barraca branca.
Um cachorro preto pega uma bola de tênis na boca enquanto um cachorro branco observa.	Um cachorro preto pula para pegar uma bola na boca perto de uma parede de pedra.
Duas garotas segurando um panfleto de filme assustador	Duas meninas segurando sacos estão em um campo.
Dois cães pequenos atravessam a grama.	Um cachorro atravessa a floresta.
Três meninos estão correndo na praia jogando um jogo.	Dois meninos e um jovem correm em uma praia com água atrás deles.
Dois cães na água enquanto um homem olha de uma doca.	Dois cães estão correndo na água enquanto um homem observa da doca.
As crianças andam de barco na água.	As quatro crianças estão montando uma balsa na água.
Uma garota está usando uma faixa roxa e uma saia combinando.	Um grupo de garotas usando saias Jean e Superman Shirts.
Um grande pássaro branco balança sobre a água.	Um grande pássaro branco voando sobre a água.
Um homem tira fotos na beira da água.	Um homem careca está tirando fotos de um corpo de água de uma câmera.
Dois cães brigando na neve.	Dois cães em pé na neve.
O homem e dois meninos pularem em um trampolim.	Um homem e dois meninos estão pulando em um trampolim.
Uma criança pequena desliza por um escorregador roxo.	Uma garota desliza por um escorregador roxo.
Um homem vestindo uma jaqueta cinza parada ao lado de uma rua.	Um garoto vestindo um colete salva -vidas azul está segurando ao lado de um barco verde.
Um cachorro marrom e preto está pulando para pegar uma bola vermelha.	Um cachorro marrom e preto pula para uma bola vermelha.
Um cachorro preto caminha por um pouco de água.	Um cachorro marrom caminha pela neve.
O cachorro bronzeado atravessa as folhas.	O cachorro branco atravessa o oceano.
Um cachorro branco e preto está pulando em uma piscina.	Uma mulher em um avental preto está em pé na frente de um espelho.
Um cachorro preto e branco está carregando um graveto na boca.	O cachorro preto e branco tem um graveto nas patas.
Um cervo pula uma cerca.	um cervo pulando sobre uma cerca.
O cachorro preto carrega um objeto na neve.	Um cachorro preto carrega um brinquedo branco na boca e caminha no campo de neve.
Um homem vestido com uma fantasia do Batman.	Um homem está posando vestido com uma fantasia do Batman.
Uma garotinha segura um bastão de madeira.	Uma garotinha nadando em uma piscina.
Um cachorro preto pula pela água.	Um cachorro caminha pela neve.
um grupo de pessoas em frente a um caminhão de bombeiros vermelho.	Um grupo de pessoas está em torno de um caminhão de bombeiros vermelho.
Um homem vestindo um capacete de bicicleta vermelho conversando em um telefone celular com outras pessoas em segundo plano.	Um homem em um capacete de bicicleta está falando em um telefone celular com outras pessoas atrás dele.
Um menino pula na água da piscina azul.	O garoto está pulando na piscina na barriga.
Um cachorro loiro está pegando uma bola na boca na neve.	Uma menina loira está sentada em uma cadeira verde.
três filhos e brincando e rindo no chão.	Três crianças brincando no chão.
Um homem fica sentado com postes de pesca perto de um corpo de água.	Um homem senta -se em uma pedra ao lado de uma cadeira dobrável e um poste de pesca.
Alguém dispara uma bala de uma pistola na floresta.	Um close de um homem atirando uma pistola na floresta.
Uma mulher e um cachorro em pé na grama.	Um homem carrega uma placa em pé na chuva.
Dois cães estão brincando em um campo gramado.	Dois cães brincam em um campo arenoso.
Um homem de camisa laranja jogando tênis.	um homem vestindo um u laranja. camiseta de Miami jogando tênis
Um homem de camisa azul está correndo em um campo de estádio.	Um homem vestindo um chapéu e camisa azul está montando um cavalo branco.
Um cachorro marrom um cachorro branco escorre por uma rampa amarela e azul.	Um cachorro marrom e branco saindo de uma rampa amarela e azul em uma área gramada.
Uma mulher de jaqueta preta e laranja joga um graveto para um cachorro marrom e preto buscar.	O homem de jaqueta azul está de pé na multidão.
Uma garota pulando em uma duna de areia no oceano.	A menina pula no ar com a areia embaixo dela.
Um cachorro preto que atravessa a água.	Um cachorro preto está passando por um pouco de água.
Crianças pulando em um trampolim.	Um homem está trenó em um slide laranja.
Um cão marrom grande está agachado em um campo gramado.	Um cachorro marrom está correndo em um campo.
Uma criança brincando em um jogo de playground.	Uma criança balançando em um jogo de playground.
Um homem praticando boxe	Um homem pratica boxe
duas mulheres olhando para uma caixa de vidro.	Uma jovem de biquíni olhando para algo em uma caixa de vidro.
Uma garota com um capacete roxo e branco está montando em uma scooter.	Uma garota usando um capacete monta uma scooter.
Um menino de capacete está fazendo truques em um skate.	Um garoto está completando um salto em um skate.
Um cachorro atravessa a grama.	Um cachorro passa pela neve.
A garota com o balde azul salpica sob o píer.	A garota da jaqueta de esqui está andando perto dos prédios.
Um esquiador acelera pela neve.	Um cachorro marrom carregando um frisbee atravessa a neve.
Duas pessoas estão jogando golfe em um campo de golfe.	Duas pessoas estão em um campo de golfe jogando golfe.
Um menino e uma menina brincando na praia.	Um cachorro brincando nas ondas com uma bola.
Um cachorro correndo pela neve com uma bola de neve na boca.	Um cachorro bronzeado está correndo pela grama com um brinquedo amarelo na boca.
Uma garota vestindo um boné marrom, tênis vermelho e um casaco verde escuro fica em um banco de rocha.	Uma mulher em uma tampa de malha e casaco verde está em um quarteirão de pedra, olhando para fora.
A criança no casaco vermelho colocado no tapete vermelho.	A criança está pronta para escalar o pedaço de equipamento vermelho.
Dois cães brincam na grama.	Dois cães estão brincando na grama.
Dois cães correndo na grama.	Dois cães pretos e molhados correndo na grama.
Um grupo de pessoas fica na areia olhando para a água.	Um grupo de pessoas está de pé na praia em frente a alguns barcos.
Um cachorro pula sobre uma barreira.	Um cachorro pula sobre uma cerca.
Uma criança em um uniforme de equipe azul e branco perseguindo uma bola de futebol.	Um garoto de uniforme de futebol azul perseguindo uma bola.
Um jogador de futebol infantil corre para uma bola perto do gol.	Um garoto corre em direção a uma bola de futebol azul em frente a um gol.
Uma garota, em uma camisa preta e calça rosa quente, está prestes a bater em uma bola de tênis na quadra.	Uma garota usando chinelos rosa e meias está balançando uma raquete de tênis em uma bola de tênis.
Um jogador de softball balançando em um arremesso.	Um jogador de beisebol batendo na bola
Um cachorro preto está correndo atrás de um cachorro branco na neve.	cachorro preto perseguindo cachorro marrom através da neve
O BMX Bike Rider pula uma rampa de sujeira gramada.	Dois motociclistas BMX pulando rampas de terra na frente de um corpo de água.
O cachorro marrom está prestes a morder uma pata impressa.	Um cachorro com presas revelado está prestes a morder uma bola com impressões de pata.
Um homem está surfando de pipa da câmera.	Um homem está surfando no céu na água.
Duas jovens se sentam em uma fonte.	Duas mulheres loiras estão sentadas em uma fonte.
Um garoto de pé e assistindo a um grupo de pessoas em uma quadra de basquete.	Um garoto de pé em primeiro plano, olhando para outras pessoas em um tribunal.
Um carro de corrida se move pela estrada enquanto duas pessoas assistem à distância.	O carro de prata e azul marcou 104 aumenta a poeira na estrada enquanto duas pessoas observam.
O cachorro marrom está correndo na grama.	O cão marrom magro está correndo pela grama verde alta.
Homem segurando um pau enquanto um cachorro pula para agarrá -lo	Um homem careca de cinza está segurando um graveto enquanto um cachorro preto e marrom pula para pegá -lo.
Um menino pequeno está construindo com alguns blocos de madeira.	Um menino pequeno vestindo uma camisa azul empilha blocos de madeira.
Um cachorro preto está correndo na grama.	um menino que corre pela grama verde.
Um menino e uma garotinha brincando juntos lá fora.	um garoto e uma jovem caminhando um para o outro
Duas pessoas sentam -se no final de uma doca.	Duas pessoas sentadas em uma doca.
Uma criança se afasta na estrada.	Um cachorro branco corre na grama.
Um cachorro preto atravessa um banco lamacento.	Um cachorro magro passa por uma área arborizada.
Dois cães em um quintal.	dois cães em um riacho.
Quatro pessoas do lado de fora de uma bilheteria ao ar livre.	Quatro pessoas esperam do lado de fora em uma fila para ingresso.
cachorro com uma gola grossa correndo pela grama	Um cachorro preto com uma gola vermelha atravessa a grama.
Um homem persegue um cachorro tentando passar a barreira para entrar em uma área de recreação.	Um homem segue seu cachorro preto e branco, pois assume uma pista de obstáculos.
Um homem e seu cachorro tocam o cabo de guerra com uma corda.	Um homem e um cachorro estão tocando um cabo de guerra.
O grande cachorro marrom e branco está correndo pela neve.	st. Bernard Dog correndo no campo de neve.
um menino e um cachorro correndo na grama	Um cachorro preto, correndo na grama.
Um cachorro atravessa a grama.	Um cachorro atravessa o caminho.
Um pequeno cachorro branco correndo através de um gramado.	um pequeno cachorro branco correndo
O cachorro branco está correndo em águas rasas.	Um cachorro molhado está espirrando em águas rasas.
Um cachorro corre em uma pista.	Um cachorro persegue outro por uma árvore.
O cachorro branco e marrom está correndo rapidamente pela grama.	O Big White Dog está correndo na grama.
Uma jovem menina vestindo uma roupa branca balançando em um bebê balanço	uma jovem vestindo um maiô preto e vermelho balançando em um balanço
Quatro crianças com capuz se amontoam sob um cobertor ao ar livre.	Quatro crianças que se aquecem sob um cobertor.
duas crianças na banheira com um guarda -chuva.	Duas crianças com um guarda -chuva amarelo e azul na banheira.
Uma pessoa em um lã listrado clica um mosquetão em uma linha de metal.	Uma jovem em um capacete prende uma polia a um cabo.
Um homem e uma mulher ensanguentados posam para uma foto.	Um homem de mulher vestido com uma foto.
Um cachorro preto e branco está passando por um campo de neve.	Um cachorro preto, marrom e branco correndo por um campo.
Um homem e uma mulher andam com um cachorro branco em uma trela.	Um homem, mulher e cachorro andam por uma estrada pavimentada.
Um cachorro branco com manchas marrons está mastigando um brinquedo preto.	Um cachorro branco e marrom brincando com um brinquedo preto.
Um pequeno cachorro marrom pulando para pegar uma bola de tênis.	um cachorro molhado perseguindo uma bola branca
Três meninos jogando futebol em um campo	Três meninos jogando futebol.
Um garoto vestindo uma viseira azul balança um bastão.	Um garoto com uma viseira joga bola com o bastão na rua.
Um cachorro marrom caminha na grama com a língua de sua língua pendurada.	Um cachorro cinza caminha na grama verde, a língua pendurada.
Cinco homens vestidos de smoking em pé em um conjunto de escadas	Cinco homens em smokings estão descendo degraus.
Dois cães correndo em um campo.	Dois cães correndo na sujeira.
Um cachorro preto e um cachorro bronzeado brigando.	Um cachorro preto e um cachorro manchado estão lutando
Um pequeno cachorro marrom está correndo na grama.	O cachorro marrom está correndo na grama.
Um cachorro amarelo está brincando em uma área gramada perto de flores.	Uma garota está brincando em um balanço.
Um menino brinca com um macarrão perto da piscina.	Um menino brinca com um brinquedo de macarrão de espuma por uma piscina.
Um ciclista em uma rampa.	Um motociclista dá um salto em uma rampa de halfpipe.
Dois grandes cães marrons correndo pela neve.	Um cachorro marrom correndo pela grama.
Um garoto pula em uma piscina com braços estendidos.	Um cachorro pula em uma piscina no quintal.
Um cachorro mais velho e um mais novo brincando com um brinquedo.	Dois cães em uma casa brincando com brinquedos.
Dois cães nadando em uma piscina.	Um cachorro e um gato estão nadando em uma piscina.
Um skatista deslizando em um trilho.	Um skatista dando um salto.
Uma garota segura um animal de balão amarelo.	Uma criança segura um balão amarelo.
Uma criança em uma camisa branca em pé em um campo de grama.	Um cachorro marrom em uma camisa do Super -Homem está deitado em um cobertor azul.
Dois cães compartilham um brinquedo em um campo de vegetação.	Dois snowboarders estão no ar sobre a neve.
Dois cães brancos passam por um fiel com neve.	Dois cães brancos correndo na neve.
Um cachorro preto está correndo na grama.	O cachorro preto está correndo pela grama.
Uma senhora de cabelos loiros em poses brancas para a câmera.	Um cachorro preto e branco corre com a boca aberta.
Um garoto está de rolo em um parque de skate.	Um garoto de rolos em um parque de skate de cimento.
Uma jovem menina em patins.	Uma jovem menina com lâminas de rolos e folhagem verde ao fundo.
O grande cachorro marrom está passando por águas rasas.	O cachorro branco está correndo em águas rasas.
Um cachorro passa por um campo perseguindo uma bola.	Uma criança passa pela grama.
Dois cães brincando na praia.	Dois cães correndo na praia
Um cachorro pula sobre uma barreira em um campo.	Um cachorro pula sobre uma corrente.
Um caminhante passa uma formação de rochas brancas no meio de um deserto vazio.	Um caminhante descobre um recurso em uma paisagem estéril.
Duas meninas estão sentadas na frente de uma estátua.	Duas garotas loiras estão sentadas ao lado de uma estátua
Duas crianças pequenas pulando de uma borda de cimento no chão de terra.	Duas crianças pulam em um trampolim.
Um cachorro de cor clara corre na praia.	Um pequeno cachorro amarelo corre em uma praia
Um garoto vestindo um casaco de inverno vermelho está comendo e segurando uma barra de chocolate.	Um garoto vestindo um casaco vermelho come uma barra de chocolate.
Uma garota de laranja ilumina uma vela.	Uma garota de camisa laranja acende velas.
Um cachorro branco atravessa um campo de flores amarelas.	Um cachorro com uma gola vermelha corre em uma floresta no meio do inverno.
Um cachorro marrom e branco atravessa a grama verde.	Um cachorro marrom e branco atravessa a grama.
Uma criança sentada em um berço estendendo a mão para tocar o rosto de um garoto mais velho.	Um garoto que parece doente está sendo tocado na cara por uma criança.
Uma garota de cabelos ruivos está pulando por um cisne.	Uma garota de cabelos vermelhos está pulando em direção a um cisne.
O cachorro pula no ar correndo depois do Frisbee.	Um cachorro bronzeado e branco pulando depois de um frisbee vermelho.
Um cachorro sacudindo a água.	Um cachorro tritura água.
O cachorro está brincando na água.	Um cachorro está andando na água.
Meninos correndo pela calçada.	Um cachorro preto correndo ao longo da beira do oceano.
Uma criança pequena desliza por um escorregador laranja.	Um menino de macacão jeans desliza por um escorregador laranja.
um cachorro preto e branco correndo por alguns postes vermelhos e brancos	Cão preto e branco na sala de estar em pé nas patas traseiras.
Um cachorro branco está correndo pela água na costa.	O cachorro branco atravessa o oceano.
Um menino desce um escorregador inflável.	uma criança descendo um escorregador inflável.
Três indivíduos estão posando em esquis atrás de uma placa "sem esqui".	Três pessoas em esquis estão atrás de um sinal de esqui.
Um homem de terno branco caminha pela rua segurando um jornal.	Um homem de terno branco sai do lado de fora carregando um jornal.
Um homem com sua bicicleta em meio a um prédio demolido.	Um homem senta -se na escada ao lado de sua bicicleta.
Um cachorro preto e branco nadando em água clara.	Um pequeno cachorro preto e branco está nadando na água.
Dois cães de corrida correm na lama.	O homem está entrando na água.
um pássaro com as asas se espalhou	Um pássaro voa com asas espalhadas.
Dois cães pretos e brancos atravessam um campo verde.	Um cachorro branco está correndo em um campo gramado.
Um garoto pulando em uma piscina que diz "sem mergulho".	Um garoto pula em uma piscina enquanto os salva -vidas observam.
Um cachorro preto com uma gola azul está correndo na neve.	Um cachorro preto usando uma gola azul está correndo pela neve.
Um cachorro pegando uma bola.	Um cachorro pegando um frisbee.
Cão preto e branco que atravessa a água.	Um cachorro preto e branco está atravessando a grama.
Um homem de camiseta cinza está sentado em uma pedra em frente a uma cachoeira.	uma pessoa sentada em uma pedra ao lado de uma cachoeira.
Cão marrom e branco com uma bola de beisebol na boca.	Um cachorro preto e branco fica na grama com uma bola de beisebol na boca
Um cachorro está correndo em direção à câmera.	Um cachorro marrom e branco correndo na grama.
Três cães correndo na terra.	O cachorro amarelo está correndo na estrada de terra.
Um garoto balançando em um balanço.	A garota está em um balanço.
Um cozinheiro se afasta quando as chamas saltam de uma panela em uma cozinha.	Uma mulher em um fogão salta para trás das altas chamas de uma panela.
Um homem e uma mulher estão sentados em uma doca juntos.	Um homem e uma mulher estão atravessando uma ponte de corda.
Um grupo de jovens nadam na água do lago	Muitas crianças estão brincando e nadando na água.
Um time de futebol azul e branco jogando um contra o outro.	Uma mulher de topless com o rosto pintada está coberta de lama.
Dois cães correndo na neve	Um cachorro deitado na neve.
Um cachorro de ouro está correndo pela neve.	Um pacote de cães de trenó puxando um trenó através de uma cidade.
Um cachorro marrom prestes a pegar um frisbee verde.	Um cachorro marrom espera que o Frisbee desça antes de pegá -lo.
um skatista em uma rua da cidade.	Um skatista no ar em uma grande rampa ao ar livre.
Quatro crianças em fezes em uma lanchonete.	Quatro crianças sentam -se em bancos altos de bar em um bar amarelo e cinza.
menino e cachorro branco correndo em campo gramado	um menino e um cachorro correndo na grama
Dois cães grandes estão correndo juntos pela grama.	Dois cães pretos estão brincando na grama.
Um cachorro marrom está correndo na grama.	Um cachorro correndo na grama.
Um cachorro está pulando sobre um tronco com orelhas voando e língua para fora.	Um cachorro pula sobre um tronco na floresta.
Um cachorro preto e branco está nadando em um grande lago verde.	Um cachorro preto corre rapidamente em águas rasas.
Dois grandes cães pretos estão brincando em um campo gramado.	Dois cães brancos estão correndo juntos.
Dois meninos jogando um jogo de futebol de bandeira.	Dois meninos estão jogando futebol de bandeira.
O cachorro marrom e preto corre pela neve.	Um cachorro preto está correndo rapidamente ao longo do chão.
Um homem de jaqueta preta está tirando uma foto de um homem em uma jaqueta vermelha.	Um homem em uma roupa preta está tirando uma fotografia de um homem em uma jaqueta vermelha.
O homem na mochila olha para a esquerda.	Um homem adulto vestindo uma mochila anda e olha para a esquerda.
Um homem idoso em uma camisa azul está segurando um pedaço de arte de lona.	Um homem negro está andando ao lado de um prédio em uma cidade grande.
Um cachorro está carregando algo rosa na boca enquanto caminha pela neve.	Um cachorro com algo rosa na boca de ele está ansioso.
Dois meninos magros brincando com areia na água.	Dois cães estão sacudindo água.
O cachorro preto e branco tem a boca aberta.	Um cachorro preto e branco pula na neve.
Um cachorro pequeno passa por uma pista de obstáculos.	Um cachorro pequeno pulando sobre um obstáculo.
Um cachorro marrom sacode água depois de sair de um lago natural.	Um cachorro sacode depois de sair da água.
Uma garota salta em uma casa de salto.	Uma garota dança como um homem em fantasia
Um cachorro marrom nadando em água escura.	um cachorro bronzeado nadando em um pouco de água
Um cachorro marrom correndo pela floresta.	Um cachorro marrom passa pela grama.
Um grupo de pessoas está parado ao lado de uma janela assistindo a algo.	Um grupo de pessoas se levanta e espera para ver alguma coisa.
Um jovem com um tainha fuma enquanto estava sentado em um sofá único.	Jovem de camisa preta fuma em um sofá em uma sala colorida
Um cachorro está pulando sobre uma barreira em uma competição de agilidade.	Um cachorro pulando sobre uma cerca de obstáculos.
Três pessoas correndo em patins de gelo.	Três patinadores de gelo ao redor de uma esquina.
Um cachorro marrom grande está andando ao lado de um rio.	Um cachorro marrom anda nas pedras perto de um rio.
Um garoto branco e um garoto negro ficam com os braços um com o outro.	Dois meninos, um branco e um preto, estão de pé com os braços um com o outro.
Duas mulheres participantes estão passeando com seus cães em um show de cães.	Duas mulheres andam para lá, cães em um show de cães.
Um menino cai da bicicleta vermelha.	Um garoto cai da bicicleta.
dois homens na lateral de uma barcaça	Um homem está deitado a grama com cabelos compridos e barba.
Um cachorro marrom e branco está pegando uma bola de tênis enquanto está de pé nas patas traseiras.	O cachorro marrom e branco está carregando um graveto na boca.
Um cachorro marrom correndo na grama.	Um cachorro marrom passa pela grama.
Um homem com uma faixa branca tocando bateria.	Um menino de faixa toca bateria.
Dois cães segurando um frisbee na boca.	Dois cães segurando um único frisbee preto na boca
Dois cães estão correndo por um pequeno lago	Dois cães estão correndo rapidamente através de um parque.
Um cachorro preto molhado com uma gola vermelha está no rio	Um cachorro preto com uma gola vermelha percorrendo a água.
Um cachorro de cor preta e branca pulando em um corpo de água.	Um cachorro preto e branco nadando em água clara.
As crianças estão montando cavalos em um anel.	Duas crianças estão montando cavalos sobre areia perto de uma cerca branca.
Uma pessoa está andando de bicicleta em uma trilha ao lado da floresta.	Uma criança pequena em uma camisa amarela está segurando os braços para os lados.
Os dois cães pretos estão correndo pela grama.	Dois cães correndo na grama.
Duas pessoas frias estão perto de um poste.	Duas pessoas vestindo roupas de inverno ficam perto de um poste em uma cena de inverno.
Uma mulher de vestido preto sorri na frente de um caminhão prateado.	Uma garota vestindo uma blusa preta está sorrindo com um caminhão prateado ao fundo.
Dois cães estão correndo pelo caminho gramado.	Dois cães estão em uma área gramada.
Garota brincando em uma poça com os pés descalços.	Uma criança está brincando com dois gansos brancos e pretos.
Duas pessoas estão andando pelo oceano.	Dois homens em lamas e chapéus olhando para a câmera.
Um homem de vermelho tira fotos de telefone celular em um jogo de futebol.	Um homem de camisa vermelha está assistindo a um jogo de futebol.
Um cachorro cinza pula para morder uma trela verde.	Um cachorro marrom pula sobre uma cerca de arame.
Duas meninas de rosa estão dançando.	Duas mulheres correndo em um caminho perto da orla.
Um cachorro preto atravessa a grama seca.	Um cachorro preto que atravessa a água.
Um cachorro branco com marcas pretas atravessa a neve.	Um cachorro branco com orelhas bronzeadas está correndo pela neve
duas crianças espirrando na água.	Dois golfinhos pulando na água.
Um cachorro está na praia perto de uma bola.	Um cara está subindo para um lay-up em uma quadra de basquete.
A criança está olhando para o Papai Noel.	A criança está olhando para o seu reflexo em vidro.
Um homem está em pé na frente de um arranha -céu	Há um arranha -céu à distância com um homem andando na frente da câmera.
duas mulheres escalando pedras ao redor do oceano	Duas mulheres subem no topo de pedras em frente ao oceano.
Um cachorro marrom está correndo pela grama ofegante.	um cachorro marrom atravessando a grama.
Um cachorro se alinha na grama marrom.	Dois cães amarrados na grama.
O cachorro passa pela água.	Um cachorro passa por águas rasas.
Uma mulher brincando com dois meninos em um parque	Uma mulher e três crianças brincam em um parque.
Um cachorro emerge forma a água com um graveto na boca.	Um cachorro corre em direção à câmera com um graveto na boca.
Um cachorro marrom de brincadeira morde um cachorro branco.	Um cachorro faz uma mordida divertida em outro cachorro.
O cachorro grande pingando na água e tremendo.	Três cães escuros nadando e um deles tem uma bola.
Três cães brincando na neve.	O garoto está brincando na areia.
Uma mulher de jeans joga um videogame na frente de uma tela grande.	Um homem e uma mulher estão posando para uma fotografia na frente de um leito de flores amarelo.
Crianças pulando em um trampolim.	Cinco crianças pulam em um grande trampolim, enquanto a neve do lado de fora derrete.
Um garoto de chapéu cinza está carregando uma bola de futebol por uma parede de cor avermelhada.	Um menino pequeno está carregando uma bola de futebol.
Duas pessoas andando ao longo da costa ao pôr do sol.	Duas pessoas andando pela praia ao Sunset Towarn, um grupo de pessoas.
Um cachorro branco correndo na praia.	Um cachorro correndo no surf.
Um homem de terno dança com uma jovem na frente de uma platéia.	As mulheres pendem de um tecido azul conectado a uma árvore.
Um cachorro marrom claro está correndo na água.	Um cachorro branco correndo na neve.
Três crianças brincando no chão com brinquedos.	Três crianças sentadas no chão brincando com vários brinquedos.
Um cachorro sai de uma piscina azul com uma bola na boca.	Um cachorro sai da água com uma bola na boca.
Um cachorro carrega uma trela na boca.	Um cachorro fofo carrega uma trela preta na boca.
duas crianças brincando na neve.	As crianças brincam em uma pilha de neve.
Um cachorro segurando um anel na boca está de pé em um pequeno rio.	Um cachorro com um anel na boca está em pé na água.
Um homem de jeans está brincando com uma bola enquanto uma mulher de jeans fica por perto, olhando para o olhar.	Um homem está amarrando uma faixa de braço vermelho ao redor de outro braço do homem na rua.
Um cachorro preto está correndo pela neve.	O cachorro preto e marrom está correndo pela neve.
Uma mulher de biquíni rosa está deitada em uma espreguiçadeira que é coberta com uma toalha rosa.	Uma mulher de camisa branca e saia preta em uma quadra de tênis.
Um esquiador está caindo na neve.	Um esquiador está caindo primeiro na neve.
Um cachorro com um brinquedo vermelho na boca.	Um cachorro marrom está carregando um graveto na boca.
Dois jogadores de hóquei brigando no gelo.	Dois jogadores de hóquei em uma luta no gelo.
Três pessoas estão em uma estrutura de vidro ao ar livre.	Uma garota está no topo de uma plataforma de obstáculos.
Dois Terriers jogam no chão de madeira de sua casa.	Dois filhotes brincam com um brinquedo de mastigar vermelho em um campo.
A pessoa está fazendo um pino na praia.	Uma criança está fazendo uma mão na praia.
Um grupo de pessoas está em uma convenção agitando bandeiras americanas.	Uma multidão de pessoas em um evento ao ar livre
Dois cães correndo por um campo.	Dois cães brincam em um campo.
um homem de terno cinza trancando uma bicicleta	Um homem e uma mulher em pé em uma rua da cidade.
Os dois cães estão brincando no quintal.	Dois cães estão brincando na grama.
Dois cães se preparam.	Dois cães pulando um no outro.
Um homem em uma roupa de mergulho preta é surfada nas ondas.	Um surfista em um terno molhado preto surfa em uma onda média.
Dois cães brincando na água.	Dois meninos brincando na água.
Um cervo está pulando sobre uma cerca.	Uma criança está pulando a bicicleta por uma cerca.
um pássaro com as asas se espalhou	um pássaro voando no ar
um menino skates na grade de algumas escadas de grafite	Um skatista está pulando sobre um obstáculo na frente de uma Casa Branca.
Um cachorro branco está correndo pela água em uma praia	Um cachorro branco está correndo pela água na costa.
Um homem de jaqueta de couro preto está dormindo em um carro do metrô.	Um homem de jaqueta de couro preto adormece no transporte público.
Um cachorro preto pula na neve.	Um cachorro pula alto na neve.
Um cachorro pulando sobre um obstáculo.	Um cachorro pula sobre o obstáculo.
Dois homens estão montando algum equívoco eletrônico	Dois cães estão lutando no chão na neve.
Um cachorro preto está andando na grama com um graveto na boca da sua boca.	Um garoto segura uma rede com uma cobra perto do chão.
Um homem e uma mulher sopram bolhas.	Um homem e uma mulher de óculos sopram bolhas.
Uma garota corre com cães em um campo seco.	Um cachorro cinza e um cachorro marrom brincando em um campo gramado.
Dois cães brincando na neve.	Dois cães pretos na neve.
Um cachorro que atravessa o chão sujo.	Um cachorro passa pela areia.
Um cachorro marrom e branco em pé em um quintal.	Um cachorro preto e branco brincando na areia.
Um skate realiza um truque em um quarto de cachimbo.	Um skatista tenta fazer um truque sobre uma rampa caseira.
duas mulheres sentam -se em um banco do parque.	Duas mulheres sentadas em um banco junto à água.
Um cachorro marrom lança para um brinquedo amarelo.	Um cachorro marrom perseguindo um brinquedo amarelo.
Um cachorro bronzeado pula para pegar uma bola de tênis.	Um pequeno cachorro marrom pulando para pegar uma bola de tênis.
Um cachorro pula de uma doca e na água.	O cachorro preto salta da doca e na água.
um grupo de velhos andando pela rua	Um casal andando pela rua.
Três cães estão até o pescoço na água.	Três cachorros pretos nadando em água suja
Três cães em pé na neve ao lado de uma cerca azul.	Três cães brincam nas águas rasas ao lado de uma costa rochosa.
Um cachorro branco rosna em um cachorro preto em frente a um conjunto de degraus.	Um cachorro branco, um cachorro marrom e um cachorro preto brincando em um campo gramado.
Pedrecedor de neve em uma tábua rosa voando pelo ar.	Um snowboarder está pulando sobre uma colina nevada
Um cachorro preto e branco está correndo pelo campo.	Um cachorro preto e branco está correndo na grama.
Um garoto de preto acena com os braços enquanto outras pessoas estão atrás dele em um campo.	Um homem em uma camisa preta está passando por um banco na cidade.
Uma mulher idosa monta uma bicicleta ao longo de uma rua da cidade.	Uma mulher idosa andando em cima atravessando a rua.
Uma garota em uma fantasia participa de um desfile.	Uma garota em uma fantasia vermelha e branca em pé na rua.
O cachorro preto atravessa a água.	Um cachorro está pulando pela água.
Um garoto está socando uma bola amarela.	Um cachorro pequeno pula sobre uma viga amarela.
Uma garotinha está limpando neve.	Uma garotinha está correndo.
Um homem com os braços levantados no topo de uma montanha.	Uma pessoa em uma camisa vermelha está de pé, com os braços levantados, no topo de uma montanha.
Um homem fica sentado em um banco de madeira ao lado de uma árvore e alguns cactos.	Um homem vestindo um capuz e jaqueta está sentado em um banco em um parque.
Um grupo de jovens bailarinas está em um estúdio de dança.	um grupo de jovens de biquíni.
Uma pessoa está surfando uma grande onda.	Um surfista monta as ondas verdes e brancas.
Um garoto de camisa branca está brincando em uma planície gramada.	Uma mulher está fazendo o cabelo em um salão.
Um cachorro que atravessa a neve.	um collie correndo pela neve.
Uma mulher e um homem se divertem com os fones de ouvido.	Um homem e uma mulher descansando após o exercício.
Duas meninas andando no oceano.	duas meninas andando na rua
Um garoto pula de uma prancha em um lago.	Um garoto pulando em um lago.
O cão Greyhound # 2 está correndo em torno de uma pista.	Um cão de galgo amordaçado está correndo em torno de uma pista
Um homem e um cachorro estão tocando um cabo de guerra.	Um homem dança em uma parede colorida.
Uma criança molhada abra sob uma toalha em uma piscina.	Uma criança molhada está tremendo em uma toalha em frente a uma piscina.
Um cachorro marrom e branco nada em uma piscina no quintal.	Um cachorro marrom e branco está remando através de águas profundas em um recipiente azul.
Um cachorro branco corre em uma praia.	O cachorro branco está correndo pela praia.
Seis cães correndo na praia de areia.	Seis cães andando ao lado da praia.
Um homem segura uma alça na água.	Um homem está segurando as alças no ar.
Quatro crianças estão brincando em um trampolim.	Quatro crianças estão pulando em um trampolim.
Um cachorro branco andando na neve.	Um cachorro preto e bronzeado andando pela neve.
Dois homens mais velhos na frente de um ônibus.	Dois homens saem do ônibus juntos.
O cachorro branco e marrom atravessa a grama.	Três cães estão correndo na grama.
Um cachorro preto recupera um pássaro.	Um cachorro preto busca um pássaro morto.
Três cães na grama correndo em direção à câmera.	Vários cães grandes estão correndo por uma grande área gramada.
Um menino desce um escorregador inflável.	Um garoto em vermelho desliza por um passeio inflável.
Dois cães brincando com uma bola em uma poça.	Dois cães ficam em uma poça e um tem uma bola de tênis amarela.
Três cães estão brincando na água.	Três cães correm na neve.
Dois cães brincando na neve.	duas crianças brincando com um cachorro.
Dois cães negros brincando na neve.	Dois cães brincam na neve
Muitos carros estacionados em uma montanha.	um grupo de carros estacionados em uma colina
Uma garota faz uma curva nas costas na praia.	Uma garota fazendo uma curva nas costas na praia.
Um cachorro branco em um salto, segurando um prato na boca.	Um cachorro pula no ar, pegando um frisbee na boca.
O barco navega em águas ásperas.	Um homem é caiaque em águas ásperas.
Uma garota senta -se em uma estrutura de jogo vermelho	Uma garotinha em uma academia na selva vermelha.
Os dois cães estão jogando buscando a neve.	Dois cães estão brincando juntos na grama.
um cachorro preto e bronzeado em pé em um campo perto de árvores	Um cachorro branco está parado ao lado de um rio senando -se seco.
Dois surfistas sobre a pilotagem de uma pequena onda.	Dois surfistas realizam truques nas ondas.
Um pássaro cinza está voando sobre a água.	um pássaro voando sobre a água.
Duas pessoas andando na praia ao pôr do sol.	Duas pessoas andando ao longo da costa ao pôr do sol.
Um cachorro pula alto na neve.	Um cachorro corre na neve.
Três cães estão brincando na neve branca.	Dois cães estão brincando na grama.
Uma criança polvilha confetes nos cabelos de uma mulher.	menina pequena em um avental colocando confetes nos cabelos de uma mulher.
Um cachorro passa pela água.	Um cachorro atravessa a grama.
O homem de camisa vermelha está subindo o lado de uma montanha.	Um homem com a camisa do logotipo monstro está surfando.
Três meninos jogando futebol em um campo	Três meninos jogando futebol.
Dois filhotes brincando na grama	Dois cães estão lutando na grama.
Uma jovem está sentada no colo do Papai Noel.	Uma garotinha está sentada no colo do Papai Noel
Duas pessoas levantam os braços em uma colina nevada nas montanhas.	Duas pessoas se ajoelham na neve e levantam os braços com montanhas atrás delas.
Um cachorro está olhando para algo perto da água.	Duas adolescentes estão mandando mensagens no parque.
Um cachorro preto e branco corre com a boca aberta.	Um cachorro preto e branco nada em água azul.
Um cachorro preto que corre na água.	Um cachorro preto que atravessa a água.
Um garoto pulando no ar na praia.	Um garoto pulando no ar na praia.
Uma mulher e um cão remar em um rio largo.	Mulher e cachorro em barco a remo na água.
Um grupo de crianças asiáticas posam para uma foto em uma mesa.	Um grupo de seis crianças sentou -se em uma mesa de madeira.
Um cachorro branco que se delicia pela neve	Um grande cachorro branco está delimitando um campo de neve.
Cinco homens em smokings estão descendo degraus.	Cinco homens de smoking andam por um conjunto de degraus
Dois filhos se abraçam.	Dois homens de chapéus se posam juntos.
Homem em shorts vermelhos e camisa branca chutando uma bola de futebol.	Um cachorro preto fica no surf segurando uma bola de borracha vermelha.
duas meninas ao lado de uma árvore musgosa.	Duas garotas se inclinam em torno de uma árvore, rindo.
Um velho sentado assistindo a algo.	As pessoas ficam do lado de fora assistindo algo.
Um homem e um cachorro em uma praia rochosa.	homem e cachorro em pé nas pedras ao lado da água
Cachorro marrom espirrando na água.	Quatro cães espirrando na água
Um garoto vestindo uma jaqueta azul balança um bastão em uma bola branca.	Um garoto de jaqueta azul balança um bastão em uma bola.
Uma mulher com uma tampa de malha está sorrindo perto da placa de pizza de um dominó.	Uma jovem com um boné de malha fica contra a parede da pizza de um dominó.
A mulher sorridente na praia está enterrada em algas marinhas.	Uma garota de chapéu de cowboy com uma ovelha em uma trela.
O homem de jaqueta marrom está sentado no chão no cais.	Uma mulher que está esqui a poses para a câmera.
Muitas pessoas estão comendo em um restaurante lotado.	Os clientes sentam -se em mesas em um restaurante lotado iluminado em azul.
Um cachorro branco com manchas marrons está correndo em um quintal, perseguindo uma bola.	Um cachorro branco com marcas marrons persegue uma bola laranja em um campo gramado.
Dois cães, o branco de pé em um frisbee, brincando juntos na grama.	Dois cães brincam na grama.
Um cachorro com orelhas grandes está segurando um pequeno graveto na boca da sua boca.	Um filhote com orelhas grandes mastigando um graveto.
O grande cachorro marrom está pulando pela grama alta.	A garota usando uma camisa azul está correndo através de um centro de ciências.
Dois cães brigando na neve.	Dois cães brincando na neve.
Um snowboarder desce uma rampa.	um snowboarder passando por uma rampa.
Um cachorro pequeno pulando com uma bola na boca.	Há um cachorro marrom nadando do lado de fora com uma bola de tênis na boca.
Um cachorro marrom está no meio de uma linha de cães perseguindo uma bola suja de tênis sobre a sujeira.	Existem dois cães brancos e um cachorro marrom perseguindo uma bola.
Um nadador fazendo o peito em uma piscina.	uma nadadora nadando borboleta em uma piscina
Um cachorro de ouro está correndo pela neve.	Um cachorro preto está correndo pela neve.
Um cão cinza é ativo em um campo gramado.	Um monte de bicicletas correndo em uma pista.
Três cães andando na grama.	Três cães brincando na água verde.
Três cães brincando na neve.	Dois cães brincando ou brigando na neve.
Duas pessoas estão correndo uma motocicleta de carro lateral na lama.	O cachorro carregando um bastão longo na boca.
Um homem em troncos de natação vermelha jogando vôlei.	um homem e uma mulher sentados em uma motocicleta.
Um homem e uma mulher passando por uma loja de discos	Um homem e uma mulher se beijando na frente de uma multidão de pessoas.
O homem está sentado no topo de uma montanha rochosa.	Uma pessoa enfia a cabeça de uma barraca no topo de uma montanha.
Duas pessoas em roupas de neve deitadas na neve fazendo anjos de neve	Dois filhos deitados na neve fazendo anjos de neve
Uma menina loira está em frente a uma fonte de água.	uma jovem de pé na frente de uma fonte
Um cachorro loiro e um cachorro preto e branco correm em um campo de terra.	Um cachorro amarelo e um cachorro preto e branco estão correndo na terra.
Um homem está amarrando uma faixa de braço vermelho ao redor de outro braço do homem na rua.	Um homem ajuda a amarrar uma fita vermelha ao redor do braço direito de outro homem durante um desfile de rua.
Um homem de pé em um barco está puxando outro barco por perto com um bastão de bambu.	um homem de chapéu preto em frente a uma parede de tijolos e um sinal
Um homem toca seu violão branco.	um homem tocando um violão branco e cantando também
Uma pessoa está esquieando com um cachorro nas montanhas.	Um cachorro marrom está brincando com uma bola na água.
Um cachorro preto e branco está correndo em grama carregando um grande graveto.	Um cachorro preto e branco está brincando em um lago ou riacho.
Duas garotas estão brigando por uma bola durante um jogo.	Dois cães brigando ou brincando juntos.
Dois jovens sem camisa brincando na água.	Muitas pessoas brincam na água na praia.
Duas crianças pequenas estão na areia.	duas crianças pequenas usando óculos de sol
Um cachorro preto e branco atravessa a água.	Dois cães pretos correm para as ondas brancas em uma praia.
Close-up de um beija-flor.	Um close de um beija -flor voando.
Dois cães brincam na grama.	Dois cães bronzeados brincam na neve.
Um jovem está vestindo uma jaqueta preta e tem fones de ouvido brancos nos ouvidos.	Um homem de jaqueta preta tem um fone de ouvido branco na orelha.
Mulher em um vestido preto andando na rua.	Uma mulher observa um cachorro pulando pelas escadas.
Três crianças lutam em um tapete floral.	Três crianças brincando no chão.
Um garoto de vermelho pulando em uma caixa de areia.	um cachorro nadando em um lago
Três cães brincam perto de um lago.	Três cães brincando na grama.
O cachorro marrom está brincando na neve.	Um cachorro preto está brincando na neve.
A garota de camisa rosa pula alto sobre a grama.	Uma garota pulando na grama.
Um homem e uma mulher olhando para a câmera.	Um homem e uma mulher rindo.
Um cachorro pula na água.	Um cachorro está pulando na água.
um cachorro marrom correndo pela grama lamacenta suja	O grande cachorro marrom está correndo para fora na terra.
O cachorro preto e branco pula com uma bola de tênis na boca.	Um cachorro branco com uma gola está correndo.
Três cães puxando um homem em uma bicicleta pela neve.	Os cães estão puxando um homem em um tipo de bicicleta, através da neve.
Um menino andando em um balanço.	Um garoto andando em um balanço.
Um homem em um terno do Batman correndo.	Um homem de uma fantasia do Batman está correndo uma corrida.
Um cachorro marrom está cavando na sujeira.	Um cachorro está cavando um buraco na sujeira
Um cachorro está correndo ao longo da grama.	Um cachorro marrom está correndo na grama.
Duas meninas com cabelo tingido conversam com dois meninos de preto.	Duas meninas com cabelos rosa e dois meninos com cabelos pretos ao lado de um edifício de concreto.
Um cachorro preto correndo pela neve.	Um cachorro preto atravessa a água.
Uma criança sopra em uma varinha laranja para fazer uma bolha.	Uma criança asiática está soprando bolhas de uma argola de bolha laranja.
Um cachorro bronzeado e branco parece assustado enquanto jogava na água.	um cachorro marrom e branco nadando na água
Um bebê de chapéu vermelho em um carrinho está segurando uma boneca.	Um homem em uma camisa cinza sentada em um campo de flores.
Dois cães brancos correndo em grama.	Dois cães correndo na floresta.
Um homem está em cima de uma montanha olhando ao pôr do sol.	Um homem de pé nas montanhas assistindo a um pôr do sol.
Três crianças brincando com o feno ao ar livre, jogando um pouco na lente da câmera.	Três crianças brincam no feno, jogando um pouco na câmera.
Um cachorro preto andando ao lado de uma piscina.	Um cachorro preto está andando ao longo de uma piscina.
Dois cães em pé em um lago.	Dois cães brincando na grama.
Cinco cães negros correm em um campo.	Um cachorro preto está correndo pelo campo.
Quatro cães correm na grama.	Um cachorro correndo na grama.
Um pequeno cachorro preto está correndo na neve.	Um cachorro preto está correndo pela neve.
Um cachorro branco molhado está espirrando na água com um graveto na boca da sua boca.	Um cães brancos pisa a água com paus na boca.
Os filhotes brancos estão brincando em um sofá com uma garrafa de bebê.	Três filhotes estão deitados em um sofá ao lado de uma garrafa de bebê.
um cachorro correndo com uma bola de tênis na boca	Um cachorro nadando com um graveto na boca da sua boca.
Um cachorro preto, marrom e branco está carregando um frisbee.	Um cachorro preto e branco está pegando um frisbee.
Um cão preto e marrom grande está correndo pela neve em uma área arborizada.	O cachorro preto e marrom está correndo pela neve.
Um alpinista está de pé na face da rocha ao lado da corda rosa.	As crianças estão correndo na neve com cercas ao fundo.
Um cachorro com um brinquedo amarelo na boca.	cachorro trotando com um pato de borracha na boca
Um homem está parado na frente de 4 cães na praia.	Um cachorro correndo na areia na praia enquanto seu dono olha para os outros cães na praia.
O homem está vestindo uma camisa preta e chapéu e sorrindo.	Um homem está levantando uma garotinha acima de sua cabeça.
Um cachorro preto usando uma gola laranja está emaranhada com arame de pesca.	O cachorro preto vestindo um colarinho vermelho sacode água.
Um cão loiro molhado carrega um graveto na praia.	O cachorro marrom e molhado tem um graveto na boca e está correndo na areia ao lado da água.
Um cachorro deitado na neve.	Três cães brincando na neve.
Três cães brincando na praia	um menino em pé na praia.
Um homem e uma mulher estão andando de bicicleta em uma rua.	Um homem e uma mulher estão andando de bicicleta por um cruzamento na cidade.
Um skatista faz um salto de uma rampa.	O skatista está pulando sobre uma rampa.
Um homem e um cachorro em pedras na praia.	Um homem e um cachorro em uma praia rochosa.
Um cachorro preto e branco correndo entre postes.	Um cachorro em preto e branco correndo na água.
Uma garota com os braços levantados para deslizar para um escorregador vermelho e branco.	Uma garota de braços estendidos desce um deslize.
Dois cães estão brincando na terra.	Uma dançarina posando para a câmera em um vestido vermelho e branco.
Uma mulher colocando um bebê em um skate na praia.	Uma mulher de casaco marrom coloca um bebê em um skate que fica em uma pista de madeira na praia.
Grande grupo de pessoas do lado de fora de um prédio.	Um grupo de pessoas está patinando no gelo em uma cidade grande.
Um cachorro de ouro está correndo na grama.	O grande cachorro bege está correndo pela grama.
O garoto de camisa verde e amarela tem uma luva e está indo em direção à bola.	Um garoto com nariz machucado e escrever em suas mãos está de pé em uma loja de aluguel de vídeo.
Um cachorro atravessa a grama.	Um cachorro atravessa a grama.
Uma criança em um vestido de formatura joga a tampa no ar.	Uma criança monta uma bicicleta no ar.
Um cachorro preto está correndo muito rápido em um solo marrom claro.	cachorro preto correndo muito rápido.
Um homem de short vermelho está andando ao longo de rochas por um rio carregando um graveto.	Um homem está andando em pedras com água fluindo ao redor deles.
homem remar um barco.	Um homem fazendo um truque no skate
Três cães correndo em uma pista de corrida.	Três cães em volta de uma curva em uma pista de corrida.
um homem e uma criança na frente de um outdoor	Um homem em pé em frente a um prédio de tijolos.
um cachorro preto e branco atravessando uma pista de obstáculos	Um cachorro preto e branco atravessa obstáculos.
dois filhos deitados em uma cama de cabeça para baixo	Duas crianças são mostradas de cabeça para baixo.
Três meninos parados ao lado e em uma cerca.	As três crianças estão de pé e por uma cerca.
Um cachorro está de pé na areia.	Um cachorro correndo rápido na areia.
Um cachorro preto e marrom caminha pela neve perto de um prédio.	Um homem mais velho fica do lado de fora de um prédio antigo.
Uma pessoa de camisa amarela e jeans está correndo em uma pista.	Uma mulher de camisa amarela correndo em uma pista.
Dois cães brincam entre si na grama.	Dois cães bege brincam na grama.
Um cachorro está pulando em uma piscina depois de um pato.	Um cachorro pulando em uma piscina.
Dois cães estão brincando em um campo gramado.	Dois cães estão brincando em um campo de grama alta.
Um cachorro preto está correndo pela neve.	O cão de pastor alemão está correndo pela neve.
Um menino pequeno brincando na neve.	Dois cães brincando na neve.
Pessoas do lado de fora em um carnaval.	Duas pessoas estão paradas ao lado de um canal hidroviário.
um cachorro que atravessa uma floresta no inverno	Um cachorro que atravessa muitos galhos.
Três pessoas estão em uma estrutura de vidro ao ar livre.	Três pessoas em uma estrutura de vidro.
Duas jovens caminham ao longo de uma estrada de terra.	Duas jovens estão caminhando ao longo de um caminho rural limitado por árvores.
Um menino anda de skate com uma bicicleta à sua direita.	Um menino está fazendo truques com sua bicicleta na rampa.
A garota está brincando junto com as imagens na tela grande.	Três meninas segurando guarda -chuvas de costas para a câmera.
Muitas pessoas correm em uma corrida em uma rua.	Um filhote correndo ao longo de uma rua.
Dois cães na neve	Dois cães brincam na grama.
Um homem de nadar está de pé contra algumas pedras.	Um homem em uma camisa cinza sobe uma grande parede de pedra.
Dois cães brancos andando na neve.	Um cachorro marrom com um colarinho preto latindo na neve.
Dois cães estão correndo na água enquanto um homem observa da doca.	um cachorro que atravessa a água com uma bola na boca
Uma mulher vestindo uma camisa rosa pula no ar com os braços e as pernas espalhados para o lado lateral.	Um homem usando suspensórios e óculos de sol salta no ar com os braços e as pernas espalhados para o lado.
Um cachorro atravessa a grama.	Dois cães correm pelo pincel.
Três cães brincando na neve.	Três cães correm na neve.
Um cachorro correndo pela areia	um cachorro correndo pela água.
Um homem de chapéu verde posa nas montanhas	Um homem viaja com dois burros nas montanhas
O garoto de camisa laranja está jogando a bola.	O cachorro preto e branco está pulando acima da grama.
Um homem usando um capacete branco está na água.	Um homem vestindo um capacete, flutuando na água.
Dois cães brincam na neve	Um cachorro toca na neve.
As meninas da escola japonesa andam pela rua.	As pessoas andam na rua.
Uma mulher está tentando montar uma pequena onda.	Um homem e uma mulher sentados para trás do lado de fora ao sol.
O cachorro preto e branco está nadando no rio.	Um homem negro e seu cachorro na praia.
Um menino pequeno brincando na neve.	Um garoto sorridente com chapéu brincando na neve.
Homem de pé em cima de pedras irregulares perto do oceano.	Um homem está em cima de pedras com vista para o oceano.
Uma garota de terno molhado preto e azul está surfando.	Uma mulher vestindo um terno listrado preto e azul está surfando em uma onda.
Um cachorro falta e um cachorro marrom e branco correm em uma superfície de cascalho com algo vermelho sob os pés.	Um cachorro marrom e um cachorro preto estão brincando com um frisbee vermelho.
Um cachorro preto molhado anda na areia com uma parede de pedra atrás.	Um cachorro preto em uma praia carregando uma bola na boca.
A mulher está liderando um cachorro através de uma pista de obstáculos.	Mulher liderando seu cachorro pequeno através de uma pista de obstáculos.
Várias pessoas estão sentadas em torno de um incêndio à noite.	Um grupo de pessoas sentou -se ao redor de um fogo ardente à noite.
Uma criança está segurando as costas de uma cadeira de vime.	Uma criança segura uma colher na boca de sua cadeira.
Uma mulher em um parque usando uma blusa roxa	Uma mulher com cabelos castanhos está usando uma camisa roxa e uma bolsa branca.
Dois cães estão correndo no campo.	Dois cães correndo em um campo.
Um menino usando boxers está segurando um punho e parado na frente de uma parede de tijolos.	Um homem com uma jaqueta usa fones de ouvido em frente a um diretório.
Duas pessoas estão na cama.	Dois boxeadores estão no ringue.
Dois cães na praia.	Um cachorro caminha na praia.
Um garoto está de pé em uma área de azulejos cinza.	Um garoto está praticando seu karatê em uma academia.
Um cachorro pula na água.	Um cachorro pequeno salta na água.
Um cachorro olhando para a câmera na neve.	Um cachorro está andando em uma pista de pneus na neve.
Dois cães brigando na neve.	Dois cães brincam na neve.
Uma pessoa em pé no meio de um monte de pedras nevadas perto de um poço de água.	Uma pessoa está em um vasto campo de gelo glacial.
Um grupo de pessoas está na água.	Um grupo de pessoas corre em uma corrida
O cachorro está correndo com comida na boca.	O cachorro está correndo com uma bola amarela na boca.
Um cachorro marrom e preto caminha na neve branca.	Um cachorro marrom e preto caminha na neve com a língua de sua língua pendurada.
Um garoto usando tinta facial caminha ao longo de uma pista vermelha.	Um garoto com tinta facial está correndo em uma pista.
Dois cães correndo pela praia.	Dois cães correndo na praia
um cachorro preto e branco nadando na piscina	Um cachorro preto e branco correndo com algo na boca.
Dois cães estão cheirando algo nas rochas.	Dois cães correndo por um caminho na floresta.
Um cachorro tem a cabeça dentro de uma bolsa de presente vermelha e verde.	Um animal de estimação investiga de brincadeira o conteúdo de uma sacola de presente.
Um homem amarelo e elevado vestindo uma máscara de sol dourado.	Um homem de camisa amarela usa uma máscara dourada em forma de sol.
Uma garotinha está sentada na grama equilibrando uma pedra no braço.	Uma garotinha caminha em um calçadão com cúpulas azuis ao fundo.
Duas crianças pequenas estão atravessando um campo aberto.	duas crianças pequenas andando em um campo.
Pessoas em um passeio de parque de diversões.	Uma foto de um passeio em um parque de diversões em um dia nublado.
Um garoto pulando em uma piscina que diz "sem mergulho".	Um garoto pula em uma piscina pública não tão frutada.
Um homem está recolhendo um rosto de rocha pura com um apoio à corda.	Um jovem está fazendo um salto de esqui com uma tábua roxa.
Uma criança com as mãos na cabeça.	Um garotinho fica com as mãos em cima da cabeça
Dois cães correndo na neve	Dois cães em pé na neve.
Um homem usando um colete laranja está canoando na água azul.	Um homem de jaqueta laranja levantando as mãos para o céu na areia.
Uma mulher e um homem com uma camisa azul estão posando para uma fotografia.	um homem e uma mulher posando para uma foto
Um cachorro preto coloca na areia.	Crianças brincam na água
Há um esquilo sentado na grama.	Um esquilo fica na grama olhando em volta.
Um cachorro marrom claro percorre um caminho alegremente.	Um cachorro pálido percorre um caminho.
O cachorro bronzeado atravessa as folhas.	Um cachorro bronzeado corre nas folhas de outono.
Um homem velho em um casaco preto em pé em um mercado.	O bebê está usando uma camisa vermelha e andando em uma praça.
Um homem realiza um truque de skate.	Uma pessoa pula da calçada em seu skate.
uma criança andando na neve.	uma criança na neve.
Um homem vestido de preto usando um chapéu e óculos na frente de uma parede vermelha.	Uma mulher de camisa branca em pé em frente a uma parede de tijolos.
Uma bicicleta pula pelo ar.	Um menino e sua bicicleta pula no ar.
Um cachorro marrom está cheirando um cachorro branco que está deitado no chão.	cachorro cheirando outro cachorro deitado sob móveis.
Um homem ajuda um garoto a andar de bicicleta.	O homem ajuda o garoto a andar de bicicleta.
Um cachorro marrom avermelhado atravessa a neve com uma bola de neve na boca.	O belo cachorro avermelhado se encaixa na rua de neve plana com uma bola de neve na boca.
Uma mulher de cabelos vermelhos de preto está posando para um homem enquanto descansa em uma árvore.	Um homem de camisa preta está segurando uma criança usando óculos de sol.
Um homem escalando um rosto de penhasco.	Um homem sobe um rosto de penhasco.
Um homem vai entre dois marcadores de bandeira vermelha em uma bicicleta suja.	O homem Waeribng, um capacete está andando de bicicleta de terra sobre pedras.
Os dois cães estão jogando buscando a neve.	Os cães brincam na neve.
Um cachorro preto com uma gola preciosa está sentada no tapete branco.	Um cachorro preto com uma gola azul está sentado no tapete bege.
Um pequeno cachorro preto e branco rema em um pouco de água azul clara.	Um cachorro preto e branco está nadando em um pouco de água
Duas garotas estão de pijama e parecem estar dançando.	Duas meninas com bonés de beisebol estão comendo um lanche lá fora.
Um cachorro fica ao longo da praia.	Dois cães correndo na praia.
Um cachorro branco e marrom brincando com um brinquedo preto.	Um cachorro branco e marrom está tocando a guerra.
Dois cães pretos estão pulando e brincando com uma bola de tênis amarela na neve.	Um cachorro marrom e um cachorro preto brincando com uma bola de futebol amarelo.
Dois cães estão brincando na praia juntos.	Dois cães pretos estão brincando em uma grama.
Um menino joga beisebol.	Um homem está jogando beisebol.
Puppy jogando com uma bola de tênis em um tapete laranja.	Um cachorro está prestes a pegar uma bola que está no tapete laranja.
Um cachorro preto e branco está pulando sobre um obstáculo.	Um cachorro branco que corre sobre uma ponte.
Um garoto vestindo uma camisa vermelha atravessa a grama com um cachorro peludo.	Um fã de esportes está usando tinta facial nas arquibancadas.
A Dalmation está correndo pela floresta.	Um cachorro corre na floresta.
Uma mulher acena enquanto monta uma tirolesa.	Uma pessoa acenando está pendurada em uma tirolesa.
Um cachorro preto recupera na neve.	Um skatista pulando na rua.
Um homem de rolos em uma barra de metal.	Lâminas de rolos deslizando em uma grade.
Um homem sorridente e uma menina posando para a foto.	Um homem sorridente segura uma criança pequena usando rosa e vermelho.
Dois cães bronzeados e brancos e um cachorro marrom correndo pela praia perto da água.	Lady em uma jaqueta rosa Tinkerbell fica ao lado da grade e olha para a água.
Um cachorro marrom cheire um toco de árvore.	Um cachorro fareja um tronco de árvore.
Um cachorro pulando para um frisbee na neve.	Um cachorro está pulando na neve.
Cinco homens de uniformes azuis e pretos posam para uma foto.	Um grupo de cinco homens de uniforme está posando para a câmera.
Um homem está andando de bicicleta em um caminho de terra.	Dois cães correndo ao longo do caminho da terra.
Uma criança pula no ar em uma pista de boliche.	Um garoto de camisa verde está pulando com os braços no ar no final de uma pista de boliche.
Um cachorro marrom e branco com uma gola rosa está latindo para um cachorro marrom com uma gola azul na neve.	O cachorro com a gola vermelha está carregando os dentes do cachorro com o colarinho azul.
Dois cães marrons atravessam a água.	Dois cães marrons correndo pela água.
Uma jovem sentada de chapéu está lendo em uma cafeteria.	Uma mulher gostando dela lendo em uma cafeteria
Um cachorro preto e branco está correndo pela grama.	O cachorro preto e branco está correndo na grama.
Um homem esqui em uma montanha nevada.	Esquiadores em uma montanha nevada.
Dois cães marrons estão mordendo um ao outro.	Dois cães marrons mordendo -se na areia.
Dois cães fofos correm pela grama.	Dois cães pequenos atravessam a grama.
um cachorro cheirando os pincéis enquanto um touro olha	Um cachorro marrom cheirando a cerca de um touro marrom.
Um skatista tenta um truque na lateral de uma parede baixa.	Um garoto faz truques de skate em uma grade.
O menino está deslizando por um escorregador de piscina e está prestes a bater na água.	Um garoto pequeno em Waterwings e um maiô desliza por um escorregador aquático.
Uma mulher sentada com cabelos curtos e uma câmera joga um frisbee para um cachorro marrom.	Uma mulher que está sentada em um campo ouvindo música joga um Frisbree para seu cachorro marrom.
Uma jovem que faz uma volta na água.	Uma jovem vestindo roxo correndo pela água
Um snowboarder anda de snowboard por um parapeito ao lado de um lance de degraus.	Um menino está moendo um skate em uma parede de concreto.
três galgos correndo em uma pista	Cinco galgos estão correndo em uma pista de areia.
Um cachorro preto está pulando da água.	Um cachorro preto está sacudindo a água.
Um cachorro está pulando no ar tentando pegar um frisbee vermelho.	Um cachorro está pulando no ar para pegar um item.
Um cachorro marrom está andando na água.	Dois cães marrons correndo pela água.
Uma mulher com dois homens em chapéus socializando lá fora.	Uma jovem com um boné de malha fica contra a parede da pizza de um dominó.
Um menino pequeno em um roupão de banho está sentado em uma cadeira de metal.	Um garoto em uma túnica fica em uma cadeira.
Um cachorro sacode a água	Um cachorro balança a cabeça.
Pessoas sentadas em um sofá risam.	Quatro pessoas felizes sentadas em um sofá vermelho
Um cachorro preto está correndo pela neve.	Um cachorro preto de pit bull está correndo pela sujeira.
Um grupo de adolescentes está dançando em um piso de madeira.	Um grupo de pessoas com roupas de cor escura é dançar em linha em um piso de madeira.
O homem senta -se em um sofá sob a ponte e a ninhada está ao seu redor.	Um homem está sentado em um sofá sob uma borda da via expressa.
Um cachorro branco está correndo pela neve.	Um pequeno cachorro branco correndo pela areia.
Uma mulher fica com os braços ao lado dela, enquanto outra tira uma foto.	Um homem fica em uma multidão segurando um objeto branco.
Um garoto está andando de bicicleta.	Uma jovem menina deitada em um brinquedo inflável azul
Um cachorro preto correndo na neve.	Um cachorro preto correndo em uma praia.
Três cães na neve por uma cerca.	Dois cães bebem água em um lago.
Um cachorro marrom brincando jogando lutando com um cachorro preto na terra coberta de neve.	Dois cães brincando no chão coberto de neve
Um cachorro passa pela neve profunda.	Um cachorro branco está correndo pela neve.
Uma garota corre ao longo de uma margem do rio com dois cães pretos.	Um menino está acariciando um tigre que está deitado.
Uma pessoa patina em um parque de skate.	Pessoa de snowboard em uma encosta de esqui.
Um cachorro marrom e branco está correndo pela grama.	Dois cães marrons e brancos correndo pela grama.
Um homem escalando uma face de pedra.	Um homem está escalando uma parede de pedra.
Uma adolescente correndo em uma praia gritando, com um homem mais velho andando atrás dela.	uma criança pequena correndo ao longo da costa em uma praia
Mulher jogando tênis e batendo na bola.	Uma mulher está jogando bola de vôlei.
Um cachorro preto pulando sobre um obstáculo.	Um cachorro pequeno pulando sobre obstáculos.
Dois cães estão correndo na grama.	dois pássaros interagindo na grama
Um garoto com o cabelo em pé, está deslizando por um slide azul	O garoto de camisa laranja está deslizando por um escorregador de cerceta.
Muitas pessoas estão na praia, perto de um prédio com bandeiras voando.	Uma praia movimentada tem pessoas espalhadas por isso assistindo ao céu.
um cachorro em pé na água.	Uma garota brincando em um pára -quedas.
Um homem de jaqueta preta está segurando um microfone em relação a uma jovem menina com longos cabelos castanhos.	Um homem de jaqueta preta segura um microfone no rosto de uma garota.
Um cachorro marrom e branco está andando ao lado de um homem em um skate.	Uma criança loira está deitada em um galho de uma árvore em um campo verde.
homem montando uma prancha de surf em uma onda.	Um homem de preto em uma prancha de surf montando uma onda.
Um surfista está andando em uma onda de quebra.	um grupo de surfistas pegando uma onda
O homem de camisa vermelha está subindo o lado de uma montanha.	Um homem está escalando o lado de uma montanha.
Cão preto e branco que atravessa a água.	Um cachorro marrom e branco atravessa a água.
Uma garotinha em um vestido colorido está brincando com uma bola de futebol azul e vermelha.	Uma garotinha em um vestido brincando com uma bola de futebol.
Um cachorro preto e branco pulando alto para pegar uma bola.	Dois cães pretos e brancos atravessam um campo verde.
Um cachorro preto e branco está perseguindo um ping frisbee.	Um cachorro preto e branco está olhando para um frisbee rosa em uma quadra.
Um homem andando de moto enquanto usava um uniforme preto.	Uma motocicleta branca está sendo montada em uma pista de corrida.
Três crianças brincando em pedras perto de um lago	Três homens jogando beisebol.
Um cachorro marrom está atravessando a água com um graveto na boca.	Dois cães brincando com um graveto na água.
Cão marrom com boca aberta e orelhas na corrida de ar.	Um cachorro cinza com cabelos curtos correndo em direção à câmera.
uma mulher e um cachorro brincando lá fora	Uma mulher brinca com seu cachorro Rottweiler lá fora.
Três palhaços em trajes brilhantes e multicoloridos.	Três mulheres em vestidos de cores vivas.
Um cachorro preto nadando através de um rio.	Um cachorro preto cavando através da neve.
Um cachorro marrom pula alto em um campo de grama.	Um cachorro marrom correndo em campo de grama verde longa.
Dois cães bege brincam na grama.	Dois cães bronzeados brincam na grama
Dois cães estão correndo pela grama perto de uma casa e árvores.	Dois cães estão correndo por um quintal verde
O cachorro marrom e branco está correndo pela areia com um objeto vermelho na boca.	Um cachorro está correndo ao longo de uma praia com um objeto vermelho na boca.
Um homem e uma mulher estão sorrindo.	Um homem e uma mulher rindo.
Um homem está de pé em cima de uma pedra ou montanha assistindo o sol.	Um homem de pé nas montanhas assistindo a um pôr do sol.
Um pitbull marrom e branco atravessa a grama com um graveto na boca de It.	Um cachorro atravessa a água enquanto segura um graveto na boca.
Duas meninas estão brincando em um trampolim.	Dois meninos estão brincando em um parquinho.
Um cachorro preto e branco pulando no ar.	Um cachorro preto e branco pulando para pegar uma bola.
Duas meninas estão pulando no ar.	Dois cães se agitam na grama perto de um lago.
A mulher segurando uma bolsa preta está fumando um cigarro.	Uma mulher com uma bolsa preta está fumando um cigarro
Um menino pequeno usando uma fralda fica perto da porta e é coberto de marcador.	Um garoto coberto de tinta fica em frente a uma porta branca.
Um cachorro está correndo ao longo da grama.	Um cachorro marrom está correndo na grama.
Um homem com cabelo comprido está olhando através de uma câmera.	Uma mulher fica contra uma parede perto de uma câmera de vídeo.
Um cachorro e uma bola vermelha no ar.	Um cachorro cava um buraco em um quintal.
Um cachorro bronzeado atravessa a neve.	Um cachorro preto correndo pela neve.
Um cachorro marrom e branco está correndo em um campo marrom.	uma pessoa pendurada em um penhasco rochoso.
Cão marrom correndo na grama.	O cachorro está correndo na grama.
Um cachorro corre pela grama.	Um cachorro trota pela grama.
Uma mulher fica em uma parede para acariciar um elefante.	Um homem está montando um elefante enquanto outra pessoa toca a cabeça do elefante.
Um cachorro branco e fofo está de pé nas patas traseiras.	Um homem está andando atrás de um cachorro que está de pé nas patas traseiras.
Duas pessoas usando chapéus sentam -se e olham para a câmera.	Um homem vestindo uma camisa azul faz um rosto ranzés.
Um cachorro deita -se na frente de um barco entrando no nevoeiro.	Um homem ajuda outro homem a dar uma volta no quintal.
um skatista fazendo um truque em uma rampa	Um skatista subindo até uma ladeira.
Um cachorro preto parado na grama perto de um vôlei.	Um marrom e preto com uma gola azul perto de uma bola de futebol em um campo gramado.
um homem esquis aquático enquanto preso a um pára -quedas.	Um surf de pipa de homem cria uma onda.
Um filhote marrom mastigando um graveto.	Um filhote com orelhas grandes mastigando um graveto.
Um cachorro com suas duas patas dianteiras em uma pedra em um campo.	Um cachorro está correndo em um campo.
Duas garotas brincando com pessoas e flores atrás delas.	Duas jovens usando saias estão brincando em um jardim.
Uma mulher joga um jogo de boxe em uma tela grande.	Uma mulher de jeans joga um videogame na frente de uma tela grande.
Um homem vestido de jeans está andando ao longo de uma rua coberta de neve ao lado de edifícios de tijolos vermelhos.	Um homem de azul anda por uma rua nevada ao lado de um prédio de tijolos.
Um cachorro pula através de um hulahoop preto.	Um treinador corre ao lado de seu cachorro enquanto pula através de vários aros.
Um surfista pegando uma grande onda no oceano.	Um homem está surfando uma grande onda no oceano.
Um homem de camisa branca está dançando com uma mulher de preto.	Um homem de camisa branca e uma mulher em um vestido preto dançando.
Uma garota de camisa rosa está esparramando seus membros no ar.	Um homem vestido com um terno de Papai Noel está subindo um grande edifício de concreto.
Uma garotinha de camisa vermelha puxa uma pipa.	Uma garota de camisa vermelha tira uma foto em um telefone.
Um cachorro corre com um brinquedo amarelo na boca.	Um cachorro nadando com um graveto na boca da sua boca.
criança deslizando na neve.	Homem dormindo na rua.
O cachorro preto toca na neve.	Um poodle preto está brincando com a neve.
Um cachorro branco com orelhas marrons está correndo na calçada.	Um cachorro branco com manchas marrons está correndo em um quintal, perseguindo uma bola.
Três cães estão brincando na água.	Três cães nadam na água.
Um cachorro branco correndo na areia.	Um cachorro branco corre na areia.
Uma garotinha com as mãos no ar está sentada nas costas de um homem enquanto ele está deitado em um cobertor.	Uma criança corre na direção oposta de outros que estavam jogando um jogo.
Uma mulher em fantasia está tocando uma gaita de foles.	Uma senhora vestindo um vestido vermelho está tocando um cano de bolsa.
um grupo de pessoas tirando suas fotos.	Um grupo de pessoas está na água.
Uma corrida de carros de corrida vermelha e branca corre em uma pista de terra.	Uma pessoa está andando de bicicleta de terra em uma corrida em uma pista de terra.
Um cachorro preto e branco está atravessando um campo de vaca.	Um grande cachorro preto e branco corre na água do oceano
Um cachorro branco com marcas marrons claras tem um graveto na boca e as patas na neve.	Um cachorro branco segura um graveto na boca enquanto passa pela neve.
Um homem de chapéu de palha sugere o telefone enquanto outros andam em uma calçada movimentada.	Um homem deita em uma rua com os ombros da cabeça debaixo de um carro estacionado que é levado.
Um homem com uma bolsa mensageira na frente de uma parede de ladrilhos cinza.	Homem de jaqueta vermelha em pé em frente ao farol.
Os cães estão andando no deserto.	Três cães brincando na água verde.
Um cachorro nada na água.	Três cães nadam na água.
Grupo de meninas e um cachorro em pé na estrada.	um grupo de pessoas rafting em uma balsa azul.
Um pequeno cão de cabelos encaracolados branco atravessa a calçada com um graveto na boca.	Um cachorro de cabelos encaracolados branco corre com um graveto na boca.
Um homem de terno molhado está jogando um bebê usando um terno molhado no ar.	Um homem de camisa branca e uma mulher em um vestido preto dançando.
Um homem de terno cinza se ajoelha na frente de uma mulher em um vestido branco.	Uma mulher de vermelho com uma cerveja seguida por um homem em branco.
Dois grandes cães marrons estão pegando um frisbee preto.	Dois cães marrons estão mordendo um frisbee preto.
A mulher loira está vestindo uma bandeira preta e americana, boné de tartan.	Uma mulher de pêlo ruivo está usando uma boina negra adornada com a bandeira americana.
Uma pessoa segurando uma rede está na água.	Uma mulher negra e duas crianças negras estão sentadas em uma barraca de palha.
Uma mulher em um tracksuit vermelho espremendo limões em uma imprensa.	Uma jovem de um capuz rosa tira uma foto.
Dois cães brincam na grama.	Dois cães brincam na água.
Um cachorro preto e branco está correndo pela grama.	Um cachorro bronzeado está andando pela neve.
Uma mulher anda com um livro enquanto fala em um telefone celular.	Uma mulher vestindo um casaco azul anda e fala em seu celular.
Um homem caminha dois cães em trelas na rua	Um homem caminha dois cães na cidade.
Um cachorro marrom e branco com um frisbee rosa na boca de It está decepcionando as costas de um homem.	Um cachorro com um frisbee na boca, pula sobre um homem.
Um homem adulto vestindo uma mochila anda e olha para a esquerda.	Um homem vestindo uma mochila olhando para o lado.
Um cachorro está correndo na neve.	Dois cães correndo na sujeira
Um menino pequeno brincando na neve.	O cachorro marrom e branco está brincando na neve.
Dois cães brincam na grama.	Dois cães atravessam a grama.
O cachorro está pulando no ar.	Um cachorro encharcado está brincando na água.
duas crianças pulando em um corpo de água.	duas pessoas mergulhando em um corpo de água.
Um cachorro aproveitado pula sobre um tronco enquanto outro cachorro segue para trás.	Um cachorro marrom e branco está pulando sobre um tronco em um campo, enquanto outro cachorro segue atrás dele.
Várias pessoas sentadas em pequenas mesas em uma sala escura.	As pessoas estão sentadas em mesas quadradas em uma sala vermelha.
Um cachorro e um gato deitados juntos.	Dois cães cinzentos estão carregando um graveto na água.
Este é um barco na água com montanhas ao fundo.	Um barco branco na água vítrea com montanhas ao fundo.
Um cachorro está brincando na água.	Um cachorro tritura água.
Uma mulher de camisa azul e bronzeado fica à mesa.	Uma jovem sorridente em uma camisa e uma bandana de turismo posa à mesa ao ar livre.
Uma família está brincando na praia com seu cachorro.	Uma menina nua sendo jogada no ar.
Um cachorro que atravessa o Deep Snow Pack.	Um cachorro passa pela neve profunda.
Três jovens dançam na praia na areia.	Três crianças brincando na areia na praia
Dois cães brincando juntos na neve.	Dois cães brincam juntos no quintal.
Um homem de camisa azul segurando uma câmera.	Um homem de camisa azul fumando um cigarro.
Pessoas com números no peito estão correndo em um pacote.	Um grupo de pessoas está correndo uma corrida.
Um cachorro branco correndo na neve	Os cães estão correndo na neve.
Um cachorro passa pela grama alta.	Um cachorro se deita na longa grama verde.
O cachorro preto está correndo pela neve.	Um motorista de carro está dirigindo o carro pela lama.
Um cachorro vestindo um suéter verde e uma mochila andando na neve.	Um cachorro pequeno vestindo um suéter verde e uma mochila caminha pela neve.
um grupo de pessoas sentadas em torno de uma mesa.	um grupo de meninas em uma praia.
O cachorro marrom está atravessando a grama com um brinquedo amarelo na boca de ele.	Um cachorro bronzeado correndo pela grama com um brinquedo na boca.
Três cães estão correndo em um campo.	Dois cães estão correndo em um campo gramado
Um homem e uma mulher com as mãos nos queixos estão parados ao lado de uma árvore de Natal.	O homem com barba branca e tampa azul está na porta de uma oficina.
O cachorro preto e branco tem um graveto nas patas.	Um cachorro preto e um cachorro branco estão de pé na neve.
Um cachorro branco correndo pela neve	O cachorro preto e branco atravessa a grama.
Um cachorro preto e marrom está correndo em um campo lamacento.	um cachorro solitário correndo em uma estrada suja
Um homem está montando um caiaque pela água.	Um homem caiaque em água áspera.
Um homem em esquis em uma colina coberta de neve com montanhas ao fundo	Um cachorro gosta de uma brincadeira na água com montanhas e areia ao fundo.
Um homem de barbear preto uma escultura de gelo.	Um homem tem uma serra elétrica e está esculpindo um bloco de gelo.
O menino com camisa azul rasteja pelas aberturas de aberturas perto de grandes janelas de vidro.	Um menino pequeno de azul rasteja ao longo de uma janela.
Um cachorro bronzeado está carregando um graveto na boca do lado de fora.	Um cachorro pequeno está carregando um graveto na boca.
Um grupo de pessoas está acampando em algumas pedras.	Um grupo de pessoas está parado ao lado de um caminhão de bombeiros.
Um cachorro preto e branco pulando alto para pegar uma bola.	Um cachorro preto e branco está pulando sobre um obstáculo.
Um cachorro preto está brincando na água com um brinquedo verde.	Um cachorro preto e branco está brincando com um cachorro marrom.
Três cães marrons estão brincando no mar.	Três cães marrons estão na água.
Quatro crianças pequenas sentam -se em bancos altos em um bar de restaurantes.	Quatro crianças sentam -se em bancos altos de bar em um bar amarelo e cinza.
Um homem em um ninho de bicicleta em um rio.	Um homem de bicicleta faz um salto muito em altura.
Três cães na grama correndo em direção à câmera.	Os dois cães estão correndo em direção à câmera.
Um cachorro marrom brincando lá fora com uma bola rosa.	Brown Dog pega uma bola rosa no parque.
Dois jovens estão fazendo malabarismos com blocos multicoloridos com pessoas assistindo.	Dois homens estão fazendo malabarismos com caixas coloridas, enquanto outros homens ficam em uma varanda.
Um cachorro beliscando os pés de uma vaca.	Um cachorro marrom correndo atrás de uma vaca jovem.
um cachorro correndo na grama	Dois cães estão correndo na grama.
Um cachorro marrom corre perto da água.	Dois cães marrons atravessam a água.
Há um cachorro preto pulando em uma piscina.	Um cachorro preto está pulando em uma piscina.
Um menino recebe um sabre leve para o Natal.	Um menino segura um sabre leve em frente a uma árvore de Natal.
Um esquiador descendo a colina nevada.	Um cachorro marrom está deitado na neve.
Dois cães estão correndo na grama.	Dois cães correndo na sujeira
Dois cães pretos estão brincando de cabo de guerra com um brinquedo laranja.	Dois cães estão jogando puxador de guerra com um brinquedo verde.
Um homem está pulverizando um líquido de uma mangueira longa na praia.	Um cara está sentado em sua bicicleta com uma roda no ar.
Três cães brincando na neve enquanto um cachorro usa uma jaqueta.	Três cães brincando na neve, com uma cidade ao fundo.
Muitos jogadores de futebol sentados no chão.	Um cachorro rola no chão.
Um grupo de pessoas em barcos correndo em direção à costa.	Um grupo de pessoas fica junto e se posiciona em frente a uma casa.
Um menino e uma garotinha brincando juntos lá fora.	Uma mulher vestindo uma camisa branca fica na rua.
Uma pessoa em um colete vermelho está tocando os patins de gelo azul em outra pessoa.	Uma senhora prende os patins de alguém na neve.
Um cachorro dourado toca na neve	Três cães brincando na neve.
Um homem usando óculos fica em frente a uma montanha nevada.	Um homem usando shorts pretos está em frente a uma montanha coberta de neve.
Uma garota salta de cabeça para baixo na cabeça em um trampolim.	Uma garota está pulando na cabeça em um trampolim.
O surfista faz uma onda de uma onda.	Um surfista faz um giro em uma onda.
Um homem está segurando uma trela muito longa presa a um cachorro muito grande que está cheirando a grama.	Um homem segura uma trela longa com um grande cachorro cinza preso a ele.
As pessoas viajam até o elevador juntas.	As pessoas sobem a escada rolante.
Um cachorro marrom parado no meio do campo de Ahuge.	um cachorro marrom em um campo.
Duas crianças brincam em um barco verde na grama.	Duas crianças estão jogando futebol de bandeira juntos.
Uma DJ feminina mantém um álbum de Michael Jackson.	Uma garota segurando uma foto de Michael Jackson sorrindo
Dois homens, um em vermelho e um em branco jogando um jogo de basquete.	Um homem com Jersey 23 está mergulhando a bola em um jogo de cesto.
Uma mulher em pé na frente das árvores e sorrindo.	Um homem está andando por árvores em frente ao horizonte da cidade.
Dois cães estão brincando na neve.	Um cachorro brincando na neve.
Um homem vestindo uma camisa azul agacha -se em um penhasco rochoso.	Um homem se senta em uma pedra.
Um cachorro branco com uma mancha laranja pulando pela grama seca.	Um cachorro está correndo através de juncos em direção ao oceano.
Um cachorro preto e branco pula para pegar o Frisbee.	Um cachorro preto e branco pula após um brinquedo amarelo.
Um cachorro preto pula na neve.	Um cachorro preto pulando sobre trilhas de pneus na neve.
Um garoto que faz uma costas deslizando para uma piscina.	Um garoto usando baús de natação vermelha e azul pulando a cabeça primeiro em uma piscina.
Três meninos se cobrem com bolhas.	Três crianças paradas ao lado de uma piscina são cobertas de bolhas de espuma.
O garoto está olhando para a garota enquanto outra garota os ignora.	O garoto está mergulhando na piscina enquanto o casal assiste.
Dois poodles padrão brancos brincam com um brinquedo na neve	Dois cães brigando na neve.
Uma multidão de pessoas fica em uma estrada rural, um campo atrás deles, uma floresta na frente.	Um monte de pessoas paradas ao lado de um carro com o tronco aberto.
Menino deita de estômago na grama.	menino pequeno deitado de estômago na grama.
Um homem está pulando sobre uma parede baixa segurando uma bicicleta.	Um homem caminha sobre uma pequena placa carregando sua bicicleta.
Um cachorro preto está nadando com uma bola na boca da sua boca.	Um cachorro branco está de pé nas patas traseiras de uma bola na boca de sua bola.
Um cachorro preto com uma gola azul está correndo na neve.	Um cachorro preto com uma gola vermelha toca na neve.
Um espadachim japonês pula no ar.	Uma mulher está levando seu cachorro a pular no ar.
Um garoto vestindo uma camisa amarela e calça azul está subindo uma árvore em uma área montanhosa.	Um garoto vestindo uma camisa amarela e calça azul está subindo em um galho de árvore em um campo gramado.
Dois cães brincam em uma árvore.	Um cachorro persegue outro por uma árvore.
Um pássaro está sentado em uma árvore.	Um pássaro fica sentado em uma árvore sem folhas.
Um cachorro marrom mastiga uma bola laranja.	Um cachorro tem uma bola laranja na boca.
Um caminhante com uma mochila está em um topo de montanha enevoado.	Um caminhante escalando uma colina rochosa com neblina ao seu redor.
Um homem e uma mulher sentam -se em um carro e assistem à estrada.	Um homem e uma mulher sentados em um carro estacionado.
Um homem com uma camisa marrom escura está subindo uma elevação rochosa.	Um homem está escalando uma montanha rochosa.
Dois meninos usando bonés de natação azuis combinando nadam em um lago.	Meninos cantando em bonés de natação azuis.
Um cachorro branco corre ao longo de uma costa rochosa.	Um cachorro pula sobre um obstáculo.
Três meninos pulando em uma piscina.	Três meninos felizes vestindo ternos de banho azuis de mãos dadas enquanto pulam em uma piscina ao ar livre.
Um cachorro marrom pulando no ar para pegar uma bola.	Três jovens pulando no ar para pegar uma bola.
menino fazendo truques em um skate	Um homem fazendo um truque em um skate.
Um cavalo marrom e branco corre rapidamente.	Um cachorro marrom e branco está correndo em torno de um poste.
O cachorro marrom e branco está na água.	O cachorro marrom e branco está brincando na neve.
Uma criança está andando de uma mesa de piquenique para outra.	O garoto pula de uma mesa de piquenique para a outra no parque.
Um homem vestindo shorts de boxe da bandeira dos EUA está de pé em uma escada.	Uma mulher vestindo uma camisa branca fica na rua.
Um grupo de sete pessoas está rafting nas corredeiras em um barco verde.	Um grupo de pessoas está de pé e sentado no chão à noite.
um cachorro na neve.	Dois cães na neve.
Um homem com cabelo comprido está olhando através de uma câmera.	Um homem com óculos de sol olhando para frente.
Dalmation correndo pela praia.	Uma dalmation corre ao longo de uma praia.
Um homem sobe uma montanha nevada.	Um caminhante move uma montanha nevada.
Um cachorro preto e branco pulando no ar para pegar um frisbee	Um cachorro preto e branco pulando em um quintal.
A mulher está segurando o arnês que o cachorro marrom e branco está usando.	Um homem e uma mulher estão olhando para obras de arte que estão em cavaletes e presas a uma parede de esgrima.
Um cachorro marrom e branco corre com uma bola de tênis na boca.	Um cachorro preto e marrom está correndo com uma bola de tênis na boca.
Um cachorro que atravessa a neve.	Um cachorro corre na neve.
Uma pessoa vestindo jeans senta -se em cima de uma sela de cavalo.	A garota está sentada em cima de uma sela.
Um jogador de futebol em um uniforme vermelho acabou de chutar uma bola.	Um goleiro em um uniforme vermelho chuta na bola de futebol para proteger o gol.
Quatro cães negros atravessam a grama.	Um cachorro atravessa o campo gramado.
Um homem de vermelho e preto está batendo uma bola de futebol com a cabeça.	Um homem em uma camisa de futebol listrada vermelha chega uma bola.
Um cachorro marrom está andando na grama.	Um cachorro persegue outro por uma árvore.
Um cachorro amarelo na neve.	Dois cães brincam na neve.
Uma garota está pulando.	Um menino está escalando.
Um cachorro carrega um pau pela floresta.	Um cães sujos atravessa a floresta.
Um cachorro atravessa a grama.	Um cachorro passa por uma pista de obstáculos.
Um garoto vestindo uma camisa amarela e calça azul está subindo em um galho de árvore em um campo gramado.	Um garoto de cabelos loiros vestindo uma camisa amarela e calça azul está subindo um galho de árvore grande e caído ao ar livre em prado gramado.
Dois homens estão correndo na água.	Dois meninos brincando com patos perto da água.
Chases de cachorro marrom após bola amarela no parque	Dois cães marrons se perseguem na neve.
Uma mulher colocando um bebê em um skate na praia.	Uma mulher segura um pequeno bebê em um skate na praia
Dois cães pretos e brancos correndo em um campo.	Um cachorro preto e branco pulando em uma piscina.
Um cachorro preto está mordendo uma orelha de cães marrons claros de uma maneira divertida.	Um cachorro preto de brincadeira bits outro cachorro em uma sala de estar
O Beagle está andando na praia na linha d'água.	Um Beagle caminha ao longo da costa calma.
Um jovem arremessador está jogando o beisebol.	Um cachorro marrom está andando na grama ao lado de uma cerca.
uma pessoa no ar médio em uma motocicleta amarela.	Um ciclista em uma bicicleta amarelo neon está no ar.
Uma jovem menina desliza por um escorregador de plástico verde em um playground.	Uma garotinha deslizando por um escorregador em um playground.
Uma criança se vira com um objeto na mão enquanto alguém passa atrás dele.	Um garoto rasteja através de um túnel de pedra com seu irmão e pai atrás dele.
O cachorro preto e branco atravessa a grama.	Um cachorro preto e branco está atravessando a grama.
pequeno cachorro preto correndo na grama	Dois cães correndo na grama
Uma garota está fazendo um truque em seu trampolim.	Uma garota faz um pino em um trampolim.
Dois cães passam pela neve, um com uma bola de tênis.	O garoto está fazendo um golpe, através do ar, em sua bicicleta.
Dois cães correm em direção à costa através de águas rasas.	Dois cães cinzentos que atravessam as águas rasas de um lago.
Um cachorro preto está andando na grama com um graveto na boca da sua boca.	O cachorro preto está correndo na grama com um brinquedo na boca de ele.
Crianças jogando futebol de tag.	Os meninos jogam touch futebol.
Três crianças brincando de neve.	Três crianças brincando no feno
Um homem caminha em direção a um policial em pé em uma faixa de pedestres em uma rua da cidade.	Um policial fica em uma faixa de pedestres em uma cidade.
Um garoto está girando em torno de um taco de beisebol na grama.	Um garoto segura a cabeça em um taco de beisebol na grama verde.
Duas pessoas andam de bicicleta por uma estrada de terra.	Duas pessoas andando de bicicleta em uma colina.
O cachorro preto e marrom está brincando no quintal.	O cachorro preto e bronzeado está perseguindo algo que ele viu.
Um cachorro preto na grama está segurando um pássaro na boca.	Um cachorro preto está segurando um pássaro preto na boca.
Um cachorro preto e um cachorro branco brincando na rua.	Um cachorro preto e um cachorro branco brincam juntos na rua.
Um homem de camisa preta nada ao lado de uma garota em uma prancha de surf rosa.	Um homem nadando ao lado de uma garota em uma tábua rosa.
Um garoto de jaqueta azul balança um bastão em uma bola.	Um garoto vestindo uma viseira azul balança um bastão.
Um grande cachorro preto e branco está nadando na água.	Um cachorro preto e branco com um graveto está em água enlameada.
Um garotinho palhaçado com uma peneira na cabeça.	Um garoto com uma peneira de metal na cabeça.
Um cachorro marrom está correndo pelo campo.	um cachorro marrom com a língua abanando enquanto ele passa por um campo
um esquiador esqui a uma grande montanha	Uma pessoa esquia por uma montanha muito grande de neve.
Um cachorro corre pela grama.	Um cachorro corre pela grama.
Um menino está soprando bolhas	Um menino de azul está soprando bolhas.
Um homem está segurando um poste em frente a um prédio.	Três postes aguardam um ônibus do lado de fora de um prédio.
Um menino está pulando na água com uma bola na mão.	Um garotinho nadando debaixo d'água com um brinquedo na mão.
Dois meninos mostram suas línguas azuis manchadas.	Dois meninos com bonés de beisebol estão destacando línguas manchadas verdes.
Uma pessoa usando equipamento de mergulho está nadando na água subaquática.	Uma pessoa está mergulhando em água azul muito clara.
Um cachorro branco e preto corre na grama.	cachorro preto e branco correndo para fora.
Dois homens ficam em um top de penhasco com vista para uma praia de areia.	Um homem fica em um penhasco com vista para o oceano.
Este cachorro está pulando pela água.	Dois cães correndo pela água em uma praia.
Um bebê masculino faz um rosto engraçado para a câmera.	Crianças sorrindo e fazendo caretas para a câmera.
Dois trabalhadores de construções sentam -se em um feixe fazendo uma pausa.	O homem está colocando a camisa perto de um elevador.
Um homem e uma mulher rindo.	Um homem e um beijo de mulher.
Um menino está em um pneu	Uma criança rola em um pneu grande.
Um cachorro preto, marrom e branco correndo por um campo.	Um cachorro branco e marrom corre em um campo.
Dois cães correm na grama.	Um cachorro correndo na grama.
As crianças estão brincando em uma piscina enquanto dois homens adultos os observam.	As crianças brincam em uma piscina enquanto os adultos olham.
Os jogadores de futebol estão trabalhando para esticar as pernas.	Os jogadores de futebol estão se estendendo juntos.
Um cachorro está de pé na areia.	Um cachorro bronzeado está em frente a algumas plantas.
Quatro garotas em roupas de banho estão jogando vôlei na praia.	Quatro damas em roupas de banho jogam vôlei de areia na praia.
Duas crianças estão em um passeio de feira.	Duas crianças estão em um slide inflável gigante.
Duas crianças espirrando na água.	Dois cães brincam juntos na cama.
Cão marrom e branco com uma bola de beisebol na boca.	Cão preto e branco segurando uma bola de beisebol na boca.
Um cachorro bronzeado atravessa a neve.	Um cachorro branco está correndo pela neve.
Uma criança de cabelos loiros balançando em um balanço do pneu.	Uma criança de cabelos loiros está balançando em um balanço do pneu.
O cachorro marrom e branco está andando em águas rasas.	Um cachorro branco e marrom parece estar andando na água.
Uma mulher lê enquanto em transporte público.	Um homem que adormeceu no transporte público.
Dois cães estão brigando na calçada de tijolos.	Dois cães acastanhados estão brigando.
Um Bulldog está passando por um parque gramado enquanto as pessoas ficam em segundo plano.	Um cachorro está correndo em um grande corpo de água, fazendo com que ele salve.
um garoto andando de bicicleta em uma estrada de tijolos	Uma pessoa faz truques em uma bicicleta em uma rampa cercada por árvores.
Um cachorro marrom e um cachorro marrom estão brincando de grama alta.	Um cachorro preto e marrom com uma bola vermelha no alto tocam na grama.
Um homem dormindo em um banco listrado amarelo com os pés em um carrinho de bagagem.	Um homem de jeans descansando em um banco listrado com os pés em um carrinho de bagagem
O cachorro preto e branco está correndo na grama.	Este grande cachorro preto e branco está correndo na areia.
Dois boxeadores com luvas brancas estão lutando.	Dois homens com luvas brancas em uma pista de boxe pouco iluminada.
Um skatista alto no ar acima de uma rampa interna.	Um skatista no ar acima de uma rampa interna.
O cachorro preto está correndo pela água.	O cachorro preto e branco está correndo pelos arbustos.
O cachorro preto e branco está correndo na grama.	O cachorro branco está correndo na grama verde.
O jovem está andando de skate em um parque de skate.	Um garoto de camiseta azul está no ar em um skate em um parque de skate.
Uma mulher tirando sua foto tirada na frente de uma grande escultura.	Uma mulher posa para fotos com uma estátua de um troll.
Um cachorro marrom e branco está andando ao lado de um homem em um skate.	Um cachorro marrom e branco está correndo por uma rampa.
Um cachorro marrom pula alto na grama.	Um cachorro marrom cava na areia.
Um cachorro marrom que atropela a grama.	um cachorro marrom correndo
Uma garota pulando uma corda em uma calçada perto de uma garagem.	Uma garota pulando uma corda em uma calçada com uma garagem à esquerda.
Dois cães correm na praia.	Cachorro marrom correndo na praia.
Uma pessoa está na água na praia enquanto o sol se põe.	uma pessoa acima da prancha na água.
um skatista na cidade.	um skatista em uma rampa.
Um cachorro pula no ar para pegar um frisbee.	O cachorro marrom pula para um frisbee rosa.
Uma criança usando shorts azuis e brancos está pulando nas ondas.	Uma garota usando verde torce algo em suas mãos.
Três cães correndo por uma poça.	Os cães estão correndo pelo quintal.
O cachorro retorna o brinquedo do jogo ao seu mestre.	Três cães correm na neve juntos.
Dois idosos se sentam em uma mesa de café ao ar livre.	Três pessoas sentam -se em um café ao ar livre.
Uma mulher vestindo uma saia xadrez fica segurando um cigarro.	Um homem de camisa azul está do lado de fora fumando um cigarro.
Duas mulheres saltam de balanços.	Duas garotas saltam para fora dos balanços.
Uma mulher com uma jovem pose com estátuas de urso em frente a uma loja.	Um homem em uma camisa fica na frente de uma grande multidão.
Uma pessoa usando calças rosa e uma parka branca em um parque de neve.	Uma pessoa usando calças rosa e uma jaqueta branca é o snowboard.
Dois cães correndo na costa.	Um cachorro branco correndo na praia.
Dois cães correm em uma área de terra perto de uma floresta.	Dois cães correm por um caminho de terra na floresta.
O cachorro branco tem uma bola na boca.	O cachorro preto e branco tem uma bola na boca.
Um homem de camisa vermelha passa uma cachoeira com uma corda vermelha.	Um homem de vermelho está subindo uma cachoeira com uma corda vermelha.
Um cachorro marrom passa pela água no oceano.	Um cachorro marrom passa pela água quando uma onda vem.
Uma garota vestindo uma jaqueta verde está de pé em um semáforo.	Uma mulher de jaqueta verde está esperando para atravessar a rua com uma luz.
Um homem sem camisa jogando futebol em um gramado.	Um homem sem camisa pega uma bola
Uma garota usando verde torce algo em suas mãos.	Um garoto usando apenas shorts verdes posa desajeitadamente com um fundo de tijolos.
Uma jovem menina sorrindo com a cabeça de cabeça para baixo	Uma garota posa com a cabeça de cabeça para baixo.
Duas mulheres segurando bandeiras quadriculadas perto de um carro laranja.	Duas senhoras de roupas acanhadas posam ao lado de um carro à moda antiga.
Um jovem com barba em um evento.	Um cachorro fica em uma praia ao pôr do sol.
Um homem de jaqueta vermelha segura a bicicleta pela foto.	Uma mulher em uma jaqueta vermelha é um vídeo gravando uma paisagem natural.
Um garoto pula em uma piscina pública não tão frutada.	Um homem pula em um snowboard.
Um menino brinca nas fontes.	Um garoto toca na fonte de água.
Dois meninos jogam espadas na grama com hastes.	Dois meninos brincam com grandes paus no quintal.
Os palhaços estão fazendo uma pose para a câmera.	Uma criança em Orange está em uma prancha de boogie nas ondas.
Um cachorro preto caminhando ao longo de um terreno rochoso.	Um cachorro preto caminha por uma paisagem rochosa e gramada sob um céu azul e nublado.
Quatro crianças de mãos dadas pularem em uma piscina.	Quatro cães brincando na neve.
Dois cães marrons latindo um para o outro.	Dois cães marrons e pretos rosnando um para o outro.
Um cachorro preto pulando em um lago.	Um cachorro preto corre muito rápido em um campo em um parque.
uma criança brincando na água.	uma criança em água.
Um carro amarelo acelera ao longo de um campo de neve.	Um carro amarelo dirige rapidamente na neve.
O cachorro preto está correndo na grama.	O cão de pastor alemão está correndo pela neve.
Um garoto empurra uma carroça com duas abóboras.	Uma criança se agacha atrás de uma carroça com duas abóboras.
Dois jogadores de futebol lutam pela bola durante uma partida intensa.	Dois pequenos cães laranja e brancos estão na neve.
Uma pessoa nadando em água próxima e uma pequena cachoeira.	Uma pessoa flutua em água perto de pedras e uma cachoeira.
Dois meninos em um campo chutando uma bola de futebol.	Dois jogadores de futebol se baterem durante um jogo de futebol.
Duas pessoas correm na areia na praia.	Pessoas fugindo das gaivotas na praia.
Um cachorro branco corre por pinheiros na neve.	Um cachorro fica na neve branca.
Um cachorro branco atravessa um campo de flores amarelas.	Um cachorro passa por um campo gramado de flores amarelas.
O cachorro preto está andando pela grama alta.	O cachorro preto está correndo pela grama.
Dois cães brincando na neve.	Dois cães brincando de grama.
Um garoto está empurrando outro garoto em um balanço.	Um menino está empurrando outro garoto nos balanços.
Um arremessador em um monte joga uma bola de beisebol.	Um garoto no meio de um arremesso em um jogo de beisebol.
Duas meninas brincando nas barras paralelas.	A menina está brincando no playground.
Dois cães negros brincando na neve.	Um cachorro preto cava na neve.
Um cachorro branco e bronzeado atravessa a grama verde alta.	Um cachorro marrom e branco de tamanho médio está passando pela grama alta.
Um cachorro marrom e branco cheira a neve.	Um cachorro preto e branco pula na neve.
Dois cães brincam em águas rasas.	Dois cães brincam na água.
Uma garota vestindo um casaco rosa salpica em poças de chuva.	Uma garota de jaqueta rosa está andando por uma grande poça.
Um cachorro pula sobre uma corrente.	Um cachorro pulando sobre uma corrente.
Um homem fica em frente às montanhas cobertas de neve.	Um homem esquiando em uma montanha coberta de neve.
Menina e homem mais velho, de mãos dadas e andando em trilhos de trem.	A menina de vestido azul está andando com um homem ao longo de uma trilha ferroviária.
Um cachorro preto e cinza corre em um campo com a língua de sua língua pendurada.	Um cachorro preto com uma gola vermelha caminha pela grama com a boca aberta e a língua pendurada.
Uma garota com uma bolsa preta sentada em um banco de madeira.	Uma jovem com uma bolsa preta fica em um banco de madeira.
O cachorro está correndo na grama.	Um cachorro joga na grama.
Um menino de camisa vermelha, em frente a uma longa parede azul, levanta a sobrancelha na câmera	O garoto de camisa vermelha fica ao lado de uma parede azul.
O garoto está deslizando para baixo em um escorregador de plástico marrom.	O garoto está deslizando por um slide de metal.
um cachorro preto e amarelo	Um cachorro preto e um cão marrom e branco brincam em um campo.
Três crianças em um poço de bola.	Várias crianças brincando em um poço de bola.
Um grande cachorro branco e cinza passa por um túnel amarelo em uma pista de obstáculos.	Um cachorro branco e preto está saindo de um tubo amarelo e laranja.
Um cachorro preto e branco está nadando em um grande lago verde.	Um cachorro preto e branco está nadando em um lago.
Um nadador está fazendo o golpe nas costas na piscina.	uma pessoa que faz o golpe traseiro em uma piscina
O cachorro branco e marrom está correndo pela grama.	O cachorro marrom está correndo na grama.
Um homem está montado em uma bicicleta em uma trilha rochosa por um lago.	Uma mulher está vestindo uma bandana branca, blusa roxa e luvas pretas.
Um cachorro marrom está correndo pela grama verde.	Um cachorro marrom está correndo por um rio.
Um motociclista "coloca um rodas" em um campo gramado emoldurado por colinas.	Um homem em uma motocicleta coloca um rodas na terra.
Um menino está chutando os pés na água.	Um garoto de shorts chuta em pé em águas rasas.
Um pequeno cachorro branco e um cão marrom grande na grama.	Um pequeno cachorro bronzeado está passando por um grande cachorro marrom em pé na grama.
O garoto vestindo uma camisa jeans coloca a língua.	Um garoto vestindo uma jaqueta jeans enfia a língua para fora.
Uma mulher segura um cachorro enquanto outro cachorro está próximo em um campo.	Uma senhora segurando um cachorro enquanto outro cachorro está brincando no quintal.
Um cachorro marrom claro está correndo na água.	um cachorro marrom e branco correndo na água
Uma garotinha está montando um triciclo de brinquedo em nascentes.	Uma garotinha está brincando em um brinquedo ao ar livre.
Um garoto está correndo uma corrida.	Um garoto corre em uma corrida enquanto os espectadores assistem.
A garota de casaco rosa e jarros rosa está andando através de uma poça.	Uma garota de jaqueta rosa está andando por uma grande poça.
Um cachorro preto andando pela água.	Dois cães negros andando pela neve.
Um cachorro salta da água em direção à costa.	Um cachorro bronzeado pulando pela água em direção à costa.
Um cachorro preto está correndo na neve.	Um cachorro preto está nadando com uma bola na boca da sua boca.
Uma mulher vestida de verde está brincando com seu cachorro marrom.	Um cachorro bronzeado lambe uma mão de menina enquanto deita.
Dois sem -teto ficam do lado de fora com uma placa de papelão.	Dois jovens sem -teto segurando uma placa de papelão.
Uma mulher está sentada na água.	A mulher está patinando no parque.
Um cachorro marrom caia na água.	Um cachorro espirra na água escura.
Uma garota bronzeada de biquíni floral está nadando em águas azuis escuras.	Uma garotinha em uma roupa de banho florida atravessa a areia na praia
Um homem de camisa laranja usando um capacete branco está andando de bicicleta.	O homem usando um capacete azul está montando um polaris.
Um jogador de hóquei parece atentamente para baixo.	Um jogador de hóquei durante um jogo.
Um menino de jaqueta vermelha e chapéu de balck deslizando de joelhos por uma colina nevada	Um menino está montando um trenó vermelho por uma colina nevada.
Um cachorro preto e marrom brinca com um bastão longo.	Um cachorro coloca suas pernas emaranhadas com um graveto.
Um cachorro preto e branco salta para pegar um frisbee laranja.	Um cachorro preto e branco se prepara para pegar um frisbee.
Um menino está em frente a uma festa de casamento rindo.	uma pessoa em pé em um palco em frente a uma multidão sentada
Dois cães marrons se perseguem na neve.	Dois cães marrons estão brincando na neve.
Um cachorro marrom e branco caminha na areia em um bom dia.	Um cachorro preto e branco pula no ar perto de um frisbee vermelho.
Um surfista está andando em uma onda de quebra.	Um surfista está montando uma onda grande.
uma pessoa em um snowmobile.	Uma pessoa em um snowmobile no salto médio.
Um cachorro pequeno atravessa um campo.	Dois cães passam por um campo.
As crianças estão brincando em um trampolim na neve.	Vários filhos e pulando em um trampolim na neve.
O homem está de pé na costa batendo uma bola com uma raquete.	Duas adolescentes estão paradas ao lado da praia ouvindo iPods.
Um cachorro preto está brincando na neve.	Um grande cachorro preto mostra os dentes enquanto corre pela neve.
Isso sobre a foto superior mostra dois homens fazendo uma pausa.	Uma pessoa com boné de natação e óculos respirando.
A mulher andando está usando uma saia e botas.	Uma mulher em uma saia curta e botas.
Um garoto segurando uma grande varinha de espuma acena perto de uma piscina.	Um menino brinca com um brinquedo de macarrão de espuma por uma piscina.
Dois cães marrons correndo juntos na areia	Dois cães marrons estão correndo na areia.
Uma jovem criança loira segurando um avião.	Um jovem garoto loiro segurando um avião de brinquedo.
Dois cães cinzentos correm juntos sobre a grama verde.	Dois cães brincando juntos na grama.
Um cachorro branco com marcas pretas atravessa a neve.	Dois grandes cães pretos atravessam a neve.
Um cachorro preto está perseguindo um frisbee vermelho.	Um poodle preto está correndo na neve.
Uma garota sopra em um dente -de -leão.	Um equipamento loiro com uma camisa rosa está soprando em um dente -de -leão.
Duas garotas com rabos de cavalo passeam um passeio de parque de diversões.	Uma jovem está em um passeio em um parque de diversões.
Um cachorro cavando na areia.	Um cachorro marrom cava na areia.
pessoa em um celular de esqui polaris na neve.	pessoas montando algo na neve.
um cachorro cinza nadando através de um rio com um graveto na boca	cachorro nadando na água carregando bastão
O cachorro está passando pela neve profunda.	Um cachorro que atravessa a neve.
Um cachorro está pulando no ar para pegar um frisbee laranja.	Um cachorro branco pulando no ar para pegar um frisbee vermelho.
Uma mulher de maiô azul está pulando de uma doca em um lago.	Um menino de camisa azul e jeans azul atravessa um playground
Um cachorro marrom pulando de uma doca na água.	Um cachorro bronzeado pula na água.
Dois homens se sentam na calçada em frente às lojas.	Uma mulher de maiô caminha um cachorro na praia.
Um cachorro manchado em preto e branco pula sobre um riacho.	Um cachorro manchado em preto e branco está pulando sobre o pequeno fluxo de água.
Uma mulher em uma fantasia verde está em frente a uma mulher de topless com seios pintados.	Uma pessoa com uma fantasia de penas verdes está se curvando na frente de uma mulher com seios pintados.
Um jogador de basquete segurando uma bola de basquete.	Um jogador de basquete está marcando uma cesta.
Duas crianças estão andando em uma calçada usando mochilas amarelas e vermelhas.	Duas crianças estão andando ao longo de uma rua usando mochilas amarelas.
uma pessoa em uma bicicleta BMX.	um homem de bicicleta no ar
Dois cães correndo pela grama alta.	Dois cães estão correndo por uma área gramada.
Pequeno cachorro branco usando uma trela pulando após uma bola vermelha.	Um cachorro preto e branco retorna um graveto na neve.
Um cachorro preto e branco pulando no ar.	Um cachorro preto e branco pulando sobre um obstáculo.
Um grupo de mulheres vestindo biquínis está jogando bola de vôlei de praia.	Quatro jovens que usam biquínis estão jogando bola de vôlei de praia
um grupo de pessoas do lado de fora de um prédio.	Um grande grupo de pessoas formou uma linha do lado de fora.
Um cachorro com uma vara segue outro cachorro pela água.	Um carro de tração nas quatro rodas está dirigindo pela lama.
Um grupo de quatro crianças dançando em um quintal.	Um grupo de crianças se estende em tapetes coloridos.
Dois cães pretos estão brincando na grama.	Dois cães pretos estão brincando em uma planície gramada.
Um grupo de adolescentes está pulando no ar na praia.	Um grupo de jovens pula no ar enquanto estava na praia.
Um cachorro preto e marrom está mastigando uma vara grande.	Um cachorro preto e branco brincando na areia.
Dois cães estão brincando na neve.	Os cães estão correndo na neve.
Um menino acena em torno de um brilho.	Um garoto está torcendo um brilho no ar.
Uma jovem está mergulhando em uma pilha de folhas marrons no quintal.	Uma garota está pulando em uma pilha de folhas.
Uma mulher vestindo uma jaqueta de sino rosa se inclina contra uma grade.	Uma mulher vestindo um moletom rosa de Tinkerbell se inclina em um trilho com vista para a água.
Dois cães negros brincando na grama.	Dois cães brincam na grama.
Dois cães brancos correndo na grama juntos.	Dois cães correm e brincam com um bastão marrom.
Várias pessoas estão sentadas em torno de um incêndio à noite.	Um grupo de pessoas está de pé e sentado no chão à noite.
Dois meninos estão pulando em uma piscina.	Dois meninos estão no ar pulando em uma piscina incrustada.
Duas raças diferentes de cães marrons e brancos brincam na praia.	Dois cães brincando na areia na praia.
Um homem toca um violão para uma criança doente em um hospital	Um homem está tocando um violão para uma garotinha em um hospital.
Um homem e duas mulheres vestidas com trajes de vampiros	Um homem e duas mulheres vestidas de fantasias.
Dois cães estão carregando os dentes um para o outro.	Dois cães ficam na água e mordem a boca um do outro.
Um cachorro marrom está correndo pelo chão nevado.	Um cachorro acinzentado correndo na neve.
Dois meninos, um vestindo um chapéu, em um playground.	Menino de chapéu bronzeado ri enquanto está sentado perto de equipamentos de playground.
Uma mulher corre ao lado de uma parede de concreto alto.	Uma mulher corre ao lado de uma parede de concreto.
Alguns jogadores de futebol em camisas vermelhas levando outra em uma camisa branca no chão	Três jogadores de futebol do time vermelho enfrentando um jogador do time branco.
Um cachorro está correndo pela neve.	Um cachorro marrom está correndo pelo campo.
Dois cães brincando na neve.	Dois cães brincam na neve.
Os ciclistas estão de pé em um cruzamento.	ciclistas esperando em um cruzamento.
Uma mulher segura um bebê enquanto um homem olha para ele enquanto outro homem segurando uma criança observa.	Uma mulher fica com os braços em uma loja, enquanto outra mulher segura uma câmera.
Um cachorro fofo branco está correndo na neve branca pura.	Um cachorro branco e branco correndo na neve.
Uma mulher segurando um jornal.	Um homem de rolos em uma barra de metal.
Um grupo de homens jogando instrumentos de bronze.	Um grupo de caras joga instrumentos lá fora.
Duas garotas na costa observam pessoas em um peixe de barco.	Dois homens, um em vermelho e um em branco jogando um jogo de basquete.
Um snowboarder pula no ar.	Um snowboarder voa pelo ar.
Um cachorro branco com orelhas vermelhas está correndo na neve.	Um cachorro preto molhado com uma gola vermelha está no rio
Uma menina e um garotinho dão as mãos em um escorregador brilhante.	Uma garotinha em um vestido Paisley atravessa um parque de arenito.
As crianças jogam futebol em um campo.	Três meninos jogando futebol em um campo
Um grupo de homens anda e se apega a cordas.	Um grupo de homens joga um jogo de futebol universitário.
Um garoto passa por um grupo de pessoas com balões em uma corrida.	Um garoto corre em uma corrida enquanto os espectadores assistem.
Um cachorro está pulando pela grama.	um cachorro correndo pela água.
Um homem pula de um telhado para outro.	Um jovem pula de uma varanda para outra.
Uma pessoa negra de preto e vermelho está dormindo em um banco com um guarda -chuva preto aberto.	Um homem sentado tirando uma soneca em um banco de parque com um guarda -chuva aberto, protegendo -o do sol.
Uma criança puxa a outra, sentada em uma carroça vermelha, ao longo da areia.	Um garoto puxa outro garoto vestindo um chapéu bobo em uma carroça de rádio.
Um cachorro preto deita em um gramado gramado coberto de folhas.	Um cachorro preto coloca na grama e olha para a câmera.
Um cachorro deitado em uma almofada verde.	Um cachorro marrom deitado em uma almofada verde.
O cachorro preto e branco atravessa a grama.	Três cães em preto e branco correndo por um campo aquoso.
Um cachorro marrom toca na neve.	Um cachorro marrom brinca com a mangueira.
Um cachorro marrom cheirando a cerca de um touro marrom.	Um cachorro marrom fica por uma cerca onde está uma vaca marrom.
Dois cães pretos estão brincando na grama.	Dois cães pretos e um cachorro branco interagem.
O skatista faz um truque em uma rampa.	O skatista chega ao topo da rampa.
Alguém está espirrando na água iluminada pelo sol no tornozelo.	Uma garota percorrendo a água em um lago.
Um menino está correndo em direção a uma gaivota em uma praia.	Um garoto correndo pela surf em uma praia.
Dois filhotes brincando com um saco plástico.	Dois cães brincando em um quintal.
Uma coruja tem as asas e difundida durante o dia.	O pássaro tem suas asas espalhadas enquanto voa.
Um homem em uma tampa azul está sentado em um banquinho debaixo de uma árvore.	Um cachorro em pé em uma praia com uma bola próxima.
Uma garota de um chapéu de corante tem uma borboleta na mão.	Uma garota de chapéu colorida tem uma criatura estranha descansando na mão dela.
Uma mulher canta em um microfone por um cara tocando um violão.	Uma mulher canta em um microfone com um guitarrista ao fundo.
Três ovelhas pastam no campo gramado com um cachorro andando atrás deles.	Um pequeno grupo de cabras na grama com um cachorro preto e branco no backgroud.
Um ciclista está fazendo sua bicicleta pular entre duas rochas.	Um homem pula sua bicicleta no ar entre duas rochas.
Um homem com barba cinza anda de bicicleta na praia do oceano.	Um cachorro manchado fica nas patas traseiras para pegar uma bola na praia.
Um homem de terno preto está surfando ao longo de uma onda de queda.	Um surfista vestindo um terno molhado preto está montando uma onda branca no oceano.
Uma jovem menina com um chapéu rosa com um prédio amarelo ao fundo.	Uma jovem menina em um vestido rosa com algo na mão dela.
Uma garota de vestido rosa anda de bicicleta ao longo de uma cerca branca.	Uma garota de vestido vermelho anda de bicicleta na frente de uma cerca branca.
Um animal peludo marrom fica atrás de algumas plantas.	uma calça de cachorro em pé na floresta.
Um garoto vestindo uma camisa vermelha corre ao longo de uma praia.	Um garoto vestindo um suéter vermelho corre ao longo de uma praia colorida.
Várias pessoas na multidão, algumas com os braços levantados.	Muitas pessoas têm braços levantados em uma multidão.
Um cachorro marrom e branco está correndo na grama.	Um cachorro marrom e branco correndo loucamente pela grama.
Uma criança em uma camisa vermelha está usando uma prancha preta para espirrar sobre uma onda de praia.	Um homem em um barco a remo está remar através da água azul.
Um cachorro pula sobre uma corrente.	Um cachorro pula por um lance de escada.
O cão bronzeado e branco está correndo no campo.	Os cães marrons e brancos atravessam o campo.
Três meninas estão sentadas na grama.	Dois poodles estão correndo pela neve.
Dois alpinistas de montanha estão no topo de uma montanha olhando em volta.	Dois alpinistas de montanha ficam na cordilheira de uma montanha alta e nevada.
Um cachorro pula na lagoa.	O skatista pula no ar.
Um cachorro marrom corre em direção à câmera em uma trilha de terra com montanhas ao fundo.	Um cachorro marrom corre em direção à câmera por uma trilha rochosa através do pincel com montanhas ao fundo.
Um Golden Retriever pulando de uma varanda de madeira.	Um Golden Retriever está pulando de uma varanda de madeira
uma garota deslizando para baixo de um poste	Uma jovem menina deslizando por um poste preto.
O cachorro está pulando por uma rampa.	Uma menina está pulando na areia.
Três cães estão brincando na neve branca.	Três cães brincam com um Frisbee em um campo de neve.
O cachorro brinca no parque.	O cachorro pula sobre a cerca no parque.
Uma mulher apontando para um gêiseador.	Mulheres apontando para um gêiseador.
Um cachorro está passando por um pouco de água.	Um cachorro preto está correndo pela neve.
Duas adolescentes, uma está sorrindo.	Uma garotinha em uma criança balançando.
Duas garotas luta contra o braço, enquanto outra olha.	Duas garotas lutam com uma terceira garota em uma camisa rosa e óculos relógios.
Uma jovem de uma jaqueta rosa andando por um caminho de cascalho em uma área arborizada.	Uma garotinha em um casaco rosa está andando por uma estrada de terra
Um cachorro passa por uma área muito arborizada.	Um cachorro que atravessa um riacho.
Um skatista moe um trilho.	Um skatista usa uma rampa.
dois pássaros interagindo na grama	Dois cães brincam um com o outro ao ar livre.
Uma mulher segura um bebê gordo com óculos de sol e um chapéu jeans.	Um pequeno bebê usando óculos de sol fica no colo de um adulto.
Quatro cães ficam na neve.	Quatro cães brincando na neve.
Um cachorro preto dormindo em um carro.	Um cachorro preto e marrom dorme no carro.
Um cachorro branco e um cachorro preto e branco estão correndo pela grama.	Uma imagem turva de um cachorro preto e branco que atravessa a grama.
Cães marrons e pretos na neve, mostrando dentes e latindo um para o outro.	Um cachorro preto brigando com um cachorro marrom na neve.
Dois caminhantes ficam no topo de uma montanha nevada.	Dois alpinistas de montanha estão no topo de uma montanha olhando em volta.
Um homem de camisa xadrez bate em uma árvore com um machado.	Um homem em uma camisa xadrez usa uma ferramenta por uma árvore.
Dois cães passam pela grama.	Dois cães marrons passam pela grama.
Dois jovens jogadores de futebol correm para o gol.	Dois jogadores de futebol correm para chutar a bola.
Um homem correndo em uma pista.	uma pista de corrida de homem
Um cachorro amarelo pega um frisbee no ar.	Um cachorro amarelo pega um frisbee vermelho.
duas crianças em um campo de flores vermelhas.	Duas crianças brincam em um campo de flores vermelhas.
Um jovem pula de pedras em um lago.	Um jovem em baús de natação vermelha pulou de uma grande pedra na água.
Um pequeno cachorro preto está na grama.	Um cachorro preto está correndo na grama.
Uma senhora vestida de quimono está olhando para a câmera.	Duas garotas vestidas de preto estão sentadas em uma sala fazendo poses sugestivas na câmera.
O cachorro preto e branco está correndo pelo oceano.	O cachorro marrom e branco está correndo pela terra da escova.
Um grupo de pessoas está disparando um balão de ar quente.	Um grande grupo de pessoas andando de cavalos marrons e brancos.
Um cachorro preto está correndo pela praia.	Um cachorro está correndo na praia.
Um cachorro preto andando pela água espirrando em um riacho rochoso.	Um cachorro preto espirra através da água esverdeada.
duas meninas tirando uma foto de si mesmas	Duas garotas loiras estão tirando uma foto de si mesmas.
Um cachorro atravessa a água enquanto segura um graveto na boca.	Um cachorro correndo ao longo de uma cerca em uma pista de terra.
As crianças brincam brigando com espadas.	uma criança e um dos pais, um cavalo.
Um homem está navegando pelo vento no oceano.	Um cachorro está correndo pelo oceano.
Um homem está patinando um conjunto de escadas.	O homem está esquiando em uma colina nevada.
Três cães correndo em uma pista de terra	carros correndo em uma pista de terra
Um homem e uma menina pequena flutuando em um Inertube.	Uma jovem menina usando um biquíni em um tubo interno.
Um grupo de cães percorre o campo de neve.	Um cachorro passa por um campo de neve.
Duas mulheres andando pela rua	Um homem andando dois cães por uma rua.
Duas mulheres loiras sentam -se na grama com um cachorro pequeno.	Duas jovens loiras ficam na grama com um cachorro marrom.
Duas pessoas de mãos dadas e andando em um campo.	Dois homens passando por um mural de um carro.
O esquiador está fazendo uma virada através de algumas árvores	pessoa em esquis de cabeça para baixo presa entre duas árvores
O cachorro preto está correndo pela grama.	Um cachorro preto que atravessa a água.
Um cachorro marrom persegue um frisbee	Um cachorro marrom se agacha na grama.
Um cachorro toca na água.	Um cachorro toca na neve.
Uma senhora com uma roupa amarela está no ar acima da cama em uma sala amarela.	Um cachorro com uma trela vermelho ainda prende as perseguições sobre a grama em direção a uma bola de tênis.
Uma pessoa está escalando uma montanha nevada.	A pessoa está nas montanhas nevadas.
Uma garotinha em um vestido colorido está brincando com uma bola de futebol azul e vermelha.	Menina de vestido azul pisando sobre uma bola de futebol.
Mulher em macacão vermelho em pé na calçada.	Uma mulher de macacão vermelha fica na calçada.
Um cachorro está passando por um quintal cheio de folhas.	Três cães passam por um campo.
Um homem em uma camisa despachada fica ao lado de uma grande tigela de madeira.	Um homem mais velho está ao lado de uma exibição de bandejas de madeira.
Dois filhotes brincando na grama	Dois filhotes tocam na grama
Um jogador de futebol chuta a bola.	Um jogador de futebol de Oklahoma tenta chutar a bola.
Um cachorro de cor clara atravessa a grama.	Um cachorro atravessa a grama.
Dois cães pretos e brancos estão brincando juntos lá fora.	Dois filhos e um cachorro preto estão brincando na neve.
Três cães correndo pela água.	Um cachorro preto que atravessa a água.
Dog marrom pulando sobre um bar em um campo gramado.	Dog marrom pulando sobre um obstáculo.
Uma mulher senta -se sozinha contra uma parede de tijolos	Uma mulher está andando com uma bolsa vermelha.
O carro de corrida em preto e branco está passando rapidamente pela pista enquanto os fãs assistem nas proximidades.	Um carro de rali em preto e branco dá a curva.
Um garoto usando sapatos vermelhos está subindo em uma árvore.	Uma criança usando sapatos vermelhos escalando uma árvore.
Um esquiador está pulando no ar em um campo de neve perto de uma cordilheira.	Uma mulher está sentada perto de um leito de flores com vista para um túnel.
A equipe esportiva posa em campo com a multidão em segundo plano.	Uma equipe esportiva posa em campo.
Essas crianças estão brincando em um trampolim ao ar livre.	Quatro crianças estão brincando em um trampolim.
Um cachorro marrom carregando um graveto na boca.	Um cachorro nadando com um graveto na boca.
Uma jovem se inclina sobre o prato em uma refeição.	Uma jovem, de topless, exceto por tinta ou lama.
Os cães estão brincando na neve.	Dois cães brincando na costa.
Um garoto em troncos de natação vermelha está pulando em uma piscina.	Um cachorro está sendo esguichado com uma mangueira enquanto pula em uma piscina de remar.
Uma pessoa sobe uma colina nevada enquanto seu cachorro segue.	Uma pessoa sobe uma colina nevada enquanto um cachorro preto segue.
Um cachorro marrom fica na praia.	um cachorro correndo na praia
Um homem que está descansando a cabeça na mão.	Uma mulher descansando o rosto na mão.
um cachorro em um carro.	Um cachorro preto e marrom dorme no carro.
Um cachorro preto e branco está correndo na praia.	Um cachorro branco está correndo na areia.
mergulhador de mergulho submerso em água.	O mergulhador está debaixo d'água.
O homem está andando de bicicleta por uma colina de terra.	Um truque de ciclista tritura um corrimão.
Um grande cachorro cinza está brincando na neve profunda.	Quatro cães brincando na neve.
Um homem andando de bicicleta na praia ao lado do oceano.	Um homem andando sua vaca na lateral da estrada.
Dois cães estão correndo na grama em frente às árvores.	Um cachorro marrom está correndo na grama em frente a algumas árvores.
um cachorro em um carro.	Um cachorro está mordendo um esfregão.
Um cachorro marrom está atravessando a grama com um graveto na boca da sua boca.	Um grande cachorro bronzeado corre na grama com um grande graveto na boca.
criança segurando um objeto que está pegando fogo.	Uma criança em rosa segura um objeto que parece estar pegando fogo.
Um cachorro com orelhas frouxas caminhando em direção à câmera na floresta.	Uma criança em frente ao seu próprio reflexo se voltando para a câmera e sorrindo.
Dois cães bronzeados brincam na grama	Um cachorro magro brincando em grama alta.
Um cachorro marrom está espirrando água em todos os lugares sacudindo a água de si mesma.	Um cachorro branco está parado ao lado de um rio senando -se seco.
um garoto escalando em uma parede de pedra	Cinco galgos estão correndo em uma pista de areia.
Um policial dirige o tráfego em uma rua da cidade.	Um homem caminha em direção a um policial em pé em uma faixa de pedestres em uma rua da cidade.
Um cachorro preto e branco atravessa a grama.	Cachorro marrom e branco correndo por um campo gramado.
menina pulando em poça de água	Uma garota pulando em uma poça.
O cachorro preto e branco está correndo na grama.	um menino e um cachorro correndo na grama
Um cachorro preto e branco está correndo na praia.	O cachorro preto e marrom está correndo pela neve.
Cão branco lá fora, com duas pessoas em segundo plano.	Little menino vindo na câmera descendo o slide azul, sorrindo mulher em fundo.
Um homem de casaco vermelho e chapéu fala com outro homem em vermelho.	Um homem vestindo um casaco vermelho com vidro olha para outro homem.
Muitos pessoas do Oriente Médio estão sentadas na parte de trás de um caminhão azul.	Um grupo de pessoas está andando na parte de trás de um caminhão.
pessoa com dois postes de esqui esqui em uma colina nevada.	Uma pessoa esquia em uma colina nevada.
Uma mulher está comendo peixe em um restaurante.	Uma mulher comendo um peixe grande em um restaurante.
Uma criança e dois cães brincam na água.	Uma criança em carros alegóricos vermelhos e azuis olhando para a água.
Um skatista fazendo um truque em uma parede de pedra.	Um skatista subindo até uma ladeira.
Uma criança em um terno bege está sorrindo enquanto brinca na neve.	Uma menina de neve de neve.
As pessoas estão de pé em uma escada rolante subindo.	As pessoas subem uma escada rolante.
Uma mulher em um vestido levanta o braço sobre a cabeça.	Uma mulher olhando para cima com a mão acima da cabeça.
Três meninas estão sentadas na grama.	Três crianças estão sentadas na grama.
O cachorro branco e marrom está andando por águas rasas.	Um cachorro branco e marrom parece estar andando na água.
Uma senhora está passando seu cachorro através de um curso de agilidade.	treinador dirige seu cachorro através do curso de treinamento com tubo verde
O cachorro branco e marrom está sacudindo as orelhas.	O cachorro marrom está correndo pela areia.
Uma multidão de homens vestindo números de papel em suas camisas correm em uma corrida.	Pessoas com números no peito estão correndo em um pacote.
Um skatista pula das escadas.	Um cachorro pula da escada.
Duas pessoas vestindo preto estão em frente a uma estátua iluminada.	Duas pessoas estão olhando para uma luz leve à noite.
Um grupo de pessoas fica em frente a um prédio amarelo.	uma jovem de pé na frente de uma fonte
Dois cães estão brincando na neve.	Dois cães estão brincando em uma piscina.
Algumas crianças estão levantando as mãos e batendo palmas.	Três crianças estão jogando futebol na areia.
Um skatista deslizando por um trilho de escada.	Um skatista dando um salto em trilhos de trem.
Dois cães brincam na neve.	Dois cães lutam na neve.
Uma garotinha está apenas chegando ao fundo de um slide de playground	Uma garotinha acaba no fundo do slide.
Um homem soprando uma grande bolha.	Um homem andando um grande cavalo preto.
Um cachorro marrom balançando a cabeça.	Um cachorro marrom usando uma corrente em volta do pescoço está balançando a cabeça.
Duas pessoas sentam -se em uma doca perto da água.	Duas pessoas sentam -se no final de uma doca no meio da água parada.
Duas meninas se sentam à mesa ao ar livre e dão seu pedido ao garçom.	Duas jovens mulheres sentadas em um resaunte ao ar livre olhando para os menus prestes a fazer seu pedido com o garçom em pé à sua mesa.
Dois cães correndo juntos e um tem um brinquedo de pato na boca.	Um cachorro preto e branco andando pela grama com um bastão longo na boca.
O cachorro preto e branco está correndo na grama.	Um cachorro preto e branco nada em água azul.
O guardadouro de hóquei está deitado no gelo em frente à rede.	Um jogador de hóquei está deitado no gelo em frente ao gol.
Cão preto e branco ao ar livre em água enlameada, com palito na boca.	Um cachorro preto e branco está correndo pela água enquanto carrega os dentes.
Um esquiador usando calças de neve azul está voando pelo ar perto de um salto.	Um esquiador fica nas mãos na neve em frente a uma câmera de filme.
Um cachorro preto e branco está correndo na praia.	O cachorro preto e branco está correndo na areia úmida.
O cachorro marrom está percorrendo um caminho gramado.	Um cachorro marrom está correndo ao longo de um trecho gramado dividido por cordas.
A garota está vestindo uma camisa listrada azul e os rolos.	Um homem vestindo uma camisa preta e branca pulando em um cachorro de volta
Um homem tatuado de preto tocando um violão branco e cantando.	Uma mulher em um casaco preto e branco e protetores de ouvido.
Um cachorro correndo pela praia.	Menino e menina correndo pela praia.
Um cachorro preto com uma gola vermelha sentada na areia.	Um cachorro preto e branco está mordendo um graveto na água.
criança pendurada de cabeça para baixo de um balanço da árvore	Uma garota é de uma árvore pendurada de cabeça para baixo de um balanço.
Um jovem e uma mulher sentados em um banco do lado de fora estão se beijando.	O homem e a mulher sentados em um banco estão se beijando.
Um cachorro marrom está pulando para pegar uma alça verde na boca de sua.	Um cachorro cinza pula para morder uma trela verde.
Dois jovens túnicos de preto estão nos degraus em frente a um prédio.	Dois padres ortodoxos estão nos degraus fora de uma igreja.
Um cachorro preto está correndo na grama.	Um cachorro preto e um marrom correndo na grama.
Dois cães cinzentos passam por um campo de urze rosa.	Dois cães amarrados sobre uma colina coberta de flores.
Um grupo de adultos senta -se em cadeiras de gramado de madeira conversando, cercado por deserto.	Grupo de pessoas sentadas em espreguiçadeiras no pátio, olhando para as montanhas.
Um cachorro revestido encaracolado olhando para outro cachorro na água.	Um cachorro de lã na praia olha para outro cachorro na água.
Um garoto que joga hóquei está no gelo, ferido.	Dois times de futebol estão jogando, um está em branco e outro em vermelho.
Dois cães pretos estão brincando com um brinquedo de cachorro de pelúcia laranja.	Dois cães pretos estão brincando de cabo de guerra com um brinquedo laranja.
Dois cães marrons usando colarinhos brigando.	O cachorro marrom está usando uma gola preta.
Uma mulher está sentada na calçada com um telefone celular na orelha.	Uma mulher está andando de bicicleta.
Três cães brincam em um campo gramado.	Algumas crianças brincam em um campo.
Um pequeno cachorro branco sobe sobre um tronco.	Um cachorro pequeno entra em um tronco.
Um garoto joga em um poço de bola vermelha.	Um garoto risonho deita em um poço de bolas azuis.
Um cachorro magro passa pela grama verde.	Um cachorro marrom e dois cães pretos em um campo gramado coberto de vegetação.
Dois meninos brincando na água.	Meninos desfrutando de um spray de água.
um surfista em uma onda.	Um surfista está montando uma onda.
Dois cães correndo pela grama alta.	Três cães correndo pela neve.
Um cachorro preto atravessa a neve.	Um cachorro preto está correndo pelo campo.
Os cães brincam na neve nas patas traseiras.	Dois cães brincam na neve.
Uma garotinha e seu macaco empalhado sentados em um passeio acima do recinto de feiras.	Garota e um grande animal de pelúcia andando de um passeio de diversão sobre uma feira.
Dois cães estão brigando por um frisbee vermelho lá fora.	Dois cães estão brigando por um frisbee vermelho que é dobrado ao meio.
Três cães estão brincando na colina gramada com um céu azul.	Três cães brincam na grama.
Dois meninos brincam com dois cães na costa.	Dois meninos e dois cães estão brincando na areia e na água no litoral.
Um cachorro marrom e branco está pulando sobre um poste amarelo e vermelho.	Um cachorro marrom e branco está pulando sobre um obstáculo
Três meninos tomam banho em uma lixeira na grama.	Três crianças bem vestidas estão sentadas em um banco e sorrindo.
O skatista chega ao topo da rampa.	O skatista monta a parede do tubo em um parque de skatista.
um grupo de crianças brincando com adereços	um grupo de crianças brincando com um cachorro
Um cachorro marrom correndo após uma bola vermelha.	Um cachorro marrom está correndo ao longo de uma praia.
Três mulheres vestidas de verde e shamrocks.	Três mulheres vestindo bastante verde e shamrocks.
Uma garota de jaqueta rosa está andando por uma grande poça.	Um garoto está espirrando através de uma poça de água.
dois homens em um concurso de corrida.	Cães em uma corrida.
Um cachorro nadando em um lago tem sol brilhando nele.	Um cachorro nada enquanto carrega um graveto na boca.
um menino skates na grade de algumas escadas de grafite	Um skatista desliza por um corrimão nos pés.
Um alpinista da montanha segue a beira da montanha.	Um esquiador prestes a descer a montanha.
Dois cães estão correndo um para o outro através da areia.	Dois cães estão correndo um para o outro em uma praia.
Um skatista no meio do ar com seu skate.	adolescente moendo um banco em um skate
Um cachorro preto e branco atravessa a água.	Dog preto e marrom passa pelo campo.
Duas crianças estão andando em um caminho na floresta.	Duas crianças andando pelo caminho na floresta.
Um homem fica sentado em um cavalo com montanhas ao fundo.	Um homem montando um cavalo marrom posa em frente a uma cena montanhosa.
Um motociclista pula um obstáculo.	Um repensão dourado salta sobre um obstáculo.
Um cachorro marrom e branco está correndo na grama.	O cachorro bronzeado e preto está correndo pela grama.
Uma mulher corre na praia.	Um cachorro atravessa o país.
Uma garota dança em um palco.	Uma garota dança em uma calçada.
Dois cães correm lado a lado na grama.	Dois cães correndo na grama.
Uma criança empurra outra em um balanço em um playground.	Um menino está empurrando outro garoto nos balanços.
Dois cães estão fazendo xixi em um hidrante vermelho.	Dois cães estão urinando no hidrante vermelho.
Uma mulher está voando pelo ar e aterrissando em uma cama.	Um cisne está voando através de um corpo de água.
Duas crianças andam de pires em uma colina nevada.	Duas crianças vão trenó.
pessoa segurando sinais de parada para o tráfego direto.	uma pessoa de pé em uma cordilheira no deserto.
Um cachorro marrom mordendo a perna de um cavalo.	Um cachorro beliscou na perna de um cavalo.
Um homem de homem sem camisa sobe.	um homem escalada em rochas.
um grupo de cães brincando	um grupo de cães correndo.
Um jogador de rugby em Dark Gear está carregando uma bola de rugby de cor clara com o braço estendido.	Um cachorro marrom espirra na água enquanto carrega uma bola na boca da sua boca.
cachorro correndo na praia ao lado de dois gansos na água	Um cachorro preto correndo ao longo da costa arenosa de um corpo de água, enquanto dois patos nadam nas proximidades.
Um cachorro pequeno passa por um campo gramado.	Dois cães amarrados na grama.
Um cachorro de cor dourada pula na grama enquanto segura um graveto na boca.	Um cachorro preto está atravessando a grama carregando algo vermelho na boca.
Um apanhador infantil estendendo a mão para pegar uma bola.	Um apanhador de meninos em um capacete, esticando a mão enluvada para uma captura.
Há um garoto usando jeans e um boné de beisebol pulando no ar.	Um garoto, vestindo um boné de beisebol, pula no ar perto de alguns degraus.
Dois cães bege estão brincando na neve.	Três cães estão na neve.
Duas pessoas estão andando por um pouco de água.	Duas meninas estão andando por uma árvore em frente a um prédio de tijolos.
Uma garota pula corda em um estacionamento.	Uma garotinha nadando em uma piscina.
Uma garota está correndo em um caminho do deserto.	Uma jovem está falando em um telefone celular.
Dois cães marrons e pretos atravessam a grama seca.	Um cachorro marrom passa pela grama.
um grupo de esquiadores subindo uma montanha	Quatro esquiadores escalam a montanha dramatizada de neve.
Um cachorro marrom deitado em um lençol azul.	Um cachorro marrom deitado em uma tampa azul.
Um cachorro branco está brincando com uma bola na praia.	Um cachorro preto e branco está brincando com um cachorro marrom.
Um cachorro parado perto da neve olhando para a água.	Um cachorro bronzeado em pé na neve olhando para a floresta.
Um cachorro espirrando na água.	Um cachorro espirra na água escura.
Um cachorro preto, marrom e branco correndo junto com uma frisbee branca na boca.	Um cachorro preto e branco carrega um frisbee branco sobre a grama.
Uma jovem garota cavalga em um cavalo através de uma trilha.	Uma garotinha está montando um cavalo na floresta.
Um homem dirige um barco azul pelas casas de cores vivas.	Um homem dirigindo um barco azul passa por algumas casas coloridas.
Um grupo de pessoas está andando pela calçada de uma cidade grande.	Um grupo de pessoas está andando na parte de trás de um caminhão.
Um cachorro caminha pelas folhas com um grande graveto na boca.	Um cachorro atravessa a floresta com algo na boca.
Um cachorro branco e marrom está deitado em uma jaqueta vermelha com um roedor em pé.	Um cachorro marrom fica de costas na grama, segurando uma bola na boca.
O cachorro está no ar acima da grama.	O cachorro está deitado em uma cama com um lençol azul.
Mulher de vestido preto com acessórios vermelhos está andando pela rua.	Mulher em um vestido preto andando na rua.
O garoto joga bola na praia.	Um cachorro brinca na praia.
Um cachorro preto está passando por um pouco de água.	Um homem de uniforme de futebol está correndo com uma bola de futebol durante um jogo.
A menina fica no metrô esperando algo.	Uma garota fica em uma área mal iluminada.
Dois cães se aproximam da grama.	Dois cães se enfrentam na grama.
O homem está sentado com uma garotinha no parque.	O homem está brincando com o cachorrinho desgrenhado.
Um cão bronzeado grande está correndo com um item verde na boca	O cachorro bronzeado está carregando um brinquedo verde na boca.
Cão branco e marrom com boca aberta correndo na grama.	Um cachorro branco com manchas de marrom e preto nos olhos está correndo pela grama verde.
Um homem faz malabarismos na praia.	Um homem em troncos de natação está fazendo malabarismos na praia
Um grupo de pessoas em barcos correndo em direção à costa.	Uma sala de aula de estudantes assistindo a uma apresentação.
Uma pessoa está montando um skate no ar acima de uma rampa.	Um motociclista está andando ao longo de um elemento de pista localizado com uma área arborizada.
Uma criança empurra outra criança em um balanço.	O garoto está empurrando uma garota em um balanço do lado de fora.
Um menino skates no loda de metal à noite.	Um cachorro marrom corre na areia, segurando um graveto.
A multidão se reuniu em ruas agitando bandeiras de cores vivas.	Uma multidão de pessoas está reunida na rua agitando bandeiras irlandesas.
Uma pessoa está espremendo uma abertura na face da rocha.	Um cachorro marrom de tamanho médio está correndo através de uma área arborizada branca aberta.
Homem em bicicleta verde realizando um truque em uma roda.	O homem está fazendo um truque em sua bicicleta verde.
cachorro correndo em direção à câmera com uma bola na boca.	O cachorro preto e branco nada com um objeto marrom em sua boca.
Uma jovem que corre na praia.	Uma garotinha correndo na costa de uma praia.
Um jogador de beisebol joga a bola.	O jogador de basquete segura a bola.
Um cachorro branco corre para um lago.	Um cachorro branco pula em uma piscina.
Dois cães estão brincando em um campo.	Dois cães estão se perseguindo em um quintal.
Um homem está balançando em uma corda sobre a água.	Um homem em um maiô marrom oscila em uma corda em um lago.
Uma mulher usando óculos de sol grandes segura jornais nas duas mãos.	Uma mulher gorda usando tampo azul fraco está soprando bolha de sabão.
Um homem fazendo um truque em um skate.	Um homem no ar em um skate.
Uma jovem de óculos de natação faz o golpe de costas em uma piscina.	Uma garota faz o golpe nas costas na piscina.
Um cervo pula uma cerca.	Um cervo está pulando sobre uma cerca.
Uma jovem menina vestida com uma roupa de Minnie Mouse e uma mulher mais velha andando pela calçada.	Um homem vestindo um terno branco segurando um jornal andando pelas ruas.
Um cachorro corre pela água.	Um cachorro pula pela água.