Que tal alguns testemunhos de especialistas em saúde reais?	Além disso, quem é dizer que não há testemunhos de especialistas em saúde "reais" lá?
"Então o capitão se foi.	Então o capitão voltou.
O problema é mais simples que isso.	O problema é simples.
Requisitos de reconhecimento negativo.	Requisitos do Pacífico.
Então, estou caindo, por enquanto, fazendo a pergunta: "Onde está o Marx"?	Estou seguindo em frente a fazer a pergunta: "Onde está a carne"?
Vá imaginar que você está me pedindo para provar um negativo?	Você está me pedindo para provar um negativo?
Estou bem com uso médico!	Estou bem com uso médico! !
Os preços de tudo o que você precisa aumentaram devido à inflação.	Os preços de tudo o que você possui, o IE, os ativos caíram.
Guerra no Oriente Médio.	Uma guerra no Oriente Médio.
Postado originalmente por Viena, como foi autoritário?	Postado originalmente por Zaf, eu desisto.
Imagine um lugar que é % branco e % preto.	Imagine um lugar com % de homens e % mulheres.
Não há chance de um julgamento justo.	Não há chance de um julgamento justo.
Nirvana é muito diferente do esquecimento.	Nirvana não é esquecimento.
Nós, na Grã -Bretanha, pensamos de maneira diferente para os americanos.	Postado originalmente por Zaf, na Grã -Bretanha, pensamos de maneira diferente para os americanos.
Se você responder sim e não para você provavelmente é reto.	Se você responder não, mas sim, então você provavelmente será reto.
Toda a Terra combinada produz comida suficiente para bilhões de pessoas.	Quem agora produz apenas bilhões o suficiente?
BTW, ele tinha adiamentos adequados para o tempo.	adiamentos apropriados para o tempo, hein?
Ei, olhos azuis, como são as coisas em Londres?	* * Smooches correu * * Ei, olhos azuis, como são as coisas em Londres?
Mas nas transmissões de notícias que vi elas o chamavam de branco.	Mas parece que teria menos "impacto" se eles não o chamassem de branco.
De acordo com a namorada e Zimmerman, ele fez.	De acordo com Zimmerman, ele fez.
Meus pais me disseram que é ruim para você.	Meus professores me disseram que é ruim para você.
.Nazi é um termo de gíria para o NSWP.	Postado originalmente por Odins Eye .Nazi é um termo de gíria para o NSWP.
Eu me oponho à pena de morte.	É por isso que apoio a pena de morte.
Bem, seja o que for, você está agora.	Bem, seja o que for, você está ciente disso agora.
Eles não produzem nada que eu possa comer, usar, viver.	Pense em todas as coisas que você pode "comer, usar ou viver".
Dickshot Matt Holliday possui.	Matt Holliday é dono, tudo.
As pessoas exploraram as leis.	As pessoas dobraram as leis.
Engraçado, eu pensei a mesma coisa sobre alguma matemática.	E aqui eu pensei que me conhecia um pouco de matemática.
Tenho anos de direitos de "Neener Neener" que também uso alface.	Eu tenho anos de direitos "Neener Neener" Hi Wiggies!
Eu não prefixo ou sufoco tudo com "Você odeia judeus".	Você deve parar de prefixar ou sufixar tudo com você odeia judeus.
Eu perguntei a ela se ela está pronta para uma árvore.	Eu pelo menos perguntei se um trio estava fora de questão.
Ainda não faz sentido.	É você que não faz sentido.
casas mais caras.	carros mais caros.
Martin disse: "Por que você está me seguindo?"	Zimmerman respondeu: "O que você está fazendo aqui?"
Embora as estimativas de intensidade do satélite do TAFB e SAB sejam apenas t. /	As estimativas subjetivas de intensidade do DVORAK do TAFB e SAB aumentaram para KT.
"Fadas não existem" - tudo bem.	"Sátiros não existem" - tudo bem.
Você quer saber o que eu acho curioso?	É isso que acho curioso.
Quando comparei o Homo sexuaity com um distúrbio do desenvolvimento?	Comparei o Homo fobia com um distúrbio de desenvolvimento.
Se você perguntou, conservadores, os números serão distorcidos para a direita.	Se você perguntasse, os progressistas, os números seriam distorcidos para a esquerda.
Você não mencionou o PFA antes daquele post.	Eu também não mencionei a ordem de restrição.
Ramblin 'Rose by Nat King Cole, somos todos navios cheios de muitas maravilhas.	Olhos do tigre, somos todos navios cheios de muitas maravilhas.
do ano anterior.	aquecido.c do ano anterior.
Ainda amo esse show.	Holy Poo Poo, este show.
Suas vastas propriedades são protegidas pelo governo.	Sua grande riqueza é protegida pelo governo.
Diferença do fundo, por favor?	diferença fundamental?
Como exatamente a Alemanha está sendo 'punida' pela estupidez da WW?	Como exatamente eles estão sendo punidos?
Z o perseguiu e depois atirou nele.	Você afirmou que Zimmerman "o perseguiu e depois atirou nele".
Não estou indignado, estou decepcionado.	Deus abençoe que não fico indignado, estou decepcionado.
Nós nunca saímos disso em primeiro lugar!	De onde vem o dinheiro em primeiro lugar?
A liberdade de expressão tem consequências!	Se a liberdade de expressão tem consequências, não é livre.
Meus pais me disseram que é ruim para você.	Meus professores me disseram que é ruim para você.
Se você pudesse matar uma pessoa para salvar quatro, não é?	Quanto a matar a pessoa para salvar, não tenho idéia.
Não é imponente moral.	Está impondo uma lei.
Depende de como você define extremo.	Depende de como você define "extremo".
Pelo menos o México estava presente na Califórnia.	O México tem zero reivindicação para a Califórnia.
Então, sim, lemos a Bíblia para aprender sobre o cristianismo.	Pessoalmente, eu lia a Bíblia para aprender sobre o cristianismo.
Ah ha, ha, ha, ha, ha!	ha, ha, ha, ha, ha, ha!
E é por isso que você está gritando comigo e se recusando a responder minhas perguntas?	Ainda se recusando a responder minhas perguntas?
Você tem muita regulamentação, não muito pouco.	Você tem muita intervenção em mercados livres, não muito pouco.
O elemento humano que você poderia assinar Lance Berkman no final do ano, eu acho?	Você poderia assinar Lance Berkman no final do ano, eu acho?
Por que o livro de Thomas foi deixado de fora do cânone?	Por que a adição de mais palavras de Jesus seria deixada de fora do cânone?
Você quer dizer, você acredita na palavra da grande mídia?	Você quer dizer, você acredita na palavra do SpringhallConvert?
Devemos explorar.	Nós devemos nos mover.
Israel não dá um * * * *, aceite.	O que Israel não é giva a * * * * o que alguém mais pensa.
Somos todos navios cheios de muitas maravilhas.	Eu quero rock and roll by Kiss, somos todos navios cheios de muitas maravilhas.
Slutstamp! Um querido amigo de Ohio me enviou isso.	Um querido amigo de Ohio me enviou isso.
E, no entanto, a história do Titanic é aquela que se levanta ao escrutínio das evidências.	O novo estudo mostra que a história do Titanic não enfrenta um exame minucioso da IMO.
Ele pode realmente fazer o Mone do Google AD Sense.	Quem ganha dinheiro com o Google AD Sense?
Eles sabem que o vídeo não mostra uma câmara de gás.	A linha inferior é que o videoclipe não mostra uma câmara de gás.
Quente, talvez grava.	Mais quente, quase certamente um recorde.
"Bright, mas Scatterbrain" se torna "Treat With Droks".	"Opinacionado e teimoso" se tornam tratados com drogas ".
Qual é a sua definição de "vida"?	Qual é a sua definição de natureza?
Pode ser muitas coisas.	Pode ser um erro simples.
Sem extorsão, sem suborno, sem dinheiro envolvido, ele está pedindo dinheiro para seu voto.	Sem extorsão, sem suborno, nenhum dinheiro envolveu apenas crimes de classe E.
dr. A versão revisada de Neander.	A versão revisada de Neander "?
Devo apenas dizer a ela como me sinto?	Devo apenas esperar e ver como vai?
eu. Requisitos atlânticos.	Requisitos do Pacífico.
Você não tem restos de míssil no Pentágono.	Você não tem testemunhas de um míssil no Pentágono.
"Jane" quer que eu peça ao hóspede da festa útil que pague por isso.	Eu não posso acreditar que ela está pedindo que você peça dinheiro para o hóspede da festa útil!
Qualquer mulher que queira controle de natalidade pode obtê -lo.	Qualquer mulher que queira e o aborto pode conseguir um.
É legal crescer?	Sim, é legal crescer.
Pressionar um não "faz" inglês.	Pressionar um envia um tom.
Qual é a minha opinião sobre a série?	Qual era a minha opinião de Firefly nesse meio tempo?
Somos todos navios cheios de muitas maravilhas.	Chuck perto, somos todos navios cheios de muitas maravilhas.
Ele tem apoiadores?	Ele definitivamente tem apoiadores.
Mas tudo bem, Ultimate Sovereignty?	Assim, a soberania final.
Isso não é uma resposta.	Não, não é uma resposta.
Os nazistas aumentam a longevidade de uma permissão de arma de fogo de anos.	Os nazistas baixaram a idade mínima para comprar uma arma de fogo para.
Mas não podemos fazer isso sem ajuda.	Não podemos fazer isso sem você. "
Nenhuma pessoa saudável precisa de jogos.	Nenhuma pessoa saudável precisa de sexo.
Eu disse que não era uma pessoa, no sentido legal.	Se não é uma pessoa, então é?
Você vê Obama pedindo reforma da regulamentação?	Você vê Obama pedindo corte, limite e equilíbrio?
"Os duendes não existem" - tudo bem.	"Os elfos não existem" - tudo bem.
Peguei alguns Heine e Coors Light, eu comecei ontem à noite Xanis.	Comecei ontem à noite Xanis.
O Irã também é um assinado do TNP e da AIEA.	Tenho que amar o EK factoid de que "o Irã também é um assinado do TNP e da AIEA.
"Gorgons não existem" - tudo bem.	"Sátiros não existem" - tudo bem.
A melhor maneira de obter dinheiro é se livrar do saguão, tudo isso.	A melhor maneira de transformá -lo de cabeça para obter dinheiro.
Eu tenho anos de direitos de "Neener Neener" geralmente tenho cuidado bastante decente.	Tenho anos de direitos de "Neener Neener" que são rachaduras.
Alguém já ouviu falar de holandês?	@ Nickfun, alguém ouviu falar de holandês?
Commodity expandiu a forma de valor ,.	Formulário de valor do capital de commodities elementar.
Você é um cristão.	Portanto, você não é cristão.
E o simples fato hoje?	Repito: e o simples fato hoje?
A moral não tem absolutamente nada a ver com isso!	E a moral e a honestidade têm tudo a ver com isso.
"Oh, você é uma pessoa tão boa!	Você é uma pessoa tão ruim! "
Fern, acho que histórias como essa são estúpidas.	- Lobo, acho que histórias como essa são estúpidas.
A formação de ciclone não é esperada durante as próximas horas.	A formação de ciclones tropicais não é esperada.
Você não entende o que significa essa sequência de palavras?	Você não entende o que a palavra 'LED' implica?
Não há liberdade de religião.	Não há liberdade de expressão.
Postado originalmente por Solinvictus, o Messhe de todas as escrituras é unidade.	Postado originalmente por Solinvictus AH.
Quanto tempo depois da obliteração o garoto deve retornar à escola?	Quanto tempo depois da obliteração não deve mais incomodar o garoto?
Um homem e uma mulher são diferentes sim.	Homens e mulheres são diferentes sim?
O duplo risco realmente aplica uma anulação do júri.	No que diz respeito à legalidade, posso usar a anulação do júri.
Facilitador: Mostre -me a criança inteligente.	Facilitador: E por que ela é a criança idiota?
A ficção religiosa não é tão redundante e repetitiva?	Não é tão redundante e repetitivo?
Postado originalmente por Anabelle o que há de errado nisso?	Postado originalmente por Viena para 'dizer' o que?
Cracklin 'Rosie, de Neil Diamond, somos todos navios cheios de muitas maravilhas.	Jingle Bell Rock, de Bobby Helm, somos todos navios cheios de muitas maravilhas.
Algumas pessoas têm total confiança nas pessoas que administram essas instituições.	Outras pessoas não confiam em pessoas que administram essas instituições.
A mudança frouxa começou como uma obra de ficção.	Terminou como uma obra de ficção.
Se não fosse uma vida, não seria capaz de nascer.	Se não estivesse vivo, então seria um aborto por conta própria.
Gl, terral que é absolutamente incrível.	Oi Ollie: Isso é absolutamente incrível.
Vamos supor que tenhamos % branco e % preto.	Imagine um lugar que é % branco e % preto.
A liberdade de expressão tem consequências!	Se a liberdade de expressão tem consequências, não é livre.
"Fadas não existem" - tudo bem.	"Os duendes não existem" - tudo bem.
Nesse caso, afirme é por isso que eles não são verdadeiros.	Por favor, e eles não são verdadeiros.
-Not- Falando sobre isso 'e' -Not- Fazendo qualquer coisa.	é ainda pior do que falar sobre isso e não fazer nada.
"Ser contra Nukes" não significa "não querer usar armas nucleares".	"Ser contra o uso de armas nucleares" significa "não querer usar nukes".
Minha sobrinha é casada com um homem negro.	Minha grande sobrinha é meio preta.
A população do Reino Unido é de pouco mais de milhões.	A população japonesa é de quase milhões.
Eu atirei no xerife que somos todos navios cheios de muitas maravilhas.	Somos todos navios cheios de muitas maravilhas.
Espero que isso não seja nada.	Espero que esteja tudo bem!
O dinheiro que gastei adotando Velociraptor.	Esses podem ser o meu topo. O dinheiro que gastei adotando Velociraptor.
Então, você realmente acredita que cada palavra do que Terral escreveu?	GL, Terral Hi Corn: Então, você realmente acredita em cada palavra do que Terral escreveu?
O que não é como o que foi vendido?	Não é como foi vendido, GB.
Eu sei que odeio ser ele.	Eu odeio ser ele também.
Não havia armas.	Claro que não havia armas.
É tão estúpido que só tem que ser verdade.	É divertido pensar que pode ser verdade.
Responsabilidade pessoal muito?	Novamente, responsabilidade pessoal.
Você percebe as coisas sem sentido que você está dizendo?	E para ser justo, você percebe as coisas sem sentido que está dizendo?
Acho que puxei para fora da extremidade traseira do censo em uma cartola.	O censo tem uma traseira em uma cartola?
Como isso é inclinado contra Bush? ?	Onde está a inclinação contra Bush?
Se não fosse uma besteira, não seria homeopatia.	É a lógica simples, se não fosse uma besteira, não seria homeopatia.
Eu nunca o acusei de miligramas, nada.	Eu nunca o acusei de médico um beisebol.
O resgate era maior que o Tarp Bloomberg News.	O resgate era maior do que o TARP, este título é enganoso.
Meus pais me disseram que é ruim para você.	Os policiais me disseram que é ruim para você.
Sua posição é que é o risco do indivíduo assumir.	Sua posição é a maneira como é atualmente.
eu. Requisitos atlânticos.	Requisitos do Pacífico.
Leia mais: você nunca conheceu alguém que seja pró-aborto?	Você nunca conheceu alguém que é pró-aborto?
Não tenho nenhum problema com aqueles que têm dinheiro!	Tenho muitos problemas com esses homens, muito para muitos para afirmar aqui!
Nixon, Ford e Carter fecharam os campos de petróleo?	O NÃO foi desligado dos campos de petróleo.
Eu não quero um presidente que 'se importa'.	Eu não quero um presidente que seja charasmático.
Não precisa ser BrainDead.	Eu não tenho um modelo proposto.
nenhuma evidência de mísseis.	Sem testemunhas de mísseis.
Meus professores me disseram que é ruim para você.	Os policiais me disseram que é ruim para você.
Meu Deus, sou o que é o ticker de gravidez.	Eu tenho o ticker de gravidez.
Então ele não é onipotente.	Então ele é malévolo.
chapéu de papel alumínio para o rosto do cachorro, que tamanho você usa?	chapéu de papel alumínio para o sarg, que tamanho você usa?
Como este ano, que foi morto a tiros em um crime relacionado à maconha.	Ou o garoto de um ano morto a tiros com armas automáticas por revendedores de maconha.
Se você pular para dar um golpe, estará recebendo uma penalidade.	Se o seu bastão atingir um cara na cara, você está recebendo uma penalidade.
Toda a energia elétrica vem da bateria.	Toda a energia elétrica vem do alternador.
Você sabe quantos passageiros testemunharam ou o que disseram?	Quantos passageiros disseram que viram um iceberg?
Imagine um lugar com % de homens e % mulheres.	Imagine um lugar que é % branco e % preto.
O cenário A assume que a taxa de crescimento CO se acelera por. % / ano.	Ele assume que a taxa de crescimento do metano acelera por. % / ano.
Na verdade, eles mostraram uma tendência de refrigeração desde o recente declínio.	Obtenha uma tendência de refrigeração por causa do recente declínio.
Somos todos navios cheios de muitas maravilhas.	Landon Memory from Cats Somos todos navios cheios de muitas maravilhas.
para repetir: eles não são tão soberanos quanto antes.	Eles não são tão soberanos quanto antes.
fora de contato e completamente não confiável, no entanto, não seria t.	fora de toque e não confiável?
são principalmente apenas os holandeses.	Na verdade, são apenas os holandeses.
Estamos falando de anjos e pinos comuns novamente, certo?	@ Lustig Andrei, estamos falando de anjos e pinos comuns novamente, certo?
Reivindicações sobre o personagem de Trayvon e quando eu fiz isso?	blogs inclinados e quando eu fiz isso?
% Quanto dinheiro PP recebe para serviços de aborto?	Quanto é gasto em serviços de aborto?
Por que essa transação ocorreu.	A transação ocorreu?
Não há mais pós-fertilização das células do ovo.	Não há mais célula espermática.
Lacey - Bem -vindo de volta!	Enfim, seja bem -vindo de volta.
Mais verificações de fact: eu não sei por que alguém está fazendo um barulho com o $, aposta.	Eu não sei por que alguém está fazendo um barulho com o $, aposta.
Se você não fez alguma reivindicação, basta dizer isso.	Eu não fiz nenhuma reivindicação.
Nenhum thatcherita pode se chamar libertário.	O ergo me ofende quando os que os que os Thatcheritas se consideram libertários.
O problema não é quem tem dinheiro.	O problema é quem não tem dinheiro.
Mas você realmente acredita que houve um iceberg nessas águas?	Eu não acredito que houve nenhum iceberg em nenhum lugar perto do Titanic.
Não o Astros ou Orioles Bad GameDay para o jogo Orioles está congelado para mim.	GameDay para o jogo Orioles está congelado para mim.
Nesse caso, muitos policiais devem tomar medicamentos de prescrição.	Nesse caso, muitos inventores, os escritores devem tomar medicamentos prescritos.
Diga -nos quais foram as acusações.	Sim, quais são as acusações dele.
Esses são psicopatas parciais.	Ted Bundy era um psicopata parcial?
Aqueles que ignoram a história estão fadados a repeti -la.	Ooo atinge dois aqueles que ignoram a história estão condenados a repeti -la.
Isso não é uma implantação de guerra.	Não é uma implantação oficial.
Nutrax O plural de anedota não é dados não precisavam de acompanhantes?	Nutrax O plural da anedota não é dados
Tudo bem, acabou de entrar.	Não está bem, tudo bem entrou.
H e eu lemos os livros e pensamos que o filme se moveu tão rapidamente.	Eu não li os livros, mas vi o filme hoje.
Essa não é a cena de Moloch, no entanto.	Esta é a cena de Moloch.
@ Lustig Andrei, então Lyndon Johnson e John Kennedy eram compatíveis?	@ Edgarblythe, então Lyndon Johnson e John Kennedy eram compatíveis?
Você precisa se decidir.	Você precisa polir suas habilidades lógicas.
Aquele que volta para casa depois e vai dormir.	O que tem três caminha para casa e bate em sua esposa.
- Admin Drpizza e eu esqueci o que você é uma cama chorosa e molhada.	E eu esqueci o que você é uma cama chorosa mais molhada.
O argumento era "Albert Einstein não foi para a faculdade".	OMG, "Einstein não foi para a faculdade".
ganhos de capital, taxa máxima: porcentagem.	Imposto de renda, taxa máxima: porcentagem.
Bienging é inacessível.	Estar bêbado é inaceitável.
Ele não tem sido engraçado em anos.	Ele não foi engraçado desde que Larry Bud Melman estava no show.
Se o universo tem uma explicação de sua existência, essa explicação é Deus.	Portanto, o universo tem uma explicação de sua existência.
O que recebemos em troca de lutar por eles?	------ ----------- O que recebemos em troca de lutar por eles?
Não pararia de piada de casamentos.	E eu não luto pelo casamento.
Se eles fossem judeus, eu os chamaria de judeus.	Se fossem católicos, eu os chamaria de católicos.
Ela era uma ótima senhora.	Ela era uma boa senhora.
Ele não é rico porque é bem -sucedido.	Por que odiar as pessoas porque elas são bem -sucedidas?
não tão irritado quanto você.	Você parece tão irritado quanto Henry.
É uma coisa de senso comum / raciocínio dedutivo.	Hilited seu senso comum / raciocínio dedutivo.
Você já fez isso - temos um muçulmano no cargo agora.	-Cryptolutheran no. Temos um cristão no cargo agora.
Eu disse que ela nunca teve que fazer parte de nenhuma força de trabalho.	Ann Romney nunca teve que sair e fazer parte da força de trabalho.
O DreamTech nunca foi ejaculado até onde eu sei.	Nunca foi ejaculado até onde eu sei.
Eu não disse que ficamos macios desde / Rand.	Eu disse que você ficou macio.
Todos nós acreditamos que estamos conseguindo o que esperamos.	Na maioria das vezes, % das vezes, estamos conseguindo o que esperamos.
Ben desprezível, pare de tentar encontrar desculpas para o homem.	Ben, pare de tentar encontrar desculpas para o homem.
A menos que seja diferente em diferentes países?	Então, forma curta, sim, provavelmente é diferente em diferentes países.
O novo estudo não apóia sua reivindicação.	A evidência física não apóia sua reivindicação.
Ele disse em todos os níveis.	Mas ele disse em todos os níveis.
A moral não existe, então tecnicamente nada pode estar moralmente errado.	Pergunto novamente se Deus não existe pode ser moralmente errado?
Eu pensei que eram principalmente apenas os holandeses.	são principalmente apenas os holandeses.
Toyland de Johnny Mathis somos todos navios cheios de muitas maravilhas.	Olhos do tigre, somos todos navios cheios de muitas maravilhas.
Vamos fazer isso no tribunal.	Nada está impedindo que essa coisa se desenrole no tribunal.
Estar em uma gangue não é um crime.	Cometer um crime em uma gangue é um crime.
Eu oferecerei um acordo ao Irã.	Chuck eu ofereço um acordo ao Irã.
Sim, ambos são diferentes.	As opiniões são diferentes.
Não é imponente moral.	Está impondo uma lei.
Annie já usou sua sexualidade assim?	Uma palavra: os zumbis Annie já usou sua sexualidade assim?
Comunismo puro: você tem duas vacas.	Libertário / anarco-capitalismo: você tem duas vacas.
Você deve colocar os cientistas em um pedestal.	Por que pessoas como você colocam cientista em um pedestal?
O que eles estão tentando se esconder?	Eu então perguntei: o que eles estão tentando se esconder?
Isso o tornaria parcialmente responsável pela morte deles.	Isso faria de você uma espécie de acessório, eu acho.
"Você gostaria de pagar por outros cuidados de saúde?"	"Você gostaria de usar o cinto de segurança?"
Eles não são tão soberanos quanto antes.	para repetir: eles não são tão soberanos quanto antes.
Não vejo Obama como o menor de dois males.	Eu não o vejo como mau.
Ou este de Jim Croce, somos todos navios cheios de muitas maravilhas.	Somos todos navios cheios de muitas maravilhas.
O ponto é que uma criança desarmada foi assassinada.	O ponto é que uma criança desarmada foi assassinada que era negra.
Zimmerman respondeu: "O que você está fazendo aqui?"	Martin disse: "Por que você está me seguindo?"
Irligion que faz isso eu tenho um problema.	A religião que não faz isso não tenho problema.
Se eu estou com raiva, ele aparecerá em uma dessas varreduras.	Se eu sou hiper ativo, ele aparecerá em uma dessas varreduras.
Se você deseja comprar $ bilhão em XYZ Inc. Ações ordinárias, quem se importa?	Se você quiser comprar uma casa ou um SUV, novamente, quem se importa?
bilhão. Todos no mundo no atual nível de prosperidade do México.	Todos no mundo no atual nível de "prosperidade" do noroeste da África.
Se você responder sim e não para você provavelmente é reto.	Se você responder não, mas sim, então você provavelmente será reto.
Às vezes eu fantasio sobre ter poder.	Às vezes eu também fantasio sobre dobrar as pessoas antes da minha vontade demente.
Meus pais me disseram que é ruim para você.	Meu xerife me disse que é ruim para você.
O Atlas encolheu os ombros também é um artista estelar em termos de idiotice.	É também um artista estelar em termos de idiotice Blithering.
Como Martin não saberia que esse não era o caso?	Como Martin ou mais alguém saberia suas intenções com base em suas ações?
Regulamento levar o governo a tudo.	"Leve o governo em tudo?"
É uma coisa de senso comum / raciocínio dedutivo.	Hilited seu senso comum / raciocínio dedutivo.
Sim, presumi que toda a embalagem seria reciclável em meu argumento.	Eu assumi isso também em meu argumento.
A anulação do júri não significa que uma lei seja inconscutional.	A anulação do júri significa que uma lei não é constitucional?
É apenas um monte de células.	Eu sou "um monte de células".
O trabalho de Mann era tudo sobre matemática.	O trabalho de Mann e o HS era sobre anéis de árvores.
Sinto muito por ouvir isso Kelly.	Sinto muito, Kelly.
Eu não gosto de cervejas com sabor.	Eu não gosto de muitas bebidas com sabor.
Espero que esteja tudo bem!	Espero que o seu lo esteja bem.
Qualquer mulher que queira controle de natalidade pode obtê -lo.	Qualquer mulher que queira e o aborto pode conseguir um.
S, como você deseja: você vê Hitler matando judeus?	Você vê Hitler matando judeus?
E eu sou seu amigo Mitt.	Seu bom amigo Mitt.
Isso significa que é uma opção.	não significa que é uma opção ruim.
Eu acho que você precisa reler o que escrevi.	Você precisa reler o que eu escrevi.
Vamos supor que tenhamos % branco e % preto.	Imagine um lugar que é % branco e % preto.
Mamãe entrou e disse: "O que é esse barulho?"	Meus filhos entraram e disseram 'O que é aquele pai? '
Meu melhor, Kutte, meu ex-noivo não usaria o VA ou o médico da Marinha.	Jay meu ex-noivo não usaria o VA ou o médico da Marinha.
Holder apresentou uma carta de três páginas.	Os juízes ordenam uma carta de três páginas a ser apresentada.
@ Lustig Andrei, Lustig, concordou.	@ Lustig Andrei, obrigado, Lustig.
Isso eclipsa o antigo registro do conjunto.	Isso quebra o registro diário de Set In.
Zimmerman respondeu: "O que você está fazendo aqui?"	Martin disse: "Por que você está me seguindo?"
Eu não sei como isso é legítimo, mas ouvi dizer que ele é meio suicida.	Então, eu não sei como isso é legítimo, mas sim.
O imposto municipal do Conselho não foi congelado para a maioria das pessoas?	O imposto municipal não foi congelado para a maioria das pessoas?
Seu truque está ficando obsoleto.	Sua misoginia está ficando confusa.
É assim que funciona?	Nah, não é assim que funciona.
Respire, expire, siga em frente.	Buwhahahaha respire, expire, siga em frente.
Espere até que eles se tornem mais consistentes e mais próximos.	Aguarde as contrações se aproximarem e se aproximarem.
Obama é extremo e de esquerda.	Obama faz parte da esquerda extrema.
@ Frank Apisa, o que você quer chamá -lo depende de você.	@ Cyracuz, o que você deseja chamar depende de você.
A anulação do júri não tem nada a ver com a constitucionalidade das leis.	A anulação do júri significa que uma lei não é constitucional?
De que convicção você está falando antes?	Que convicção seria essa?
Então, eu realmente li o OP e adivinhe o que descobri.	Além disso, achei o seguinte: então eu realmente li o OP e adivinhe o que descobri.
O governo não determina se você é casado ou não.	O governo não precisa declarar que você se casou antes de se casar.
A democracia é uma ameaça à liberdade.	A democracia não tem nada a ver com liberdade.
Oi Pro e Corn: Quantos tópicos você planeja fazer?	Quantos tópicos você planeja fazer?
Diga -me exatamente qual sistema não está funcionando agora?	Então, qual sistema não está funcionando para nós?
Ah, e novamente afirma que o casamento é um direito humano fundamental.	particularmente depois de afirmar que o casamento é um direito humano fundamental.
Por que os russos estão em Damasco?	Russos em Damasco!
Sim, é sobre diluição.	Er, não é como a diluição funciona.
Sim, eu também não acho isso controverso.	Eu não acho que o que ela está dizendo é isso controverso.
O Operação Caos é apenas pessoas votando.	O caos é apenas pessoas votando.
Postado originalmente por Jond Doubtful.	Postado originalmente por Eleanor.ellis
Gas clássico somos todos navios cheios de muitas maravilhas.	A música tema para aplausos: somos todos navios cheios de muitas maravilhas.
para repetir: eles não são tão soberanos quanto antes.	Eles não são tão soberanos quanto antes.
A moral não tem absolutamente nada a ver com isso!	E a moral e a honestidade têm tudo a ver com isso.
Eu estou conversando com Cornell West, meu querido irmão.	Eu estou tendo conversas Cornell West, o que diabos é isso?
Não há guerra no Oriente Médio.	Não há "guerra" no Oriente Médio.
Ele não tinha intenção de apreendê -lo.	- Eu não disse que ele planejava apreendê -lo.
Somos todos navios cheios de muitas maravilhas.	Coloque um pouco de amor em seu coração, somos todos navios cheios de muitas maravilhas.
Você é "um monte de células".	Eu sou "um monte de células".
O que é uma garota ducha?	Você é uma garota Douche.
A anulação do júri significa que uma lei não é constitucional?	não . A anulação do júri não significa que uma lei seja inconscutional.
Definitivamente, não é o que costumava ser.	votado votado, definitivamente não é o que costumava ser.
O ônus está no fabricante de um produto para convencer os consumidores que é seguro.	O fabricante precisa convencer o governo que está seguro.
Eu acho que você está perdendo o ponto com empreendedores.	Mais uma vez, acho que você está perdendo o ponto na citação de Twain.
"Ciclopes não existem" - tudo bem.	"Goblins não existem" - tudo bem.
"Nele havia uma doença mental, agora o que eles estão ensinando?"	Ele afirmou que era uma doença mental, como isso é fanatismo?
Landon e, portanto, é o Natal, somos todos navios cheios de muitas maravilhas.	Brinque com fogo, somos todos navios cheios de muitas maravilhas.
Bush recebe zero crédito pelo orçamento sob ele.	E Obama recebe zero crédito pelo orçamento sob ele.
. Pessoas pecaminosas não chegam ao céu.	ou o pecado é removido após a entrada do céu.
Quanto tempo depois da obliteração o garoto deve retornar à escola?	Quanto tempo depois da obliteração não deve mais incomodar o garoto?
Holly Santo somos todos navios cheios de muitas maravilhas.	Diga o que você fará, somos todos navios cheios de muitas maravilhas.
Qual foi a "resposta" em Chicago?	Qual será a resposta na Califórnia?
A coisa toda não faz sentido.	Veja isso não faz sentido.
Quem supostamente operou as câmaras de gás homicida?	Atualize sua memória: quem supostamente operou as câmaras de gás homicidas?
Portanto, a explicação da existência do universo é Deus.	Se o universo tem uma explicação de sua existência, essa explicação é Deus.
A predisposição genética à resistência ao câncer é a genética superior.	A predisposição genética a Alzheimer é genética inferior.
Você percebe as coisas sem sentido que você está dizendo?	E para ser justo, você percebe as coisas sem sentido que está dizendo?
uso da força em defesa da pessoa.-A	uso da força por agressor.
É isso que os dados disponíveis mostram.	É isso que o registro histórico mostra.
Alegria para o mundo somos todos navios cheios de muitas maravilhas.	A música tema para aplausos: somos todos navios cheios de muitas maravilhas.
Eu pensei que eram principalmente apenas os holandeses.	Na verdade, são apenas os holandeses.
Eu vi crianças brincarem.	Eu gosto de ver as crianças brincarem.
David @ omsigdavid, acho que Santorum é mais provável que Gingrich.	@ Sozobe, acho que Santorum é mais provável do que Gingrich.
Eles estão olhando um para o outro!	Por que eles estão se olhando assim? ! ? !
Você está dirigindo um?	Você está dirigindo um Volt porra?
Religião que faz isso com isso tenho um problema.	Irligion que não faz com que eu não tenha um problema.
Eu acho que ele não seria melhor para os interesses comerciais americanos em geral.	Ele seria melhor para a sociedade americana?
não é uma questão constitucional.	Novamente, isso não é uma questão constitucional.
seus tolos .. comprei o encobrimento .. gancho ..	oi eots: seus tolos .. comprei o encobrimento .. gancho ..
"O que pressionar o número um faz?"	"Pressionar o número um faz inglês."
Que convicção seria essa?	De que convicção você está falando antes?
Postado originalmente por Spikdboy, não é um pensamento, bastante realista.	Postado originalmente pelo objetivismo não é um pensamento desejado, bastante realista.
Pela trilhão, nunca disse que a reabilitação não funciona.	O ponto que você cita deve dizer "eu nunca disse que a reabilitação nunca poderia funcionar".
Charlie Rangel censurou alguém viu as filmagens disso?	Alguém viu as filmagens disso?
outubro vermelho parado.	Red Fox de pé.
Isso não é como os resumos legais são escritos.	Isso não é como o raciocínio legal funciona.
Não, nenhum desses fatores é responsável pelo aquecimento recente.	Você não sabe se esses fatores são responsáveis ​​pelo aquecimento, ou não.
Stone notificou o capitão Lord.	Ele também notificou o capitão Lord.
O foco principal da dialética sistemática é Syn Crônica, não do DIA crônica.	Assim, a dialética meta - sistema - atica é diacronico - dialética sincrônica.
Você está dirigindo um?	Você está dirigindo um Volt porra?
E isso está acontecendo nos estados controlados pelo Partido Republicano.	Michigan é um estado controlado pelo Partido Republicano.
Na bacia de Foxe, estava congelado.	Foxe estava principalmente congelado.
@ Frank Apisa, Frank, eu observo e percebo.	@ cicerone impostor, Frank, eu observo e percebo.
O governo decidindo o que as gestações precisam ser levadas para termo, isso está bem.	O governo espionando seus próprios cidadãos, isso está bem.
Coloque um pouco de amor em seu coração, somos todos navios cheios de muitas maravilhas.	Landon e, portanto, é o Natal, somos todos navios cheios de muitas maravilhas.
superior a por cento, mas não muito alto.	menor que por cento, mas não muito baixo.
O que não é como o que foi vendido?	Não é como foi vendido, GB.
Deus definitivamente não existe.	Deus provavelmente não existe.
Respire, expire, siga em frente.	Buwhahahaha respire, expire, siga em frente.
É um excelente indicador de mudança climática.	Acho que todos concordamos com a natureza da mudança.
O melhor de viver aqui é o espaço.	O ruim é o espaço de Lá.
Ah ha, ha, ha, ha, ha!	ha, ha, ha, ha, ha, ha!
Não entendo como a liberdade de expressão será proibida.	Sua liberdade de expressão não será mais proibida do que é hoje.
A pergunta precisa ser feita.	É uma pergunta que precisa ser respondida.
Você pretende valorizar muito a vida.	Eu pretendo valorizar muito a vida humana.
os postos de infestação.	os mosquitos postagens.
Eu não quero um presidente que 'se importa'.	Não queira um presidente que seja compassivo.
Você tem algo para torná -lo menos atraente ou não?	Você tem algo para torná -lo mais atraente?
Pela trilhão, nunca disse que a reabilitação não funciona.	O ponto que você cita deve dizer "eu nunca disse que a reabilitação nunca poderia funcionar".
Gas clássico somos todos navios cheios de muitas maravilhas.	Tempo da temporada pelos zumbis, somos todos navios cheios de muitas maravilhas.
Peeve, então concordamos que caiu essencialmente em queda livre?	Concordamos que eles caíram essencialmente em queda livre?
As pessoas pró-vida não querem que uma mulher seja capaz de escolher o aborto por si mesma.	As pessoas pró-escolha não tentam forçar um aborto a ninguém.
Então responda à pergunta.	Pare de evitar a pergunta.
Haiti é um mergulho.	O Haiti tem sido um mergulho.
Eu absolutamente acredito que havia um iceberg naquelas águas.	Eu não acredito que houve nenhum iceberg em nenhum lugar perto do Titanic.
O rosto da franquia: a pior parte é que ele nem é um fã do Leafs!	A pior parte é que ele nem é um fã do Leafs!
Concordo completamente que espero que ele esteja em um segundo mandato.	Espero que ele esteja em um segundo mandato.
Jake com a assistência.	Voracek com o objetivo.
É possível que sua casa tenha sido afetada e a escola não fosse?	Claro, é possível que sua casa tenha sido afetada, mas não a escola.
As pessoas despertaram.	Porque as pessoas despertaram.
Umm, a Califórnia era um navio de carga, eu não me importo com o que o artigo diz.	A Califórnia era um navio de carga.
Umm, isso afirma claramente: "O estatuto é presumido constitucional".	e até que eles decidam que "o estatuto é presumido constitucional".
Flórida A ignorância é sua!	A ignorância é sua!
Vou gritar por justiça para Trayvon.	As pessoas gritando por justiça para Trayvon são todos hipócritas.
Como você sabe o que está certo e errado?	Como você sabe qual história é a certa?
ha, ha, ha, ha, ha, ha!	Ah ha, ha, ha, ha, ha!
E Nugent foi um tolo completo para dizer o que ele disse.	Natalie era um tolo completo por ter insultado sua base de fãs.
É tudo culpa de Bush.	Obama é a culpa de Bush.
Você deve parar de prefixar ou sufixar tudo com você odeia judeus.	Eu não prefixo ou sufoco tudo com "Você odeia judeus".
Eu perdi o ponto em que ele disse que os negros estavam indo para o tumulto.	Nunca, nunca, eu disse que os negros estavam indo para o tumulto.
No entanto, você não precisava declarar isso.	E você não precisava.
Provérbios João Batista era um nazarita desde o nascimento.	João Batista era um nazarita desde o nascimento.
James: diz que a fé sem obras está morta.	Paulo não pregou fé sem obras.
bilhão. Todos no mundo no atual nível de prosperidade do México.	Todos no mundo no atual nível de "prosperidade" do noroeste da África.
e os dados sísmicos de vídeos não são iguais à duração do colapso.	Os dados sísmicos não são iguais à duração do colapso.
Postado originalmente por Lone Fox, você disse isso várias vezes agora.	Postado originalmente por Lone Fox e também não é tudo relacionado iraniano.
Você pode não gostar de visualizações de Obamas, mas ele as tem.	Você pode não gostar das posições que ele ocupa, mas pelo menos ele as tem.
Mas você realmente acredita que houve um iceberg nessas águas?	Eu absolutamente acredito que havia um iceberg naquelas águas.
Simplesmente não há vitória para Obama entre os conservadores.	Isso é rico vindo de um conservador.
Satanás representa indulgência em vez de abstinência!	. Satanás representa vingança em vez de virar a outra bochecha!
Contanto que o imposto sobre essa venda seja pago.	Contanto que o imposto seja pago.
consertar ? : O próprio Islã não é político.	O Islã sempre foi político.
Março também é a data da revolta na China.	Postado originalmente por Vitchilo March também é a data da revolta na China.
Espero que esteja tudo bem!	Espero que esteja tudo bem.
Você entende por que é absurdo limitar a pergunta para nós, residentes?	Você entende por que os residentes fora dos EUA também são relevantes para as estatísticas?
Eu vi OVNI sobre Varsóvia no passado.	Respeitosamente enviado, Steve eu vi OVNI sobre Varsóvia no passado.
Dependendo de qual ação promove sua agenda maluca do momento.	Dependendo de qual ação promove sua agenda de Tunes Lonny.
Você concorda ainda que eu não fiz nenhuma reivindicação?	Para que você admitisse e verificará que não fiz nenhuma reivindicação.
Zimmerman diz que foi otário socado por seu carro.	Seus "amigos" dizem que ele foi confrontado por seu carro.
Não há "guerra" no Oriente Médio.	Não há guerra no Oriente Médio.
Parte da pró-vida é a oposição ao aborto legalizado.	pró-vida também se refere apenas a "oposição ao aborto".
ganhos de capital, taxa máxima: porcentagem.	- Renda, taxa máxima: porcentagem.
Tempo da temporada pelos zumbis, somos todos navios cheios de muitas maravilhas.	A música tema para aplausos: somos todos navios cheios de muitas maravilhas.
Não, eu mostro que você é intencionalmente ignorante.	LOL, você é tão ignorante.
Somos todos navios cheios de muitas maravilhas.	Jingle Bell Rock, de Bobby Helm, somos todos navios cheios de muitas maravilhas.
O problema não é quem tem dinheiro.	O problema é quem não tem dinheiro.
Infelizmente, a Ford aceitou o dinheiro dos contribuintes.	A Ford não aceitou dinheiro dos contribuintes para salvar a empresa.
Os muçulmanos diriam a mesma coisa sobre o Alcorão.	Os hindus diriam a mesma coisa sobre a Bhagavad Ghita.
Sua confusão não me faz um mentiroso.	Então sua confusão também não me faz um mentiroso.
Quando os cristãos são extremos, é simplesmente religião.	Quando os muçulmanos são extremos, é o terrorismo.
Alguns acreditam que o 'direito' é mais importante.	Alguns acreditam que não matar o nascituro é mais importante.
A evolução não é uma opinião, não uma crença.	A teoria atômica não é uma opinião, não uma crença.
Não sou eu quem afirma o direito de decidir sobre o corpo de outra mulher.	Você quer que os outros decidam sobre o corpo da mulher.
Onde está Ron Paul?	Onde está o mundo a mídia? ?
Você não tem restos de míssil no Pentágono.	Você não tem restos de um A- no Pentágono.
O ponto que você cita deve dizer "eu nunca disse que a reabilitação nunca poderia funcionar".	Pela trilhão, nunca disse que a reabilitação não funciona.
bilhão. Todos no mundo no atual nível de prosperidade do México.	Todos no mundo no atual nível de "prosperidade" do noroeste da África.
Meu cabelo é bonito tho: / citação: idem.	Meu cabelo é bonito tho: / woops!
Não pararia de piada de casamentos.	E eu não luto pelo casamento.
Você parece pensar que as pessoas pobres não são responsáveis ​​por suas ações.	As pessoas são responsáveis ​​por suas ações.
Por que essa transação ocorreu.	A transação ocorreu?
É sobre a bagagem anexada.	Não é a mesma coisa.
Somos todos navios cheios de muitas maravilhas.	Coloque um pouco de amor em seu coração, somos todos navios cheios de muitas maravilhas.
O problema não é quem tem dinheiro.	O problema é quem não tem dinheiro.
O que faz você pensar que a coruja não participou?	Não diz que não participou.
LOL ansioso para ver o seu interno!	Estou ansioso para vê -lo!
Postado originalmente por Jacko!	Postado originalmente por Izzy!
Obrigado Candy por iniciar o tópico.	Candy - Obrigado por nos iniciar hoje.
Exceto que não era.	exceto que eles não poderiam.
Se eu lhe devo dólares, tenho um problema.	Se eu lhe devo um trilhão de dólares, você tem um problema.
Se não for fornecida evidência para apoiar uma posição; então deve ser rejeitado.	Se uma posição não for verificável; então deve ser rejeitado.
Todo mundo no atual nível de prosperidade do México.	Todos no mundo no atual nível de "prosperidade" do noroeste da África.
Bush recebe zero crédito pelo orçamento sob ele.	E Obama recebe zero crédito pelo orçamento sob ele.
lol não tem que fazer um teste para dirigir um veículo nos EUA?	Existe um teste para possuir uma arma de fogo nos EUA?
Nós dois pensamos que o filme era bom e não achamos confuso de forma alguma.	Eu pensei que era bom e não achei confuso.
Se Deus não existir, algo pode ser moralmente errado?	Pergunto novamente se Deus não existe pode ser moralmente errado?
Uma lei é constitucional se não entrar em conflito com a Constituição.	ser inconstitucional meios para violar a Constituição.
Postado originalmente por garotas muçulmanas, desculpe!	Postado originalmente por Muslim Girl não é uma impossibilidade completa.
Este não é o seu país.	Este é o nosso país.
Postado originalmente por Zaf, suponho que a água no meio faça a diferença.	Postado originalmente por Zaf a longo prazo, sim.
Cone jogou um jogo.	Addie Joss Cone jogou um jogo.
Editado por Lashl: editado para mascarar adequadamente palavrões.	Editado por Lashl: editado para mascarar adequadamente palavrões no post citado.
O júri não é informado sobre a anulação do jurado.	A cotação que você fornece não tem nada a ver com a anulação do júri.
A vítima é provável?	paranóico tem alguma prova?
Você não usa muito o botão de pesquisa, não é?	Você não usa o botão de pesquisa, não é?
Eu não acho que Paul tenha um tiro.	Paul não tem um tiro.
Tempo da temporada pelos zumbis, somos todos navios cheios de muitas maravilhas.	Alegria para o mundo somos todos navios cheios de muitas maravilhas.
Você percebe as coisas sem sentido que você está dizendo?	E para ser justo, você percebe as coisas sem sentido que está dizendo?
E se eles estragassem um estudo?	E se eles tivessem um viés pessoal?
especificamente um batista.	especificamente gnóstico.
e grande parte da costa leste.	e partes da costa oeste.
Por que você está falando sobre mulheres dentro das tribos hebraicas?	Estávamos conversando sobre mulheres como recompensas de guerra, não éramos?
Ontem à noite, as forças japonesas atacaram Hong Kong.	Ontem à noite, as forças japonesas atacaram as Ilhas Filipinas.
. Qual é a sua definição de "força vital"?	Qual é a sua definição de "alma"?
Isso não é responsabilidade direta aos constituintes.	Sim, mas eles são responsáveis ​​por seus constituintes.
A ideologia foi construída em torno de uma expansão violenta, então sim - expansão violenta.	A ideologia foi construída em torno da violenta expansão e superioridade racial.
Isso poderia ter sido um enema?	@ ossobuco, isso poderia ter sido um enema?
Minha palavra final: ignorar tem o efeito de normalizar.	Aproveitar tem o efeito de reforçar.