a atividade de aprender ou ser treinado	o processo gradual de aquisição de conhecimento.
tiras de metal finas usadas na composição	Tira fina de metal usada para separar linhas do tipo na impressão.
Falcon: abandonar o jogo pretendido e perseguir presas menores	abandone a presa pretendida, vire e perseguir uma presa inferior.
o ato de designar um papel para alguém	o ato de designar ou identificar algo.
tornar puro ou livre do pecado	tornar puro ou livre de pecado ou culpa.
Deixe desfeito ou deixe de fora	não conseguir fazer algo; Deixe algo desfeito.
um conjunto social ou camarada de amigos	uma associação não oficial de pessoas ou grupos.
a parte superior de uma coluna.	a parte superior de uma coluna que suporta o entablamento.
afundar para um nível mais baixo; descer	afundar para um nível mais baixo ou formar uma depressão.
Crie código ou programas de computador	Crie código, escreva um programa de computador.
Libere do confinamento, obrigação ou um fardo	conceder alívio ou isenção de uma regra ou requisito para.
(causa para) manchar o bom nome e a reputação de.	cobrar falsamente ou com intenção maliciosa; Ataque o bom nome e a reputação de alguém.
uma empresa que fornece commodities de serviço público	uma empresa que executa um serviço público; sujeito à regulamentação do governo.
estender ou se espalhar fisicamente para fora de um centro ou foco ou para dentro em direção a um centro; espalhe fisicamente do ponto de partida.	Estenda ou se espalhe para fora de um centro ou foco ou para dentro em direção a um centro.
distribuir sistematicamente ou estrategicamente; iniciar.	para distribuir sistematicamente ou estrategicamente.
Crie algo na mente	formar uma imagem mental de algo que não está presente ou esse não é o caso.
(causa para) tornar -se menos claro ou indistinto	para tornar menos distinto ou claro.
isento ou livre de um ônus, dever ou requisito	livre de um fardo, mal ou angústia.
um comprimento reto de estrada ou pista	uma seção direta de uma pista de corrida.
(causa para) emitir uma breve explosão de luz	Emite uma breve explosão de luz.
esticar ao máximo, causando estresse ou lesão	Altere a forma de (algo) por estresse.
mova -se em um grupo ou rebanho	Mova -se como multidão ou em grupo.
um debaramento temporário, revogando um privilégio	um debaramento temporário (de um privilégio ou posição etc.).
uma imperfeição; a qualidade de ser inadequado ou aquém.	A qualidade de ser inadequada ou aquém da perfeição.
Muco limpo da garganta de um	Limpo do muco ou comida da garganta de um.
preservar, manter em segurança, usar frugalmente	Mantenha em segurança e proteja de danos, deterioração, perda ou destruição.
um endereço usado para comunicação postal	o endereço onde uma pessoa ou organização pode ser comunicada.
uma organização que patrocina um grande evento público	Qualquer organização que forneça recursos e instalações para uma função ou evento.
aprovar ou ratificar legalmente uma pessoa para uma posição	Apoie uma pessoa para uma posição.
Tente curar por cuidados ou tratamento especial, de uma doença ou lesão; tratar com cuidado.	Tente curar cuidados especiais do tratamento, de uma doença ou lesão.
qualquer coisa com a forma de uma tira fina	Um longo implemento fino, semelhante a um comprimento de madeira.
o componente controlador de um constituinte gramatical	(Gramática) A palavra em um constituinte gramatical que desempenha o mesmo papel gramatical que todo o constituinte.
alcançar um destino ou objetivo	chegar a um destino; chegar por movimento ou progresso.
murchar, murchar ou madurar imperfeitamente, como de uma flor.	murchar ou murchar ou madurar imperfeitamente.
parte, cessar ou quebrar associação com (alguma coisa).	papel ; cessar ou quebrar a associação com.
uma sugestão dada a alguém para obter ajuda	Uma sugestão dada a um artista (geralmente o início da próxima linha a ser falado).
tornar mais comum, uniforme ou geral	Receba de casos específicos para casos mais gerais.
(causa) estourar ou abrir, geralmente com um som nítido	Operto com um som nítido e explosivo.
faça (indevidos) reivindicações de possuir.	Faça reivindicações indevidas de ter.
o chefe político do governo da cidade	o chefe de um governo da cidade.
fazer ficar quieto	fique quieto ou parado; ficar em silêncio.
mais para a frente de maneira saltada ou pular.	Avance aos trancos e barrancos.
desistir certo ou posse de outro	Desista ou concorde em renunciar ao poder ou posse de outro.
venha como uma conseqüência lógica, seja inferido	Venha como uma consequência lógica; Siga logicamente.
o evento de desaparecer gradualmente de vista	o evento de desbotamento e desaparecer gradualmente da vista.
sentir -se ansioso, preocupado, desconfortável ou apreensivo com	Tenha medo ou sinta -se ansioso ou apreensivo com uma situação ou evento possível ou provável.
viajar ou ser moldado como um zigue -zague	viajar ao longo de um caminho em zigue -zague.
criar uma bagunça ou desordem	Faça uma bagunça ou crie desordem.
o estado de ser empregado	o estado de ser empregado ou ter um emprego.
uma escultura de um humano ou animal	uma escultura representando um humano ou animal.
(Resumo) caracterizar, comemorar, tornar especial (ou respeitoso)	ser uma característica, atributo ou característica distinta; Às vezes, em um sentido muito positivo.
operando ou viajando através de um veículo	viajar ou ser transportado em um veículo.
(causa) cair ou diminuir para um local inferior, nível ou valor	cair ou descer para um lugar ou nível inferior.
A capacidade de lembrar as coisas	A capacidade de recordar ocorrências passadas.
Um agente animado pronuncia com um som cuspindo, como se estivesse com raiva.	Dunemente com um som cuspindo, como se estivesse em uma raiva.
o barulho de algo batendo contra uma superfície	o som de bater (como em uma porta ou em um motor ou rolamento).
Peça e obtenha algo de graça.	Peça e se liberte; Seja um parasita.
uma condição geral de solidez de um sistema ou máquina	a condição geral do corpo e da mente.
uma área cercada por paredes ou edifícios	uma área total ou parcialmente cercada por paredes ou edifícios.
levantar as apostas ou aposta de um jogo por um fator de 2	Aumentar as apostas em um jogo de cartas em um fator de 2.
o ato de renunciar a um ativo	o ato de perder ou renunciar a algo como uma penalidade por um erro ou falha ou falha no desempenho etc.
proteger ou falar contra críticas ou oposição	Proteja ou lute como campeão.
uma relação de afinidade ou harmonia entre as pessoas.	uma relação de afinidade ou harmonia entre as pessoas; O que quer que afete um afeta correspondentemente o outro.
salvar de uma experiência, ação ou dano	salvar ou aliviar de uma experiência ou ação.
percorrer a borda de	Corra ao redor da borda de.
Assumir (mental ou fisicamente)	Tome (gás, luz ou calor) em uma solução.
separado (como se) passando por uma peneira	Separe passando por uma peneira ou outro dispositivo de estiragem para separar os elementos mais grossos.
uma planta cultivada que agora está ficando selvagem	Uma planta originalmente cultivou, mas agora crescendo selvagem.
acelerar o processo de	acelerar o progresso de; facilitar.
fornecer evidências para; mostrar pelo comportamento, atitude ou atributos externos de um; incorporar.	fornecer evidências para; permanecer como prova de; mostrar pelo comportamento, atitude ou atributos externos de um.
Um programa de computador que executa suporte ao sistema	(Ciência da Computação) Um programa projetado para apoio geral aos processos de um computador.
o período de uma cessação temporária	um intervalo de tempo durante o qual há uma cessação temporária de algo.
empurrão rítmico das pernas em um golpe de natação	Um movimento rítmico das pernas como na natação ou na calistenia.
Torne mais temperado, aceitável ou adequado.	tornar mais temperado, aceitável ou adequado adicionando outra coisa; moderado.
confinar ou como se estivesse em uma prisão	Confie como se estivesse em uma prisão.
fazer avanços amorosos ou sexuais para	abordagem com uma oferta de favores sexuais.
derrubado pela força, intimidação ou autoridade, como uma pessoa; correto por punição ou disciplina.	correto por punição ou disciplina.
quebrar um sólido, geralmente em uma solução	causa para entrar em uma solução.
Um movimento (físico ou abstrato) de volta de um impacto.	um movimento de volta de um impacto.
o ato de colocar algo para usar.	a ação de colocar algo em operação.
(causa para) relaxar, ficar à vontade, assuma uma maneira amigável	separar e elevar as fibras de.
Uma estrutura física de tiras de cruzamento, geralmente de madeira	Estrutura que consiste em um design ornamental feito de tiras de madeira ou metal.
Uma declaração de dinheiro especificada devido	Uma declaração de dinheiro especificada devido a mercadorias enviadas ou serviços prestados.
parte central de um átomo de carga positiva	o centro denso de um átomo carregado positivamente.
Um evento que faz com que alguém ou algo morra.	Um evento que faz com que alguém morra.
indicar uma decisão ou previsão	declarar na capacidade de um árbitro ou árbitro.
estado de ser ativo, movimentado sobre	o traço de ser ativo; movendo ou agindo de forma rápida e energética.
causa para ficar acordado ou alerta	causa para estar alerta e enérgico.
Procure um livro ou algum outro material escrito (para obter informações).	Olhe através de um livro ou outro material escrito.
a conclusão de uma comunicação	a última seção de uma comunicação.
conhecer ou encontrar a capacidade social ou profissional	vá ver por razões profissionais ou comerciais.
grupo montado de espectadores em uma performance	Uma reunião de espectadores ou ouvintes em um desempenho (geralmente público).
Dê explicações ou citações interlineares para texto	Forneça uma tradução interlinear de uma palavra ou frase.
Deixe para alguém após a morte de alguém.	sair ou dar por vontade após a morte de uma.
causa para vibrar em um padrão diferente	causa para vibrar em um padrão definido.
obrigar, aplicar ou insistir em algo	obrigar a se comportar de uma certa maneira.
Desenhe um cruzamento no ar sobre algo	viajar ou passar.
dar algo que não é necessário	Desista do que não é estritamente necessário.
(causa para) tornar -se menos interessante, atraente ou vigoroso.	Torne -se menos interessante ou atraente.
Tenha um desacordo ou briga sobre algo	Tenha um desacordo sobre algo.
suportar ou experimentar um evento doloroso	sofre (como lesões e doenças).
a maneira pela qual algo ou alguém funciona ou opera	processo ou maneira de funcionar ou operar.
o evento de parar, acabando com algo	o evento de algo que termina.
retornar a um estado anterior	retornar a um estado original.
os Estados Unidos, especialmente o Norte durante a Guerra Civil	Os Estados Unidos (especialmente os Estados do Norte durante a Guerra Civil Americana).
(causa para) ficar sobrecarregado ou sobrecarregado	Coloque muita carga.
o ato de substituir uma coisa por outra	o ato de fornecer uma pessoa ou coisa equivalente no lugar de outra.
imagine; formar uma imagem mental de algo	formar uma imagem mental de algo invisível ou abstrato.
indicar uma decisão ou previsão	indicar uma decisão em relação a.
carregar um fardo, real ou metafórico	carregue um fardo, real ou metafórico.
uma tarefa ou empreendimento oficial, geralmente financiado	Qualquer trabalho que seja realizado ou tentado.
A sequência happlóide completa do DNA de um organismo	a ordem dos genes em um conjunto haplóide de cromossomos de um organismo específico; A sequência completa de DNA de um organismo.
carimbo ou relevo com um bloco	Carimbar ou grave um título ou design em um livro com um bloco.
(medicina) A capacidade de um organismo de se defender contra doenças.	(medicina) A condição na qual um organismo pode resistir a doenças.
um bando de ovelhas ou cabras	um grupo de ovelhas ou cabras.
uma unidade de pressão atmosférica	(Meteorologia) Uma unidade de pressão igual a um milhão de dines por centímetro quadrado.
um chute vencedor no tênis contra o saque do oponente	(Tênis) Uma pontuação que consiste em ganhar um jogo quando seu oponente estava servindo.
um mensageiro implantado em uma missão em nome de outra pessoa	Alguém enviou uma missão para representar os interesses de outra pessoa.
o ato de levar uma oferta	o ato de levar algo que é oferecido.
acertar ou retornar antes de tocar o chão	Bata antes de tocar o chão.
uma arma de empuxo, como uma espada	Uma arma de corte ou empuxo que tem uma longa lâmina de metal e um punho com um guarda de mão.
Misture ou crie coisas de diferentes variedades ou qualidades	cria animais ou plantas usando pais de diferentes raças e variedades.
Caminhe pesadamente e firmemente (como um gato) como quando cansado ou sobre terreno macio.	Caminhe pesadamente e firmemente, como quando cansado ou pela lama.
pagar atenção sexual não solicitada a	Pague atenção sexual não solicitada e geralmente indesejada a.
liberação (gás ou energia) como resultado de uma reação química ou decomposição física (talvez em sentido metafórico)	liberação (gás ou energia) como resultado de uma reação química ou decomposição física.
remodelando uma peça ou transmissão	executar novamente uma apresentação de uma peça, por exemplo.
uma posição figurativa em relação a outras posições, como nos argumentos	uma posição dada por sua localização ao lado de um objeto.
estado de estar sob controle	o estado de ser controlado ou governado.
uma corrida de veículos em estradas públicas	Uma corrida de automóveis atropela as estradas públicas.
quantidade que pode ser contida	a quantidade que pode ser contida.
Tome medidas legais para buscar uma compensação por um errado	instituir procedimentos legais contra; arquivar um processo contra.
mova -se e fique em uma posição específica	Coloque em um determinado local ou localização abstrata.
Tiro de abertura em bilhar ou piscina	O tiro de abertura que espalha as bolas em bilhar ou piscina.
um instrumento de tortura aplicado ao pé e perna	Um instrumento de tortura que é usado para aquecer ou esmagar o pé e a perna.
(causa) separar ou mover em direções diferentes	causar separar e seguir direções diferentes.
um direito estabelecido ou reconhecido, formal ou informal.	um direito informal a algo.
buscar algo de uma fonte	ato de obter ou drenar algo como eletricidade ou um líquido de uma fonte.
comunicar ou fazer conhecido por gestos, ação ou sinais	Comunique-se silenciosamente e não verbalmente por sinais ou sinais.
atinge a parte superior de uma bola dando uma rotação para a frente	Strike (a parte superior de uma bola no golfe, beisebol ou piscina) dando uma rotação para a frente.
o ato de gastar fundos, desembolsando	o ato de gastar ou desembolsar dinheiro.
Gravando faixas de música feitas em algum meio	uma trincheira parecida com um sulco feito por erosão ou escavação.
uma aptidão ou talento inerente	uma aptidão que pode ser desenvolvida.
Torne o liberal ou mais liberal, torne -se mais liberal, geralmente em termos de leis ou regras.	tornar liberal ou mais liberal, de leis e regras.
livre de obrigações, serviço ou confinamento	livre de obrigações ou deveres.
torcer uma parte do corpo repentinamente para entrar em torno	torça repentinamente para torcer.
uma causa ou fonte de coação, preocupação	dificuldade que causa preocupação ou tensão emocional.
um estado de autoridade gerenciando ou dominando uma circunstância	a atividade de gerenciar ou exercer controle sobre algo.
mover (como se) diminuindo	Venha como se caia.
Processar ou refinar em um forno reverberando	Trate, processe, aqueça, derreta ou refine um forno reverberatório.
Termo econômico: aumentar a demanda econômica, expandir a oferta de dinheiro ou aumentar os preços para experimentar a reflação	Economia: aumentar a demanda, expandir a oferta monetária ou aumentar os preços, após um período de deflação.
limpo, limpeza ou capaz de ser limpo	Limpe com um agente de limpeza, como sabão e água.
Invocar em ação ou trazer à existência, muitas vezes como se por mágica; Peça a ajuda ou proteção de.	solicitar sinceramente (algo de alguém); Peça ajuda ou proteção.
o ato de jogar um beisebol	(beisebol) O ato de jogar um beisebol por um arremessador em um batedor.
quebrar a pele (de uma parte do corpo) raspando; impactar outra coisa.	Quebre a pele (de uma parte do corpo) raspando.
alocar ou dedicar; Separe ou separe para uma finalidade ou uso específico.	Separe ou separe para uma finalidade ou uso específico.
(tentar) convencer a matricular, se juntar ou participar	Registre -se formalmente como participante ou membro.
dar uma interpretação específica para	torça e gire para dar uma interpretação pretendida.
organizar novamente, como após um revés; coletar ou se compor.	Organize novamente, como após um revés.
pegar ou como se estivesse em uma armadilha; imobilizar	Pegue ou se estivesse em uma armadilha.
um grupo exclusivo e privilegiado de pessoas	um grupo exclusivo de pessoas.
entrar em conflito, encontre -se em oposição	ser incompatível; estar ou entrar em conflito.
reagir ou responder a uma chamada, comando ou estímulo	reaja a um estímulo ou comando.
fornecer uma trilha sonora ou narração	Forneça (filmes) com uma trilha sonora de uma língua estrangeira.
uma alavanca que ativa um mecanismo de disparo, especialmente com uma arma de fogo	alavanca que ativa o mecanismo de disparo de uma arma.
avançar ; contribuir para o progresso ou crescimento de.	contribuir para o progresso ou crescimento de.
causar a atenção, os objetivos, o pensamento de outra direção em outra direção	Ocupar de uma maneira agradável, divertida ou agradável.
o ato humano de fazer algo novo.	O evento que ocorreu no início de alguma coisa.
mover ou se reunir em uma colméia	Mova -se juntos em uma colméia ou como se estivesse em uma colméia.
enxágüe a boca de um com enxaguatório bucal, gargarejo	Enxágue a boca e a garganta de um com enxaguatório bucal.
fornecer ou equipar especificamente com móveis.	fornecer ou equipar com móveis.
Faça ou crie algo para uma função específica.	Faça com os componentes (geralmente de maneira improvisada).
Salário mais baixo de funcionários permitido por lei	O salário mais baixo que um empregador pode pagar; determinado por contrato ou por lei.
podridão aquosa na produção causada por fungo	podridão aquosa macia em frutas e legumes causados ​​por fungos.
sala onde trabalho ou reparos são feitos	quarto onde o trabalho é feito.
separe ou remova beliscando ou brigando; tendem cortando.	Reduza ou remova beliscando ou rolando.
Compressa fora de forma ou em pequenos pedaços	Fique ferido, quebrado ou distorcido pela pressão.
uma única pedra alta, por exemplo , obelisco ou monumento	uma única grande pedra (geralmente na forma de uma coluna ou obelisco).
(causa para) gradualmente se tornar fraco	causa para crescer magro ou fraco.
mover ou executar muito rapidamente ou apressadamente	Corra ou mova -se muito rapidamente ou apressadamente.
provar ou sugerir ser falso ou incorreto.	provar ser falso ou incorreto.
(causa para) ser sobreposto a algo	Forneça uma cobertura ou causa para ser coberta.
Leve como uma mochila, vá mochila	Carregue, como está de volta.
(causa) separar -se em constituintes, enfraquecer ou destruir especificamente a imersão.	separados em constituintes, imertando.
Rale: roça emocionalmente; deixar ressentido ou com raiva.	roer; deixar ressentido ou com raiva.
brilho ou ataque com intensidade	olhar ou atacar com grande intensidade.
porção ou estaca legítima de algo	(lei) uma participação certa ou legal de algo; um envolvimento financeiro com algo.
Seja brilhante; Seja uma fonte física ou metafórica de luz.	Shine intensamente, como uma estrela ou uma luz.
o movimento rotativo de um objeto	movimento rotativo de um objeto em torno de seu próprio eixo.
um parceiro romântico, namorada ou namorado	(gíria) A namorada ou namorado de uma pessoa.
aderência, penetrar ou rasgar com ou como se com os dentes ou mandíbulas	Para agarrar, cortar ou rasgar com ou como se com os dentes ou mandíbulas.
exceder ou superar, vá além, seja maior do que algo	Passe por, mais ou menos sem fazer contato.
a parte mais externa de um carro ou roda de caminhão	a parte externa de uma roda à qual o pneu está preso.
entregar para conseguir algo em troca	Para entregar (vouchers ou cupons) e receber algo em troca.
o ato de perceber um perfume	o ato de perceber o odor de algo.
escuridão relativa de uma cor	escuridão relativa ou leveza de uma cor.
expressar ou transformar em uma nova forma ou idioma	mude de uma forma ou meio para outro.
refrescar, para fazer fresco; Atualizar	torne -se ou se torne fresco novamente.
uma área de trabalho para fabricação ou reparo	pequeno local de trabalho onde artesanato ou fabricação são feitas.
cair entre dois grupos taxonômicos	ser intermediário entre dois grupos taxonômicos.
borbulhar com um certo sentimento	transborda com um certo sentimento.
Pegue -se, como se com uma concha	Pegue a mão de alguém ou uma concha abaixo da superfície.
a ação de se opor a outra força social ou militar.	A ação militar de resistir ao avanço do inimigo.
inclinar ou dobrar; Configuração de Changle.	para inclinar ou dobrar de uma posição vertical.
(porque) pulverizar ou molhar com um surto de líquido	Molhado com um surto de líquido.
mover -se (a cabeça ou o corpo) rapidamente para baixo ou para longe (de alguma coisa).	mover -se (a cabeça ou o corpo) rapidamente para baixo ou para longe.
uma parte especificada de um todo	Uma das várias partes ou peças que se encaixam com outras pessoas para constituir um objeto inteiro.
Junte -se ou anexe (como se) com cola, possivelmente para cobrir a superfície de um objeto.	Junte -se ou anexe com ou como se com cola.
mover de um local para outro	Transferência de um lugar ou período para outro.
Para fazer um ótimo esforço mental ou físico	Faça um grande esforço em uma tarefa mental ou física.
A pesca exausta, permitindo puxar a linha	Exaustão permitindo puxar a linha.
Use completamente um recurso	use todo o suprimento de.
proteger e proteger uma forma de vida, manter por lesão ou dano	manter em segurança por lesão, dano ou perigo.
uma faculdade local não residencial oferece dois anos de cursos	Uma faculdade júnior não residencial oferece um currículo ajustado às necessidades da comunidade.
jogue um olhar para; Dê uma breve olhada ou examine às pressas.	jogue um olhar para; Dê uma breve olhada em.
uma unidade militar da Força Aérea, menor que um esquadrão	uma unidade da Força Aérea menor que um esquadrão.
interferir na atividade de outra pessoa	destruir a paz ou tranquilidade de.
atribuir ou organizar em categorias	Organize ou encomende por classes ou categorias.
ser elegível ou adequado, atenda aos requisitos para / as	provar capaz ou adequado; atender aos requisitos.
trate uma substância com algum agente; Adicione um agente a.	tratar com um agente; adicione (um agente) a.
construir, fazer combinar materiais ou peças	Faça combinar materiais e peças.
tornar mais frio ou gelado, usando gelo	causa para se tornar gelo ou gelado.
fornecer um assento ou base para	mostrar um assento; Atribua um assento para.
Exponha ao ar para esfriar, refrescar ou deixar escapar.	Exponha ao ar frio ou frio para esfriar ou refrescar.
o ato de perpetrar um crime	o ato de cometer um crime.
apoio colocando -se sobre ou contra algo sólido	suporte colocando -se contra algo sólido ou rígido.
não consegue alcançar uma coisa abstrata	não ganhar dinheiro em um negócio; fazer uma perda ou não lucrar.
um instrumento pontiagudo para escrever, caneta	uma ferramenta pontiaguda para escrever, desenhar ou gravar.
participe ou forneça um banquete	participe de um banquete ou banquete.
um participante que é iniciante em alguma atividade	qualquer novo participante de alguma atividade.
prenda passando uma corda através ou ao redor de algo	prenda passando por um buraco ou em torno de algo.
alinhar ou fazer paralelo; trazer para o ajuste adequado	Coloque em uma linha ou organize para ser paralelo ou reto.
o ato de enumerar ou somar um total	o ato de contar; Recitando números em ordem crescente.
Remova substâncias de um líquido ou solução	Remova um constituinte de um líquido.
estudar intensamente como se estivesse se preparando para um teste	Estude intensamente, como antes de um exame.
Decida o valor a ser pago em uma reivindicação de seguro	Decida quanto deve ser pago em uma reivindicação de seguro.
suborno, faça pagamentos em troca de benefícios	obter por compra; adquirir por meio de uma transação financeira.
um centro de detenção para prisioneiros ou bêbados	uma célula para prisioneiros violentos.
um pequeno presente ou lembrança dada aos convidados em uma festa	Lávenir composta por um pequeno presente dado a um hóspede em uma festa.
Corra em um ritmo moderadamente rápido, como para o exercício.	Corra em um ritmo moderadamente rápido.
opor ou abordagem, como em hostilidade ou competição	Opor, como em hostilidade ou competição.
as técnicas e princípios da composição artística usando tintas	Criando uma imagem com tintas.
Território de um governo soberano	o território ocupado por uma nação.
(causa) mudar de um gás para um líquido.	fazer com que um gás ou vapor se transforme em um líquido.
uma operação que agrupa itens de acordo com critérios específicos	uma operação que segrega itens em grupos de acordo com um critério especificado.
força a ir embora piscando um olho.	força a ir embora piscando.
a qualidade tátil (touch) algo tem	A sensação produzida pelos receptores de pressão na pele.
manipular ou mover algo para operar.	fazer continuar ou ser envolvido ou definido em operação.
arraste frouxamente ao longo de uma superfície, trilha	arraste frouxamente ao longo de uma superfície; Deixe varrer o chão.
influenciar ou controlar com habilidade e muitas vezes.	influenciar ou controlar astuciosamente ou devidamente.
causa para ser perplexo ou mentalmente confundido.	causa para ser perplexo ou confuso.
simbolizar, servir como um exemplo de	Sirva como um meio de expressar algo.
a atividade de remover um recurso	o ato de diminuir algo acentuadamente.
passe (um fio) através ou para dentro ou para dentro ou como se estivesse em uma string	Freque ou como se estivesse em uma string.
Mudando uma coisa para outra	O ato de mudar uma coisa para outra coisa.
Falta de acordo, não harmoniosa	falta de concordância ou harmonia.
construir, fazer combinar materiais ou peças	Reúna -se de componentes ou peças artificiais ou naturais.
o ato ou capacidade de ver	o ato de olhar ou ver ou observar.
Uma afirmação oferecida como evidência, uma linha de raciocínio	Um fato ou afirmação oferecida como evidência de que algo é verdadeiro.
mancha com uma substância suja	mancha com uma substância suja, como fuligem.
nomear, ordenar para um post de escritório	Nomear para postagens de escritório.
Espere, preveja ou prevê algo no futuro	fazer uma previsão sobre; diga com antecedência.
declarar ou explicar o significado	Dê uma definição para o significado de uma palavra.
mergulhar brevemente em líquido ou recipiente	mergulhe brevemente em um líquido para molhar, revestir ou saturar.
um contrato que concede uso ou ocupação de propriedades sob determinados termos ou condições.	um contrato que concede uso ou ocupação de propriedades durante um tempo especificado para um pagamento especificado.
passar ou colocar uma embarcação através de uma fechadura em uma hidrovia	passe por meio de uma fechadura em uma via hidrográfica.
causa para assumir uma condição	coloque em um determinado estado; causa para estar em um determinado estado.
A inclusão de todos os membros de conjuntos matemáticos	um conjunto contendo todos e apenas os membros de dois ou mais conjuntos.
encharcar periodicamente com líquido enquanto cozinha	Cubra com líquido antes de cozinhar.
aumentar para um nível de energia mais alto (como na física)	aumentar para um nível de energia mais alto.
Certifique -se de fracasso ou destruição de; destinar	certifique -se do fracasso ou destruição de.
função de uma maneira específica ao se mover	tem certas propriedades quando conduzido.
um conjunto de peças de trabalho criativo para mostrar	Um conjunto de peças de trabalho criativo coletadas para serem mostradas a clientes ou empregadores em potencial.
uma pessoa que tira fotos, geralmente um profissional	alguém que tira fotografias profissionalmente.
surgir; revelar sua presença ou fazer um apropriado.	revelar sua presença ou aparecer.
Reduza para pequenos pedaços batendo ou moendo.	Reduza para pequenos pedaços ou partículas batendo ou abrasando.
discernir, identificar ou saber por causa de uma experiência anterior	Exiba reconhecimento para (um antígeno ou substrato).
executar ou supervisionar um ritual	realizar (um sacramento da igreja) ritualmente.
Um objeto prejudica a respiração de alguém ou algo.	prejudicar a respiração ou obstruir a passagem do ar de.
a abordagem próxima de um objeto para outro	o movimento de um objeto em relação a outro.
agir de acordo com as regras, comandos ou desejos	Aja de acordo com as regras, comandos ou desejos de alguém.
custo ou valor monetário de bens ou serviços	o alto valor ou valor de algo.
uma unidade em funcionamento de uma organização política maior, um quadro	uma pequena unidade que serve como parte ou como o núcleo de um movimento político maior.
envolver como um acompanhamento ou resultado necessário; tem como conseqüência lógica.	impor, envolver ou implicar como um acompanhamento ou resultado necessário.
consideração com consideração ou respeito	consideração ou tratamento com consideração, respeito e estima.
o ato de levantar algo	o ato de levantar algo.
mentir em um ângulo; dobrar ao longo de um caminho.	para inclinar ou dobrar de uma posição vertical.
prejudicar ou ocultar o progresso ou ocorrência de	Evite o progresso ou a livre circulação de.
o ato de ficar para descansar após uma viagem.	o ato de descer à terra (ou outra superfície).
derrubado pela força ou autoridade; desça ou mantenha o uso injusto da autoridade.	desça ou mantenha o uso injusto da autoridade de um.
Remova os pêlos faciais amarrando uma corda fina e puxando	Remova os pêlos faciais amarrando uma corda fina e puxando a corda.
gerenciar, manusear ou controlar algo	direcionar o curso de; gerenciar ou controlar.
força física que une objetos	a força pela qual um objeto atrai outro.
lidar com de acordo com a rotina ou procedimento	lidar com uma maneira rotineira.
inclua em uma cobertura protetora.	Cubra com um revestimento protetor.
reverte uma direção, atitude ou curso de ação, talvez perceptivamente.	reverso (uma direção, atitude ou curso de ação).
uma taxa de entrada fixa para um clube ou local	Uma carga fixa por um restaurante ou boate, além da acusação de comida e bebida.
o ato de permitir, conceder algo	o ato de fornecer um subsídio.
Desenhe e expele o ar através dos pulmões.	Desenhe o ar e expulse os pulmões.
Página inicial de um site	A página de abertura de um site.
(Baseball) Marque o corredor da base para tirá -lo.	Marque o corredor da base para tirá -lo.
(causa) mover -se abruptamente, muitas vezes emitindo um som curto e nítido	Feche com um movimento de estalo.
As pessoas se reuniram em um movimento rítmico	Uma festa de pessoas se reuniu para dançar.
um transporte ou transportador, muitas vezes com rodas	um transporte que transporta pessoas ou objetos.
365 dias de 1 de janeiro a 31 de dezembro, o calendário gregoriano	o ano (calculado de 1º de janeiro a 31 de dezembro) de acordo com o calendário gregoriano.
Aplique condicionador para tornar suave e brilhante.	Aplique o condicionador para tornar suave e brilhante.
uma votação, uma escolha pública e legal de funcionários	uma votação para selecionar o vencedor de uma posição ou cargo político.
Aproxime -se de uma certa medição, seja de idade, velocidade, temperatura, etc.	abordar uma certa idade ou velocidade.
Para encher de carvão ou óleo	Encha (um bunker de navio) com carvão ou óleo.
atribuir a uma tarefa específica	atribuir a uma tarefa específica.
deixar isolado com pouca esperança de resgate	Deixe preso ou isolado com pouca esperança de resgate.
um organismo infectado com outro organismo ou patógeno parasitário	um animal ou planta que nutre e apóia um parasita; Não se beneficia e é frequentemente prejudicado pela associação.
fazer coincidir no tempo ou operação	Faça síncrono e ajuste no tempo ou na maneira.
confinar ou como se estivesse em uma prisão	trancar ou confinar, dentro ou como em uma prisão.
a expiração forte do ar do nariz ou boca	Expiração forte através do nariz ou da boca.
um sistema social de produção, distribuição e consumo	o sistema de produção e distribuição e consumo.
Mantenha algo intacto, mantenha uma condição inalterada	Mantenha em segurança e proteja de danos, deterioração, perda ou destruição.
resultado ou resultado de uma causa ou condição anterior	o resultado de um evento, especialmente como em relação a um indivíduo.
considere algo provável ou razoável que aconteça	considere algo provável ou provável.
um aumento de tamanho conforme medido por unidade de tempo	A taxa de aumento do tamanho por unidade de tempo.
ter um grande carinho, gostar ou desejo por	ter um grande carinho ou gosto.
Mantenha algo ou alguém sob controle; Pare de acontecer algo	Pare por um momento, como se fosse por incerteza ou cautela.
Descubra ou determine, talvez após um cálculo ou investigação.	Descubra, aprenda ou determine com certeza, geralmente fazendo uma investigação ou outro esforço.
algo que serve para sugerir um certo fato.	algo que serve para indicar ou sugerir.
Uma taxa cobrada pelo uso de estradas ou pontes.	Uma taxa cobrada pelo uso de estradas ou pontes (usadas para manutenção).
Obtenha de um dispositivo de armazenamento, como das informações em um computador.	obter ou recuperar de um dispositivo de armazenamento; até a informação em um computador.
repita ; restabelecer ou começar de novo	Restar em uma nova, geralmente melhorada, com base ou faça novas ou como novas.
Computadores: obter dados / imagens de fitas magnéticas ou com um feixe de luz	Obtenha dados de fitas magnéticas.
Melhore ou perfeito, polindo, podando ou tornando mais conciso.	melhorar ou perfeito por poda ou polimento.
significar ou médio de expressar ou transmitir	média ou pretendo expressar ou transmitir.
ataque pesadamente, especialmente com um punho ou implementação.	atacar pesadamente, especialmente com o punho ou um bastão.
um projétil autopropulsionado impulsionado por propulsor independente	Qualquer veículo autopropulsionado por um motor de foguete.
quebrar ou se separar de repente e com força; separar ou fazer se separar; vá em pedaços.	separar ou fazer se separar abruptamente.
causa para corresponder (idéias ou atos); ser compatível	causa para corresponder, por idéias ou atos.
(causa para) estar firmemente preso ou fechado.	causa para ser firmemente ligado.
um gráfico ou mapa mostrando as dimensões, movimentos ou progresso de algo	um gráfico ou mapa mostrando os movimentos ou progresso de um objeto.
Identificar, estabelecer localização ou identidade	reconhecer como ser; Estabeleça a identidade de alguém ou algo.
coloque ou coloque em, entre ou entre	coloque ou introduza algo.
uma pessoa ou coisa no papel de substituir outra coisa	uma pessoa ou coisa que toma ou pode tomar o lugar de outra.
Divisão de uma universidade que oferece diploma além do diploma de bacharel	Uma escola em uma universidade que oferece um estudo que leva a diplomas além do diploma de bacharel.
subsistir em um subsídio ou suprimento escasso.	subsistir em um subsídio escasso.
fornecer, arrecadar ou fornecer fundos para	obter ou fornecer dinheiro para.
um funcionário com responsabilidade de supervisionar algum domínio da atividade social	um oficial responsável pelo controle e supervisão de uma determinada atividade ou área de interesse público.
o ato de criar trabalhos escritos.	a atividade de colocar algo em forma escrita.
levar ou capturar por força ou autoridade	Pegue ou capture por força.
Vá depois com a intenção de seguir ou pegar.	Vá depois com a intenção de pegar.
uma campanha oficial contra um dano social percebido	Uma campanha concertada para acabar com algo prejudicial.
Remova penas, poços, conchas, pele, cascas	Remova conchas ou cascas de.
Disposição agressiva em lutar, pugnacity	uma disposição agressiva de competir.
Pate ou aperte, especialmente sob o queixo.	Dê um tapinha ou aperte com carinho ou de brincadeira, especialmente sob o queixo.
Dê uma aparência interessante para, arrumado	Dê uma aparência interessante para.
o contorno espacial e geométrico de um objeto	o conjunto de elementos comuns a dois ou mais conjuntos.
a ativação fisiológica de um organismo ou órgão	Resista imunologicamente, a introdução de algum tecido ou órgão estranho.
defensor, defensor de algo ou alguém	o ato de contratar algo ou alguém.
inventar algo fictício ou falso	inventar algo artificial ou falso.
regular ou definir a hora de (um relógio)	Ondulando na forma de uma nuvem.
o ato de substituir uma coisa por outra	o ato de testar algo.
a principal parte de algo	a primeira parte ou seção de algo.
o estado de estar em contato	o estado de estar ativo.
medir o tempo ou duração de	deixar fraco atropelando o crescimento ou desenvolvimento de.
Crie um curto elétrico em algo.	o ato de parar de algo.
Mova -se ou faça com que se mova com um movimento repentino e espumoso.	puxe ou mova -se com um movimento repentino.
a seção final de uma comunicação	a última seção de uma comunicação.
estágio final de um evento ou atividade	Faça um retiro de um compromisso ou atividade anterior.
o ato de governar, administrar	o ato de libertar alguém ou algo.
o ato de se mover, girando algo	o ato de reter algo.
o estado de ser retido	o estado de ficar com raiva.
Segure em um determinado estado ou situação	Crie e carregue com uma tarefa ou função.
O ato de preparar uma preparação em algo.	o gerenciamento de alguém ou algo.
Mergulhe (como se) com uma esponja.	arremesso como se com uma funda.
Registre -se formalmente como participante	Registre -se formalmente como participante ou membro.
o ato de criar trabalhos escritos.	um ato de atrasar ou interromper a continuidade.
o estado de ter opções, alternativas	o ato de admitir alguém para entrar.
a atividade de examinar ou avaliar algo	o ato de reter algo.
o ato de prever ou prever algo	o ato de diminuir ou reduzir algo.
o ato de ocultar ou disfarçar	o estado de inatividade após uma interrupção.
o ato de fornecer ajuda ou ajuda a alguém	o ato de olhar ou ver ou observar.
o estado de ser retido	o traço de ser bem comportado.
Forneça gratificação sexual por meio de estimulação oral.	Obtenha gratificação sexual através da auto-estimulação.
aja ou faça algo em reação a algo	os restos de algo que foi destruído ou quebrado.
a qualidade de ser útil para algo	O ato de mudar uma coisa para outra coisa.
proteger com ou como se com um escudo	separado com ou como se com um instrumento.
declarar inválido; Tire a força legal de ou tornar ineficaz.	Tire a força legal de ou tornar ineficaz.
vincular alguém ou se vinculado emocionalmente	estar em algum estado ou condição especificada.
Assimilar na mente ou em uma situação	levantar e redefinir em outro solo ou situação.
o ato humano de fazer algo novo.	o ato de fala de tornar algo evidente.
Aumente com algo desagradável	Aumente algo ou alguém desagradável.
a maneira pela qual algo ou alguém funciona ou opera	o ato de forçar algo a espremer ou pressionar.
Localização protegida do vento	uma parte removida do todo.
o ato de escolher ou selecionar	o ato de olhar ou ver ou observar.
Mova -se ou faça com que se mova com um movimento repentino e espumoso.	Mova -se ou faça com que se mova com um movimento repentino de brilho.
o ato de omitir intencionalmente algo	tem sabor; gosto de algo.
o barulho de algo batendo contra uma superfície	o ato de aplicar tinta a uma superfície.
(causa para) formar um cluster no espaço abstrato ou físico.	causar, no sentido abstrato ou no sentido físico.
inclinar de uma posição vertical	para inclinar ou dobrar de uma posição vertical.
o ato de se mover, girando algo	o ato de passar de um estado ou lugar para o outro.
fazer uma incisão ou separação	Tome medidas em preparação para.
um caminho linear estabelecido de viagem	uma linha estabelecida de viagem ou acesso.
Comporte -se de uma certa maneira, usu. alegre	se comportar de uma certa maneira.
Torne mais puro, mais intenso, como pela remoção de elementos estranhos	Faça sujo ou irregular, como a exposição ao ar; também usado metaforicamente.
o contorno espacial e geométrico de um objeto	o ato de fala de objetar.
uma dificuldade física ou obstáculo	Obtenha apesar das dificuldades ou obstáculos.
cumprir: Aja de acordo com as regras, comandos ou desejos.	Aja de acordo com as regras, comandos ou desejos de alguém.
quero, desejo ou perfer fazer algo	um desacordo ou argumento sobre algo importante.
Olhe ou observe algo ou alguém	A aparência visual de algo ou alguém.
a natureza, composição ou constituição de algo	Mude a natureza, propósito ou função de algo.
entenda, dê sentido a	entenda; atribua um significado a.
mova, transfira ou carregue algo ou alguém	um meio ou agência pela qual algo é expresso ou comunicado.
o estado de ser retido	o estado de estar em vigor ou ser operativo.
o ato de fornecer ajuda ou ajuda a alguém	o ato de perceber o odor de algo.
Fazenda: Organize o trabalho contratado a ser feito por outros.	organizado para que o trabalho contratado seja feito por outros.
Aperte (como se) com um rebite ou rebite.	Crie e carregue com uma tarefa ou função.
porque ficar imerso em	causa para ser firmemente ligado.
o ato de se mover, girando algo	o ato de descrever algo.
construir, fazer combinar materiais ou peças	Faça combinar materiais e peças.
(causa para) acontecer posteriormente	onde você mora em um determinado momento.
o ato de preservar ou proteger algo	o ato de colidir com algo.
o ato de preservar ou proteger algo	o ato de rejeitar algo.
(causa para) tornar -se menos tenso; Descanse ou pegue uma facilidade.	Torne -se menos tenso, descanse ou tenha uma facilidade.
o ato de chegar a um determinado lugar	a ocorrência de uma união de partes separadas.
o ato de agarrar os braços de um	a característica de desperdiçar recursos.
um estado de estar cercado	o estado de ser excomungado.
inclinar de uma posição vertical	para inclinar ou dobrar de uma posição vertical.
(causa para) ser superado com medos repentinos	para reunir ou combinar ou com outra coisa.
Deixe desfeito ou deixe de fora	encerrar, terminar ou retirar.
Mudando uma coisa para outra	o ato de mudar uma coisa ou posição para outra.
Reduza para pequenos pedaços batendo ou moendo.	Reduza para pequenos pedaços ou partículas batendo ou abrasando.
colocar ou manter em uma barraca	trazer para um estado diferente.
a coisa apropriada ou desejável.	a parte superior de qualquer coisa.
o ato de ocultar ou disfarçar	o ato de recorte ou correr.
uma caracterização visual de algo	uma representação visual de algo.
lidar fisicamente com um oponente	um círculo exclusivo de pessoas com um propósito comum.
o perfume ou odor de algo	o ato de aplicar força para impulsionar algo.
o ato humano de fazer algo novo.	o ato de quebrar alguma coisa.
(causa) separar ou mover em direções diferentes	causar separar e seguir direções diferentes.
um estado ou ato de ganhar prazer	o ato de gastar ou desembolsar dinheiro.
Mude o significado das palavras (de alguém) com a intenção de enganar.	Faça uma cópia com a intenção de enganar.
o ato de preservar ou proteger algo	o ato de testar algo.
Aumente com algo desagradável	Aumente algo ou alguém desagradável.
o ato de avaliar, criticar algo	O ato de pegar um objeto com as mãos.
(causa para) aparecer de repente ou brevemente	porque acontecer ou ser responsável.
agir ou se comportar de uma certa maneira	obrigar a se comportar de uma certa maneira.
o estado de ser retido	o estado de estar ativo.
uma instância ou ação de estar incorreto.	mostrar consideração por; leve em consideração.
o ato de expressar aprovação, apoio a algo	o ato de diminuir algo acentuadamente.
o ato de colocar algo para usar.	a atividade de proteger algo contra perda ou perigo.
desencorajar ou assustar com ameaças ou de maneira dominadora; intimidado; Seja mandão em relação a alguém.	desencorajar ou assustar com ameaças ou de maneira dominadora; intimidado.
sacrifício ou pedágio necessário para alcançar algo	uma avaliação do valor de algo.
o ato de defender ou promover algo	o ato de tomar uma pessoa pela força.
o estado de ser empregado	o estado de ser excomungado.
a qualidade de ser útil para algo	a qualidade de não ser útil ou conveniente.
uma pessoa que memoriza ou aprende rapidamente	uma pessoa que se junta a outras pessoas em alguma atividade ou esforço.
o estado de ter o peso de um suportado	o estado de estar conectado.
o ato de prever ou prever algo	o ato de levantar algo.
dar um relato detalhado de	narrar ou dar um relato detalhado de.
uma experiência emocionante ou estimulante.	o ato de construir algo.
o ato de prever ou prever algo	o ato de escalar algo.
o ato de incentivar alguém	o ato de danificar algo ou alguém.
o ato de colocar algo para usar.	o ato de testar algo.
a raiz ou a forma base de uma palavra	A remoção da peça de um oponente do tabuleiro de xadrez.
ser ou entrar em conflito	originar ou surgir.
tornar ou tornar -se mais agudo ou intenso	fazer ou tornar -se mais estreito ou restrito.
Mova -se ou organize -se (OneSeLves) em uma posição confortável e aconchegante.	Mova -se ou organize -se em uma posição confortável e aconchegante.
literalmente porque se tornar incapaz de ver.	vincular por uma obrigação; causa para ser endividado.
atrair; causa para ser apaixonado pela natureza (uma).	matéria que foi depositada por algum processo natural.
Representação visual esboçada à mão	uma representação visual de algo.
uma pessoa que é membro do Senado	uma pessoa que é membro de uma parceria.
cubra ou de volta com papel alumínio.	comunicar ou sinalizar com uma bandeira.
o estado de estar satisfeito com a vida.	o estado de se unir ou unido ou vinculado.
Olhe ou observe algo ou alguém	o ato de contratar algo ou alguém.
Dê uma aparência interessante para, arrumado	Dê uma aparência interessante para.
uma abundância ou profusão de algo	colocar sob suspeita ou lançar dúvidas.
solicitar ou exigir uma resposta de alguém; desafie alguém	Faça um pedido ou demanda por algo para alguém.
o ato de se mover, girando algo	O ato de decidir sobre algo.
o estado de ser empregado	o estado de ser esgotado.
estabelecido como uma introdução ou prefácio	Mexa os sentimentos, emoções ou paz de.
o ato de ocultar ou disfarçar	o ato de fornecer um subsídio.
o ato de começar algo novo.	o ato de rejeitar algo.
(causa) separar ou mover em direções diferentes	causar separar e seguir direções diferentes.
viver nos arbustos como fugitivo ou guerrilha	declarar na capacidade de um árbitro ou árbitro.
o ato de comprar de volta algo vendido anteriormente.	o ato de danificar algo ou alguém.
Traga, liderar ou forçar a abandonar um caminho ou estilo de vida maligno e adotar um curso de ação correto.	Traga, liderar ou forçar a abandonar um curso errado ou mau da vida, conduzir e adotar uma certa.
(causa para) executar em um ritmo moderadamente rápido.	Corra em um ritmo moderadamente rápido.
(causa para) conhecer ou cruzar	causa para fazer um som de estalo.
liquidar ou lidar com algo	coloque ou introduza algo.
causa para passar de um curso ou usar para outro	Envie de uma pessoa ou lugar para outra.
Pesquise (como o fundo de um corpo de água) por algo	Pesquise (como o fundo de um corpo de água) por algo valioso ou perdido.
perceba e lamenta a ausência de algo ou alguém	Uma restrição que verifica o movimento de algo.
siga o próprio caminho ou outro	siga o próprio caminho; se separar.
o estado de estar em contato	o estado ou fato de ser proprietário.
o ato ou meio de se livrar de algo.	o ato de remover ou se livrar de algo.
estabelecido como uma introdução ou prefácio	Defina ou peça um determinado preço.
indenização por uma conexão social ou gravata	livre de obrigações ou deveres.
o ato humano de fazer algo novo.	o ato de fala de tornar algo evidente.
o estado de ser retido	o estado de ser rejeitado.
uma instância ou ação de estar incorreto.	O espaço onde ocorre uma divisão ou despedida.
Entregue as mercadorias: alcançar o sucesso, atingir uma meta	alcançar o sucesso ou atingir um objetivo desejado.
o ato de prejudicar ou magoar alguém	o ato de danificar algo ou alguém.
dar um relato detalhado de	narrar ou dar um relato detalhado de.
a pulsação do coração	peça (algo antigo) com uma nova parte.
se comportar ou se mover de uma certa maneira	ser digno de ou ter uma certa classificação.
mover ou executar muito rapidamente ou apressadamente	Corra ou mova -se muito rapidamente ou apressadamente.
inferir ou acreditar ser o caso	Acredite ser o caso.
uma borda ou limite de um objeto	Planeje, organize e realize (um evento).
o ato de incentivar alguém	o ato de perder alguém ou algo.
o ato de começar algo novo.	o ato de diminuir algo acentuadamente.
administrar ou conceder como porções	Administre ou conceda, como em pequenas porções.
implorar; Peça algumas informações ou ações.	o ato de passar algo para outra pessoa.
o ato de indicar ou apontar pelo nome.	o ato de gastar ou desembolsar dinheiro.
o ato de começar algo novo.	o ato de parar de algo.
mover de um local para outro	Mova de um lugar para outro.
estabelecido como uma introdução ou prefácio	Exponha ao ar frio ou frio para esfriar ou refrescar.
a ação de colocar ou situar um objeto	o ato de escolher ou selecionar.
O ato de preparar uma preparação em algo.	o ato de quebrar alguma coisa.
o estado de ser retido	o estado de estar conectado.
uma conseqüência, resultado ou resultado de algo	Tenha um desacordo sobre algo.
o ato de confinar, prevenir ou bloquear algo	O ato de mudar uma coisa para outra coisa.
o ato de preservar ou proteger algo	o ato de aplicar força para impulsionar algo.
diminuir em vigor, impacto ou efeito	diminuir em força ou efeito.
o ato de acusar alguém ou algo por ser culpado	Entre na posse de algo concreto ou abstrato.
uma justificativa ou razão para algo	Uma relação que fornece a base para alguma coisa.
solicitar ou exigir algo de alguém	o ato de danificar algo ou alguém.
Registre -se formalmente como participante	Registre -se formalmente como participante ou membro.
o ato de girar, girar um objeto	a característica de desperdiçar recursos.
forma definidora ou forma distinta de algo	um atributo proeminente ou aspecto de algo.
Aperte-se- (porque) chegar ao chão	causa para chegar ao chão.
expulsar ou ejetar (saliva, fleuma, escarro ou vômito) da boca.	expulsar ou ejetar (saliva ou fleuma ou escarro) da boca.
uma agregação de coisas ou pessoas	A aparência visual de algo ou alguém.
traçar a forma ou esboço de	Altere o arranjo ou a posição de.
o ato de preservar ou proteger algo	o ato de afirmar, afirmar ou declarar alguma coisa.
o ato de preservar ou proteger algo	o ato de diminuir ou reduzir algo.
manipular ou mover algo para operar.	agir ou mover em alta velocidade.
o processo de se tornar menos ou menor	o processo corporal de descarregar resíduos.
o estado de ser retido	o estado de ser real ou real.
suba ou cheia para cima sob uma força natural, como uma onda.	suba ou suba para cima sob a influência de uma força natural, como uma onda.
fazer uma proposta ou proposta para um fim específico em vista	fazer um canal para; fornecer um canal.
a atividade de examinar ou avaliar algo	o ato de gastar ou desembolsar dinheiro.
Combine para formar um produto mais complexo	Combine para formar um todo; misture.
Entenda o significado de algo.	Obtenha o significado de algo.
a qualidade do sabor de algo	um pedaço de algo estreito relativamente longo.
estimar ou calcular o valor numérico de algo	Observe ou plote o caminho em movimento de algo.
Coloque em uma posição perigosa	Coloque em uma posição horizontal.
uma loja ou suprimento de algo	um suprimento grande ou extra de algo.
Entenda o significado de algo.	Organize (a produção de algo) em uma indústria.
uma lote ou porcentagem de algo	uma avaliação do valor de algo.
o ato de ocultar ou disfarçar	o ato de explodir ou explodir.
dar uma explicação enganosa para; cobrir	Dê uma explicação ou desculpa enganosa para.
tomar medidas legais contra, como no tribunal	Amarre ou prenda um nó.
o ato de procurar ou comprar bens ou serviços.	o ato de se ramificar ou se dividir em galhos.
traga uma certa pressão	trazer para um certo estado espiritual.
penetrar ou cortar com um instrumento nítido	Penenet -se ou corte com um instrumento nítido.
(causa para) executar em um ritmo moderadamente rápido.	causar sofrimento corporal e ficar doente ou indisposto.
A maneira como algo está em conformidade com uma forma	Como algo é feito ou como isso acontece.
perceba e lamenta a ausência de algo ou alguém	um julgamento das qualidades de algo ou alguém.
Faça receptivo ou disposto a uma ação ou crença.	Faça receptivo ou disposto a uma ação, atitude ou crença.
um agente ou empresa que assegura algo	Uma tentativa enérgica de alcançar algo.
o evento de propor ou ser voluntário algo	o ato de rejeitar algo.
Remova de um local ou do escritório	Retire de um concurso ou corrida.
(causa para) tornar -se menos tenso; Descanse ou pegue uma facilidade.	Torne -se menos tenso, descanse ou tenha uma facilidade.
grátis (de restrição), solte	um ruído ressonante ressonante.
o ato de girar, girar um objeto	o ato de incomodar ou irritante alguém.
Remova para ou para um lugar ou situação	Remova ou force de uma posição.
o ato de começar algo novo.	o ato de quebrar alguma coisa.
a qualidade da luz aumentada em áreas de um objeto	a atividade de proteger alguém ou algo.
ato de mover ou transmitir algo	o ato de diminuir ou reduzir algo.
o ato de preservar ou proteger algo	a atividade de fornecer ou fornecer algo.
o ato de colocar algo para usar.	o ato de testar algo.
Desenhe um cruzamento no ar sobre algo	Obtenha o significado de algo.
o ato de levar à força a oposição	o ato de forçar o inimigo a se retirar.
o ato de escolher ou selecionar	o ato de enrolamento ou torcer.
Projete alguém a fazer algo (muitas vezes exagerado ou falso) promessas ou persuasão.	Projete alguém a fazer algo (muitas vezes falso ou exagerado) promessas ou persuasão.
Recuse -se a reconhecer algo como válido (não uma pessoa).	o poder de usar algo ou alguém.
uma indicação de algo, evidência	a divulgação de algo em segredo.
o ato de melhorar a qualidade de algo	o ato de começar algo.
Crie uma nova entidade juntando componentes ou membros	Crie juntando componentes ou membros.
Pequena placa de metal no dedo do pé de um sapato de dança	algo que flutua na superfície da água.
o ato de acusar alguém ou algo por ser culpado	o ato de colocar algo em ordem de funcionamento novamente.
o estado de estar em contato	o estado de ser excluído.
quantidade que pode ser contida	a quantidade que pode ser contida.
Coleção de nomes e endereços para servir como destinatários do conteúdo da informação	A parte do público em geral interessado em uma fonte de informação ou entretenimento.
vire, torça ou prenda (como se) com um parafuso	Retire ou suba com ou como se com uma colher.
o ato de prever ou prever algo	o ato de se projetar de alguma coisa.
Torne -se ou porque seja obstruído	Torne -se ou porque se torne macio ou líquido.
ter meios financeiros para obter, comprar ou fazer algo	A estrutura anexante em torno de uma porta ou janela se abre.
o ato de levar à força a oposição	o ato de quebrar algo.
o ato humano de fazer algo novo.	o ato de levantar algo.
Aumente com algo desagradável	Aumente algo ou alguém desagradável.
(causa para) acontecer posteriormente	causa para pular sobre uma superfície.
uma porção pequena e indefinida de algo	madeira serrada usada na construção de algo.
ser dado a, entre na posse de	entrar na posse de.
Aumente com algo desagradável	Aumente algo ou alguém desagradável.
Faça um ruído esmagador, possivelmente como resultado de pressionar ou moer.	tem um intervalo; Seja capaz de projetar a uma certa distância, a partir de uma arma.
coloque ou deite como se estivesse em uma pilha	incluir em ou como se estivesse em um quadro.
o ato de esfregar uma superfície	o ato de aplicar tinta a uma superfície.
Mova -se ou organize -se (OneSeLves) em uma posição confortável e aconchegante.	Mova -se ou organize -se em uma posição confortável e aconchegante.
Recuse -se a reconhecer algo como válido (não uma pessoa).	o ato de fala de tornar algo evidente.
o ato de confinar, prevenir ou bloquear algo	o ato de referir ou consultar.
o ato de escolher ou selecionar	o ato de começar algo.
o ato de colocar algo para usar.	o ato de colocar algo em algum lugar.
conhecer ou encontrar a capacidade social ou profissional	Obtenha ou extorque (dinheiro ou outras posses) de alguém.
o contexto ou cenário em que algo ocorre	o ato de começar algo.
o estado de ser retido	o ato de quebrar alguma coisa.
avançar ; contribuir para o progresso ou crescimento de.	contribuir para o progresso ou crescimento de.
causar ou tornar -se estado acessível, tornar ou ficar disponível	causa para experimentar ou sofrer ou tornar responsável ou vulnerável.
Remova de um local ou do escritório	remover da memória ou existência.
o ato de preservar ou proteger algo	o ato de levantar algo.
recuperar ou encontrar de volta; recuperar	recuperar ou encontrar de volta; recuperar o uso de.
considere algo provável ou razoável que aconteça	Mudar em direção a algo menor ou menor.
Um objeto prejudica a respiração de alguém ou algo.	uma vantagem para o benefício de alguém ou algo.
realizar ou completar uma atividade	realizar ou executar uma ação.
cair, afundar ou se acalmar ou como se fosse por pressão ou perda de tautura; Torne -se menos intenso.	cair, afundar ou se acalmar ou como se fosse por pressão ou perda de tautura.
causa para passar de um curso ou usar para outro	Causa (um líquido) para lixiviar ou percolar.
(causa para) aparecer de repente ou brevemente	causa para aparecer em um novo formulário.
o ato de prejudicar ou magoar alguém	o ato de desenhar ou transportar algo.
o ato de se mover, girando algo	o ato de construir algo.
o ato de preservar ou proteger algo	Faça um esboço ou esboço para alguma coisa.
(causa para) se separar, separar ou dividir	causar para ficar agitado, excitado ou despertado.
Remova de um local ou do escritório	Retire de um concurso ou corrida.
dar um relato detalhado de	narrar ou dar um relato detalhado de.
o ato de virar um objeto no ar	o ato de rasgar, rasgar ou dividir alguma coisa.
o ato de preservar ou proteger algo	o ato de escolher ou selecionar.
o ato de protestar, dissidente	o ato de quebrar alguma coisa.
a atividade de fingir ser alguém ou outra coisa	a atividade de proteger alguém ou algo.
fazer uma imagem ou parecer mais claro; colocar em foco	Faça uma bagunça ou crie desordem.
o ato de girar, girar um objeto	O ato de pegar um objeto com as mãos.
o ato de avaliar, criticar algo	o ato de diminuir ou reduzir algo.
(causa para) executar em um ritmo moderadamente rápido.	Corra em um ritmo moderadamente rápido.
passar o tempo em um determinado lugar ou maneira	Atribua uma nova hora e local para um evento.
(causa para) ser coberto com alguma coisa.	dê crédito a alguém por alguma coisa.
(o ato de fazer) uma medição de algo.	o estado de não ter certeza de algo.
Escreva todas as informações necessárias	Escreva todas as informações necessárias em um formulário.
estado abrupto de descrença sobre algo	o ato de escolher ou selecionar.
o ato de ocultar ou disfarçar	o ato de formar ou estabelecer algo.
a causa ou instigação de algo	o fim ou a conclusão de algo.
Perca a clareza ou se afaste, especialmente do assunto principal de atenção ou curso de argumento.	Perca a clareza ou se afaste, especialmente do assunto principal de atenção ou curso de argumento por escrito, pensamento ou falando.
um contexto ou situação que impede ou impede	Um aspecto negativo de algo que geralmente é positivo.
Crie um curto elétrico em algo.	tenha uma discussão sobre algo.
Tenha uma tez com uma cor forte e forte; refletir emoção através da tez de um.	Tenha uma tez com uma cor forte forte, como vermelho ou rosa.
atribuir ou colocar em associação com	estar ou agir em associação com.
uma estrutura de plantas perto do topo da planta.	uma forte corrente de ar.
o ato de esfregar uma superfície	o ato de dar assistência temporária.
o ato de prever ou prever algo	o ato de começar algo.
quantidade que pode ser contida	a quantidade que pode ser contida.
extremidade arredondada de um osso	Coloque na mente de alguém.
a ação de colocar ou situar um objeto	a condição de viver ou o estado de estar vivo.
o ato de prejudicar ou magoar alguém	o ato de dificultar, obstruir ou impedir.
administrar ou conceder como porções	Administre ou conceda, como em pequenas porções.
a afirmação de uma proposta oferecida como verdadeira	A ação de se opor a algo que você desaprova ou discorda.
o ato de entrar em uma estrutura	o estado de ser real ou real.
o ato de preservar ou proteger algo	o ato de acabar com algo.
uma área central em alguma região maior.	uma área que é aproximadamente central em alguma região maior.
Reduza o preço de algo	A taxa de algum evento repetido.
uma instância ou ação de estar incorreto.	o status ou fato de ser eleito.
o estado de estar em ordem de funcionamento	o estado de ser real ou real.
o estado de ser retido	o estado de estar conectado.
a ação de colocar ou situar um objeto	uma formação de pessoas ou coisas um ao lado de outra.
o ato de recrutar soldados para um exército	o ato de competir como lucro ou prêmio.
o ato de prever ou prever algo	o ato de parar de algo.
o estado de ser empregado	o estado de ser excluído.
ter em mente como um plano ou propósito	Limpe com uma esponja, para limpar ou umedecer.
o ato de protestar, dissidente	o ato de bater vigorosamente.
turma de estudantes ensinados juntos	um corpo de estudantes que são ensinados juntos.
avançar ; contribuir para o progresso ou crescimento de.	contribuir para o progresso ou crescimento de.
colocar em movimento ou mover para agir; tornar ativo ou mais ativo.	algo que serve como cobertura ou proteção.
o ato de cortar o comprimento, saindo	o ato de fazer ou promulgar leis.
o ato de se mover, girando algo	o ato de escalar algo.
(causa) separar ou mover em direções diferentes	causar separar e seguir direções diferentes.
cubra com uma base de primer	Mova -se com um movimento de debulhagem.
o estado de ter opções, alternativas	o ato de chegar à terra após uma viagem.
o ato de preservar ou proteger algo	o ato de perceber o odor de algo.
se comportar ou se mover de uma certa maneira	se comportar de uma certa maneira.
a essência ou essência de algo	A desvantagem que resulta da perda de algo.
Prepare -se para / coloque em ação ou use	prepare -se para ação ou uso.
porque ficar imerso em	causa para se interessar ou curioso.
um tipo de aeronave militar	uma unidade de aeronave militar.
passar por penetrar ou permear	o ato de quebrar alguma coisa.
uma área de fronteira ou borda de algo	um exemplo concentrado de algo.
a atividade de examinar ou avaliar algo	o ato de designar ou identificar algo.
o ato de começar algo novo.	o ato de acabar com algo.
a qualidade da luz aumentada em áreas de um objeto	a data em que uma obrigação deve ser paga.
unir; fundir -se com algo já existente	Aumente algo ou alguém desagradável.
o ato de se mover, girando algo	o ato de remover ou se livrar de algo.
o estado de ser retido	o estado de ser suspeito.
o ato de governar, administrar	A taxa de mudança (especialmente caminhada ou corrida).
a qualidade de ser útil para algo	O ato de decidir sobre algo.
o ato de escolher ou selecionar	o ato de levantar algo.
estar em contato físico direto com	estar em contato físico direto com; faça contato.
o local dentro do qual uma autoridade tem poder	o ato de adicionar uma coisa a outra.
a principal parte de algo	o maior grau possível de algo.
Marque ou cubra com ou como se com pontos	cubra com ou como se estivesse com uma capa.
o ato de colocar algo para usar.	o ato de começar algo.
vômito, de maneira controlada ou não controlada.	algo copiado ou derivado de um original.
O ato de preparar uma preparação em algo.	A aparência geral externa de algo.
o ato de defender ou promover algo	o ato de levantar algo.
(causa) separar ou mover em direções diferentes	causar separar e seguir direções diferentes.
o ato de colocar algo para usar.	O caminho seguido por um objeto que se move pelo espaço.
um terminal espacial ou mais limite de algo	Uma relação que fornece a base para alguma coisa.
o ato de substituir uma coisa por outra	O ato de entrar em contato com uma coisa com outra.
o ato de preservar ou proteger algo	o ato de diminuir ou reduzir algo.
o ato de ocultar ou disfarçar	o estado de ser excluído.
o ato de aplicar tinta a uma superfície	o ato de virar uma moeda.
se comportar ou se mover de uma certa maneira	se comportar de uma certa maneira.
Reduza para pequenos pedaços batendo ou moendo.	Reduza para pequenos pedaços ou partículas batendo ou abrasando.
o ato de ocultar ou disfarçar	O ato de libertar uma cidade ou cidade que foi sitiada.
Coloque o creme, como no rosto ou no corpo de um.	Carregue, como está de volta.
defensor, defensor de algo ou alguém	A aparência visual de algo ou alguém.
avançar ; contribuir para o progresso ou crescimento de.	contribuir para o progresso ou crescimento de.
desgaste ou exibição, como em uma faceta de algo ou um artigo de roupa.	uma conseqüência dos esforços de alguém ou de um conjunto específico de circunstâncias.
mova -se e fique em uma posição específica	concentre -se em um determinado local ou local.
(causa) mover -se para frente e para trás ou de um lado para o outro	Mova -se para frente e para trás ou de lado.
Venda algo ou obtenha algo por atividade secreta.	Venda algo ou obtenha algo por atividade enérgica e especialmente secreta.
estado de não ser sem roupa, nua	o ato de escalar algo.
o barulho de algo batendo contra uma superfície	o evento de algo ardente (geralmente destrutivo).
o ato de prever ou prever algo	o ato de reter algo.
Forneça água para culturas, como nos canais, valas ou córregos.	Forneça com água, como com canais ou valas ou riachos.
arrancar ou capturar um objeto em movimento livremente	Procurando ou comprando bens ou serviços.
(causa para) tornar -se amplamente distribuído.	tornar -se ou causar para ser obstruído.
o ato humano de fazer algo novo.	o ato de fala de tornar algo evidente.
traçar a forma ou esboço de	mostre a forma ou esboço de.
oca na forma de um sulco ou ranhura.	Mova -se com ou como se com um ancinho.
o ato de comprar de volta algo vendido anteriormente.	o ato de explicar; tornando algo claro ou inteligível.
a atividade de examinar ou avaliar algo	o ato de formar ou estabelecer algo.
reclamar ; fale de maneira chorosa.	fale de maneira chorosa.
existem de uma certa maneira, modo ou estilo	o último ou o mais baixo em um pedido ou série.
o ato de prejudicar ou magoar alguém	o ato de escolher ou selecionar.
colhendo ou reunir produtos naturais	Reúna -se, a partir de produtos naturais.
Aumente com algo desagradável	Aumente algo ou alguém desagradável.
saturar ou inocular com uma substância.	faça uma marca ou linhas em uma superfície.
o ato de girar, girar um objeto	o ato de adicionar uma coisa a outra.
Faça faixas em uma superfície	faça uma marca ou linhas em uma superfície.
o ato de colocar algo para usar.	o ato de contratar algo ou alguém.
a identificação ou a realização de algo	O período que é considerado melhor para iniciar ou terminar algo.
Para se preparar, encaixe	prepare -se para ação ou uso.
o ato de omitir intencionalmente algo	o ato de rasgar, rasgar ou dividir alguma coisa.
o ato de substituir uma coisa por outra	o ato de adicionar uma coisa a outra.
causa para avançar com força.	variar ou passar de um ponto ou curso fixo.
a maneira pela qual algo ou alguém funciona ou opera	a quantidade pela qual algo diminui.
ferir girando ou girando	Mova -se virando ou girando.
o ato de prever ou prever algo	o ato de diminuir ou reduzir algo.
causa para estar em um estado ou local	Coloque em um determinado local ou localização abstrata.
proteger com ou como se com um escudo	Mantenha com ou como se com uma aposta.
o ato humano de fazer algo novo.	o ato de levantar algo.
a seção final de uma comunicação	a última seção de uma comunicação.
a coroa de uma planta de floração	a redução do valor ou valor de algo.
quero, desejo ou perfer fazer algo	Prefira ou deseja fazer algo.
a atividade de fingir ser alguém ou outra coisa	o ato de libertar alguém ou algo.
Forneça água para culturas, como nos canais, valas ou córregos.	Forneça com água, como com canais ou valas ou riachos.
o ato de combinar, misturar, integrar	(Teologia) o ato de Deus de trazer o universo à existência.
a atividade de fingir ser alguém ou outra coisa	o ato de danificar algo ou alguém.
o ato de prejudicar ou magoar alguém	o ato de danificar algo ou alguém.
Aumente com algo desagradável	Aumente algo ou alguém desagradável.