A educação global on -line é a chave para democratizar o acesso à aprendizagem e superar males sociais, como a pobreza -	Colunista de Op-Ed: Revolução atinge as universidades
Hollywood aceita a censura chinesa (os filmes melhorarão?)	Nos filmes de Hollywood para a China, os burocratas querem dizer uma opinião
# Bloomberg: Pub de venda de armas de assalto. Inimigos 1 e 2 De acordo com o prefeito menor: Big Gulps e # armas. # OCRA	Bloomberg: a proibição de armas de assalto é uma venda difícil
O carro -bomba detona fora # Agência de Inteligência Afegada; Toll de vítima não está claro.	poderoso carro -bomba explode fora da agência de inteligência afegã
O que está em Feinstein's Gun Bill - # tgdn # pjnet	O que está na conta de Feinstein?
Linda Greenhouse: Roe v. Wade foi DRS enfrentando a acusação por agir no que eles viam como os melhores interesses dos pacientes	Opinisteiro: conceitos errôneos sobre Roe v. Wade
Medidas especiais para a poluição de Pequim:	Cobertores de nuvem de fumaça Pequim
Synthax _ Terror 2 ::	'American Taliban' ganha o direito de agrupar a oração
as perguntas que Oprah deveria ter perguntado a Lance Amstrong	Perguntas difíceis para Lance Armstrong
CC ": pelo menos 90 mortos no Brasil Nightclub Fire"	Centenas mortas no incêndio da boate do Brasil
Não é uma lágrima aqui: as brigadas vermelhas Jagoff morre, ano mais velho que eu, foda -se:	Prospero Gallinari, um terrorista, está morto aos 62
Tantos lugares para ir ...	os 46 lugares para ir em 2013
Enquanto # California se recupera, o governador pede objetivos elevados	Com a recuperação da Califórnia, o governador empurra grandes projetos
NYTIMES: # Leishmaniose: um # Link genético encontrado em vítimas distantes de uma forma letal de uma doença parasita	Atualização global: um link genético encontrado para vítimas de forma letal de leishmaniose
Jesus ... pelo menos 245 mortos enquanto o fogo varre a boate no Brasil.	pontuações mortas enquanto o incêndio varre a boate no Brasil
Então a empresa louca, não é isso o que a maioria das empresas está fazendo?	nós. Man terceiriza emprego na China, surfs gatos vídeos
Apontar # Stopgunviolence # Congress # NRA	Obama, política de armas e N.R.A.
# NRA libera o aplicativo de tiro de destino, hmm, espere um segundo ..	NRA desenha calor para o jogo de tiro
Membros quebrados, vive em Northern # Mali # Africa # conflito # Humanrights	membros quebrados, vidas rasgadas no Mali
Slams convidado sobre AR-15s	Piers, convidados colidem com os AR-15s
Um caminhão de queijo marrom flamejante fechou um túnel rodoviário na Noruega do Ártico nos últimos seis dias.	Briefing mundial | Europa: Noruega: o fogo de queijo fecha o túnel
Abuso sexual comum, mas também a nossa incapacidade de enfrentar a faixa rodoviária de comportamentos comuns aos seres humanos um pedófilo à vista	Opinião: na Poly Prep, um pedófilo à vista de simples
O número de mortos sobe para 220 em # Brasil Nightclub Fire, diz oficial.	Centenas mortas no incêndio da boate do Brasil
(Eu o amo!!!!!) 10 razões pelas quais não podemos obter o suficiente - Gosling -	Por que não podemos obter o suficiente (duh!)
nós. A retirada é 'amor duro' para os afegãos	nós. 'amor duro' para tropas afegãs
NYTIMES: Andrew Revkin nos próximos passos para a China na limpeza da poluição.	traçando um caminho de pós -poluição para as cidades - de Londres, 1952, através de Pequim, 2013
O juiz Clarence Thomas quebra seu silencioso, a justiça que a cortesia não protegerá os direitos dos cidadãos.	Justiça Thomas quebra seu silêncio no tribunal
OTAN: A bateria de mísseis é aberta na fronteira síria, isso pode estabelecer uma cadeia indesejada de eventos aqui.	OTAN: bateria de mísseis patriota operacional na fronteira síria
O que há de errado com o Boeing Dreamliner? ". As companhias aéreas devem ser tão felizes!	O que há de errado com o Dreamliner?
Espero não estar juntos ": Richard Pryor e Dick Cheney Focus of Showtime Documentários"	Richard Pryor e Dick Cheney Focus of Showtime Documentários
Vamos passar por um marco este ano: a maioria dos peixes que comemos será criada na fazenda em vez de selvagem	Um marco aparece para peixes criados na fazenda
Design, design, design. ? nós ? Re no final da tecnologia sendo especial,? diz John Maeda.	Interrupções: Interrupções: o design está impulsionando a tecnologia para a frente
Artigo interessante sobre a página inicial da CNN. "Mickleson tem um ponto sobre os impostos".	Mickelson tem um ponto sobre os impostos
Fotos do dia: Paquistão, Síria, Indonésia, Alemanha, Phillipines e Mali.	Fotos do dia: Paquistão e outros lugares
Como # Vine Video pode mudar o Twitter # em	6 maneiras de os seis segundos de Vine podem mudar o Twitter
+ 1 mt? "Eu detesto escrever com .. uma espécie de fobia .. apenas uma espécie de masoquismo perverso me mantém nisso" Styron	? Cartas selecionadas de William Styron?
Esporte: o Monte Lance Armstrong confessa ao doping. Próximo passo? testemunhando contra os superiores no ciclismo.	Armstrong admite doping e diz que testemunhará contra funcionários do ciclismo
Bloomberg chips em um bilhão	A Bloomberg dá US $ 1,1 bilhão para a universidade
nós. A missão de resgate apoiada pelo governo da refém francesa na Somália falhou.	nós. apoiou o falhado do resgate de reféns na Somália na Somália
NYTIMES: Delhi é tão diferente de Steubenville, EUA?	Colunista de Op-Ed: Delhi é tão diferente de Steubenville?
Cardeal Mahony, abusador de liturgias e Shielder de abusadores de crianças. Tão triste e frustrante.	Mahony protegeu sacerdotes abusivos, os documentos mostram
"Tênis: Djokovic reivindica a australia Triumph Zmerchnews Dot Com"	Djokovic: 3 vitórias australianas
Man Capping morto no outono entre os carros do metrô	O trem mata o homem na estação de metrô da 125th Street
# Detalhes dos EUA ajudam em falha # resgate de reféns. # Somália # França	nós. apoiou o falhado do resgate de reféns na Somália na Somália
As vendas do Windows 8 da Microsoft estão OK, não é ótimo CNNMoney	As vendas do Windows 8 da Microsoft são grandes - mas não grandes o suficiente
O ativista da Internet # Aaronswartz, criador do # RSS, está morto em 26- suicídio. A pressão dos processos pendentes era demais?	Aaron Swartz, ativista da Internet, morre em 26
A verdade sobre publicidade ... A má publicidade existe. # mídia pr #	Talvez exista uma publicidade ruim
# Revolution atinge as # universidades por # Distância # Educação # Sustentabilidade	Colunista de Op-Ed: Revolução atinge as universidades
Vicki Huddleston: Por que devemos ajudar # salvar # Mali	Colaborador de Op-Ed: Por que devemos ajudar a salvar o Mali
Este é um artigo estranho. "Ray Kurzweil diz que vamos viver para sempre"	Conversa: Ray Kurzweil diz que nós? vou viver para sempre
Daannngg! ? : Lance Armstrong diz a Oprah que ele não poderia? Não ganhou 7 títulos de Tour de France sem doping?	Armstrong despojado de medalha olímpica
A Apple obtém um lucro de US $ 13,1 bilhões, vende 28 % mais iPhones e 48 % mais iPads. Merda de estoque 11 %	maçã ? Os lucros são planos e gotas de estoque
Quando começa a vida? O Hospital Católico argumenta que um embrião não é uma pessoa.	Os advogados do Hospital Católico argumentam que o feto não uma pessoa
Dois anos após a revolução egípcia ... os EUA erram no Egito novamente -	Opinião: os EUA erram no Egito, novamente
Depois que Armstrong admite doping 2 Oprah anos 2 atrasado, ele agora diz que testemunhará contra supostos funcionários doping	Armstrong admite doping e diz que testemunhará contra funcionários do ciclismo
Espere, subornar crianças é ruim? # NotMomoftheyearAfterall	Esta vida: modificando uma criança? S Comportamento sem recorrer a subornos? esta vida
# O novo # Videogame da Disney, via NYTIMES: VIDEO COMBRA OS MUNDOS DA DISNEY	Blog de decodificador de mídia: novo videogame apresenta a Disney e a Pixar Mash-ups
no canal Gowanus, um golfinho	Dolphin nadando no canal de Gowanus
O senador Schumer diz ele? está satisfeito com Chuck Hagel no Oriente Médio. Seu endosso deve resolver esse problema.	Schumer diz que ele? está satisfeito com Hagel no Oriente Médio
Produtor de vídeos populares relacionados a armas filmadas. Toda morte por arma é uma tragédia.	Produtor de vídeos populares relacionados a armas encontradas fatalmente filmadas
Interessante e sensível	Opinisteiro: quando eu estava fazendo as malas
Sinal de atendimento convencional inacessível e culturalmente incompetente? como ? Clínicas bodega? preencher vazios, as autoridades de saúde estão rasgadas	? Clínicas bodega? atrair interesse dos funcionários da saúde
Coliseu colorido de Roma	O Coliseu de Roma desiste de segredos
": Samsung lucro com recorde de US $ 6,6 bilhões"	O lucro da Samsung sobe para US $ 6,6 bilhões recordes
A polícia espanhola apreende itens destinados ao Irã. qu? Mal Rollo ...	A polícia espanhola diz que os itens apreendidos destinados ao programa nuclear do Irã
Esta é uma leitura incrível. # Howstuffworks NYTIMES: moedas, contas e dívida nacional	Economix Blog: Bruce Bartlett: Contabilidade de uma moeda de platina de US $ 1 trilhão
Fitness Center em um quarto de hotel	Atleta urbano: um treino de quarto de hotel de Nicole Glor
Estou surpreso com a falta de cobertura dos distúrbios da N Irlanda.	A polícia destaca canhão de água na Irlanda do Norte Riot
Saudis Defend # Execução da empregada srilanka	Saudis defender a decapitação de Maid
O pior tipo de mau julgamento voador. O avião de dublês mal perdeu duas pessoas solicita a sonda FAA.	Vídeo do avião de dublês mal perdeu duas pessoas solicita a sonda faa
na abordagem de FP de Hillary Clinton	Iht Rendezvous: A Doutrina Clinton da Política Externa Americana
Um insider retorna à política na Itália # MemofromRome # Politics	Berlusconi provoca eleições na Itália
Sinal do # Apocalypse: Voice de Charlie Brown preso, acusado. ?	Boa tristeza! Charlie Brown Ator cobrado
Uma história muito bem escrita: no metrô, uma voz para mexer a alma	Nos metrôs, Geechee Dan? S Voz agita a alma
CALÇÃO CES: Os jovens hoje são 'nascidos # móvel' # hitech	CES: os jovens são 'nascidos móveis'
O que impede que as pessoas possam morrer em casa não são suas necessidades médicas, mas as necessidades de seu # cuidador # hpm	O novo blog de velhice: o que você precisa para trazer seu ente querido para casa para morrer
nós. Os aviões de guerra entram na Somália Airspace MR. potus; Escreva outra carta e diga a francês que não estamos com vontade de bagunça.	nós. Planos de guerra entram no espaço aéreo somali
Mudança climática na CNN: Próximo passo: Discurso do Estado da União de Obama em 12 de fevereiro ....	Ativistas de mudanças climáticas para Obama: evite o Congresso
RSS e Reddit Co-Desenvolvimento Aaron Swartz comete suicídio	Ativista on -line Aaron Swartz comete suicídio
Charlie Brown Voice Ator cobrado	Boa tristeza! Charlie Brown Ator cobrado
NJFF está exibindo este filme em 26 de janeiro na Universidade Rutgers:	Nossa geração :? definido para a vida? Documentos Crise entre Baby Boomers
Dreamliner tendo um lançamento adequado. Quão difícil é isso para a Boeing?	aprofundando a crise para o Dreamliner
O que não sabemos está nos matando que a indústria de armas não pode lidar com a verdade.	Editorial: o que não fomos? Eu sei que está nos matando
Índia tinta: mulher estuprada por sete homens em Punjab, a polícia diz: A polícia disse no domingo que uma mulher de 29 anos havia sido ...	India Ink: Mulher estuprada por sete homens em Punjab, Índia, a polícia diz
# Fotos: # Kimjongun e suas forças do exército	Fotos: Kim Jong Un e seus militares
Oficial indonésio: vítimas de estupro aproveitam oh inferno não, eles não	o possível juiz sugere que as mulheres desfrutam de estupro
Então, espere, você acha que eu quero pesquisar # Facebook e usar o Bing como o backup? ha.	Bits Blog: Facebook revela uma nova ferramenta de pesquisa
ICYMI, o Facebook apresentou uma nova ferramenta de pesquisa hoje: "Pesquisa de gráfico"	Bits Blog: Facebook revela uma nova ferramenta de pesquisa
"Emergência humanitária", declarado por grupos de ajuda na Síria "	'Emergência humanitária' na Síria
presidente? Se ela quiser	Presidente Hillary Clinton? Se ela quiser
Eles merecem palavras tão desagradáveis.	Rangers quenianos caçadores caçadores que mataram 11 elefantes para marfim
Uma ótima peça na NYT Mag on Story, Lit e Media.	RIFF: Era uma vez, havia uma pessoa que disse? era uma vez ?
Revisão: Pesquisa de gráficos do Facebook não v. Útil - CNN "Apenas dois dos meus 526 amigos como gatos" ... diga não mais	Revisão: A pesquisa de gráficos do Facebook não é muito útil
Ucrânia assina a perfuração de gás de xisto com # shell em # Davos # Energy # Marketentry	Sigra da Ucrânia O acordo de perfuração com Shell for Shale Gas
pelos números: mulheres nos EUA nah militar não é boa ideia	por números: mulheres nos EUA militares
Tente algo novo em suas próximas férias.	Tours culinários exóticos ao redor do mundo
": Britney Spears chama o engajamento" Loool CNN relata isso? Para onde este mundo está indo?	Britney Spears, Jason Trawick chama o engajamento
Homem de cocô morto no outono entre os carros do metrô	O trem mata o homem na estação de metrô da 125th Street
Graças a Deus. ? : Homem acusado de assassinato na morte do médico da Filadélfia. ?	Homem acusado de assassinato na morte do médico, diz a fonte
adolescente assassinado na Cisjordânia pela força de ocupação militar israelense, dizem ativistas -	adolescente baleado na Cisjordânia por militares israelenses, dizem os ativistas
viver para comer ou comer para morar? Eu tomo o primeiro.	Big City: Nova geração confronta luxo inacessível de comida
aumentando sua resposta # gripe com # exercício	Exercício pode aumentar a potência da gripe
Os smartphones são controle remoto de vida -	Os smartphones agora podem administrar consumidores? vidas
Er Diab ... ": pelo menos 245 mortos no Brasil Nightclub Fire"	Centenas mortas no incêndio da boate do Brasil
Nomeações do Oscar de 2013: quem conseguiu	Oscar de 2013 acenos: quem foi desprezado?
NYT relata meu Intvu com Ehud Barak, links para o Daily Beast # WEF # Israel # IRAN # NUKES # War	Dicas oficiais de defesa de que Israel está recuando dos planos para atacar unilateralmente o Irã
condenado na Tailândia de * implicar * um insulto ao rei. ? Não houve menção ao rei? s nome no discurso. ?	Na Tailândia, uma definição mais ampla de royalties insultos
"Escape de La Crosse", os Preppers ao lado	os preppers do dia do juízo do dia do juiz de Nova York
Oprah pode salvar Lance Armstrong? Ela não está convencida # doprah	Mesmo Oprah pode salvar Lance Armstrong?
Notre Dame linebacker vítima de uma farsa do tipo gato?	Notre Dame linebacker diz que é vítima de farsa
Inspiração atlética da manhã (deixe todos competirem!): Caminho de forjamento para a linha de partida para atletas com deficientes mais jovens # nyt	Atletas deficientes se adequam, levantando questões de logística e justiça
Michael r. Bloomberg Credita # JohnshopkinsUniversity por transformá -lo em um líder	Em US $ 1,1 bilhão, a Bloomberg é o principal doador da universidade nos EUA.
Isso é ridículo. SHERIFF: Eu não aplico as leis de armas de Obama. realmente ?	O xerife Won Won 'T reforce as leis de armas' inconstitucionais '
Man terceiriza o próprio trabalho para a China	nós. Man terceiriza emprego na China, surfs gatos vídeos
Morsi? S insuficiários contra judeus em 2010 descobertos	Morsi? S insuficiários contra os judeus provocam preocupação
Os Thins não somam apenas quando a Coréia do Norte almoçou com sucesso um foguete agora que a América permite isso. ou eu sou ...	Como os principais gerais da América vieram endossar mulheres em combate
Você é uma # inspiração! # Keepfighting	as linhas de frente em luta pelas mulheres
Estudo: A desaceleração resistida pela faculdade melhor: melhor:	Estudo mostra o diploma universitário? S valor durante a crise econômica
tristeza . ": golfinhos presos em matrizes de canais poluídos de Nova York."	Dolphin preso no canal de Nova York Dies
"Erros podem ter exposto veteranos a vírus" uh oh ...	Erros de injeção de insulina podem ter exposto veteranos a vírus
Hoje eu aprendi "Atualmente, não existe uma lei federal que defina o tráfico de armas como um crime". Estou sem palavras.	O senador revela o projeto de lei para limitar os braços semiautomáticos
Presidente Obama se voltando para a ex-promotora Mary Jo White para ser Boss Securities and Exchange Commission (S.E.C.)	Mary Jo White para ser nomeado New S.E.C. chefe
uau . Uma breve mas reveladora peça no: um pedófilo à vista	Opinião: na Poly Prep, um pedófilo à vista de simples
Boa leitura ... Por que a rede sofre Aaron Swartz -	Por que World Grieves Aaron Swartz
Finalmente Armstrong admite doping e diz que testemunhará	Armstrong admite doping e diz que testemunhará contra funcionários do ciclismo
Ótimo artigo informativo que mostra a cooperação da PepsiCo com a resolução desse problema de saúde e colocando os consumidores em primeiro lugar	Gatorade ouve um adolescente e muda sua fórmula
Como os EUA mudaram na minha vida:	De Reagan a Obama, como mudamos como nação
The New York Times: a empresa chinesa compra os EUA start-up solar	A empresa chinesa compra uma start-up de tecnologia solar americana
Na França, os manifestantes se reúnem contra permitir o casamento entre pessoas do mesmo sexo	Rally francesa: não ao casamento entre pessoas do mesmo sexo
Siga o Dinero: Cuomo arrecada US $ 22,5 milhões para lance de reeleição	Cuomo levanta quase US $ 22,5 milhões para campanha de reeleição
A China está investindo em # educação - # superior # edpolicy	Próximo boom feito em china: graduados da faculdade
O Livestrong pode sobreviver à admissão de doping de Lance Armstrong?	Livestrong tem vida depois de Lance
Construa uma cerca em torno de sua boa saúde! Suas principais perguntas da gripe respondidas.	Suas 10 principais perguntas da gripe respondidas
Johnson & Johnson ciente de 40 % de falha no implante de quadril # Hipimplant	criador ciente de 40 % de falha no implante de quadril
'Existe uma maneira pior de viver? '(cc :) # jidf	'Existe uma maneira pior de viver do que isso? '
A violência armada é absoluta uma edição de # publichealth. Bom trabalho, sobre sua reforma de armas para uma geração # IsaStart	Editorial: Presidente Obama? S Plano de Reforma das Armas
Az Gov Jan Brewer muda de idéia e expandirá o Medicaid: # Medicaid	Briefing Nacional | Southwest: Arizona: Governador cede no Medicaid
Vale a pena ler para os trechos da coluna: Pauline Phillips, Dear Abby, morre aos 94	Pauline Phillips, conselheira de Flinty para milhões como querida Abby, morre aos 94
# Luta de Mianmar com # Armado # rebeldes Bordes em direção à China # Birmânia # Kachin	Mianmar lutando bordas em direção à China
Verdadeiramente um dia triste. Pelo menos 90 mortos no incêndio da boate do Brasil	Centenas mortas no incêndio da boate do Brasil
Rebeldes inadvertidamente treinados: ataques franceses no Mali Supplant Cuidado dos EUA.	Jets franceses atacam no fundo do Mali Held-Held
A bomba de calorias no cardápio fará com que os comedores se sintam culpa após terminar essas refeições	9 bombas de calorias em restaurantes
O Facebook foi o aplicativo móvel mais popular nos Estados Unidos em 2012	O aplicativo móvel do Facebook ocupa o primeiro lugar
Um alarme na operação no # ClimateChange # EntereWeather # GlobalWarming # ECO	um alarme na operação sobre a mudança climática
Síria: ataques aéreos mortais em Damasco	Síria lança ataques aéreos mortais nos subúrbios de Damasco
Dois de nossos parceiros favoritos e, se uniram para trazer mais música para o seu trajeto.	Ford anuncia comandos de voz no carro para a música em nuvem da Amazon
Incrível, você pode jogar jogos de tiro violento e ninguém diz nada além da NRA desenha calor sobre o novo jogo de tiro-alvo	NRA desenha calor para o jogo de tiro
vale a pena assistir. "Set for Life" documentando uma geração? s cair. # trabalho # desemprego # babyboomer	Nossa geração :? definido para a vida? Documentos Crise entre Baby Boomers
Fix do Dreamliner: 'Não é fácil' - esta grande bagunça que não é fácil.	787 Dreamliner correção: 'Não é fácil'
NYT Editorial: o que não sabemos que está nos matando # pesquisa # armas # violência	Editorial: o que não fomos? Eu sei que está nos matando
Acha assim? Eles não pensam assim!	Presidente Hillary Clinton? Se ela quiser
Poeta vencedor do Pulitzer Tracy k. A rotina de domingo de Smith:	Poesia, fantoches e playgrounds
posição "eliminada". hum . Eu li "Exterminado". O Times Executive está saindo	Times Communications Executive está saindo
senhor. Drummond, sim ... mostrando minha idade: Conrad Bain, pai? diff? Alugar golpes? , morre aos 89 anos	Conrad Bain, ator? diff? Alugar golpes ,? morre em 89
A Arábia Saudita defende a execução de Maid	Saudis defender a decapitação de Maid
"O Facebook tem muitos dados, mas são dados muito barulhentos".	Fortunas do Facebook podem depender de pesquisas
CNN tragédias recentes de boates: no sábado, um enorme incêndio na boate Kiss no sul do Brasil morto em L ...	Blazes mortais: tragédias da boate na história recente
Coréia do Norte enviando ameaças a elas novamente	A Coréia do Norte emite uma nova ameaça para os Estados Unidos
Nós somos todos humanos, não mais morte, por favor! Outro tibetano se pega fogo, morre para protestar contra o domínio chinês	tibetano se incendia para protestar contra o domínio chinês
Coca-Cola se juntando à luta na obesidade	A Coca-Cola pesa a luta da obesidade
orações por Burt Reynolds	Burt Reynolds 'sentindo -se melhor', mas ainda na UTI, diz o representante
'Taliban' é plural, mas isso é aparentemente esotérico para a CNN ou qualquer outro jornalista :.	'American Taliban' ganha o direito de agrupar a oração
Os ativistas sauditas dizem que não serão silenciados ~ ~ Espero que encontrem uma maneira de obter seus direitos pacificamente!	Ativistas sauditas dizem o reino tentando silenciá -los
Quando os médicos não ouvem o que você pode fazer?	O que fazer quando os médicos não ouvem
Jodie Foster se importaria mais com a Síria lançar ataques aéreos mortais nos subúrbios de Damasco	Síria lança ataques aéreos mortais nos subúrbios de Damasco
dobrando as regras de churrascaria # comida # comendo	Revisão do restaurante: Arlington Club no Upper East Side
Excelente passo com questões legais complicadas.	Os legisladores de Nova York esperam votar rápido em novas leis de armas
'Anonymous' ameaça o Departamento de Justiça. 'Anonymous' ameaça o Departamento de Justiça	Grupo hacktivista ameaça o Departamento de Justiça
Pelo menos 245 mortos no incêndio da boate do Brasil, uma vergonha	Centenas mortas no incêndio da boate do Brasil
Vício em Internet do dia: 'O que acontece quando você lança Lindsay Lohan no seu filme'	Aqui está o que acontece quando você lança Lindsay Lohan em seu filme
Ótima peça do NYT mostrando a China também tem o que a McKinsey vê como um problema global de educação para trabalho:	Os graduados chineses dizem não graças a empregos de fábrica
Sobre as virtudes da procrastinação: essa deveria ser minha coluna para o Ano Novo? dia s	Resultados: Procrastinação positiva, não um oxímoro
França: Nós não somos os pacifistas que você pensa que somos - Mali	Por que a França não é nação pacifista
O mundo bizarro dos relacionamentos on -line: a imagem de Manti te 'O se torna um quebra -cabeça à medida que as teorias giram	Imagem de Manti Te? o se torna quebra -cabeça à medida que as teorias giram
O boom econômico de Washington, financiado por você na vida real "Jogos Vorazes"	Washington? s boom econômico, financiado por você
Finalmente confirmado - os lábios rachados são o primeiro sinal de você? Tenho doença louca de vaca.	Opinião: Hipocondria: um visual interno
Swatch joga uma mão grande em US $ 1 bilhão Harry Winston Acqusition Get It, grande mão ... # iexplainMyjokes	Swatch para comprar negócios de relógios e jóias de Harry Winston por US $ 750 milhões
Os estados obtêm extensão em # HealthExchange Tonsetable :: Os estados recebem tempo extra para configurar as trocas # ACA # HCR	Os estados terão tempo extra para configurar trocas de seguro de saúde
"Viva pela espada ..." triste e irônico. Produtor de vídeos populares relacionados a armas	Produtor de vídeos populares relacionados a armas encontradas fatalmente filmadas
Kobe Bryant, esposa para cancelar o divórcio yaayy! lol .	Kobe Bryant e esposa chamam o divórcio
excelente ! ? : # Obama acelerando as tropas da retirada do # Afeganistão, vários meses antes do previsto :?	Obama, Karzai para acelerar a transição militar
OBIT: Vincent Sombrotto, líder da greve de 1970 que fecharam os correios em todo o país até Nixon enviou a Guarda Nacional	Vincent Sombrotto, que liderou o ataque postal, morre aos 89 anos
Tão de partir o coração “: pelo menos 90 mortos no incêndio de boate brasileiro, dizem as autoridades.”	Centenas mortas no incêndio da boate do Brasil
Mais motivos para revisar uma estrutura tributária pró-doméstica mais progressiva "a produtividade da América sobe, mas os salários estagnam"	Análise de notícias: America? s produtividade sobe, mas salários estagnados
Isso é interessante: "O que não sabemos está nos matando".	Editorial: o que não fomos? Eu sei que está nos matando
Quando vi esse cara cantar pela primeira vez no metrô, pensei que ele precisava de um artigo. E o NYT entregou!	Nos metrôs, Geechee Dan? S Voz agita a alma
Alemanha para mover 674 toneladas de ouro do centro de Manhattan para Frankfurt ..	Alemanha para repatriar algumas de suas reservas de ouro
Isso apenas aqueceu meu coração: Ada Bryant e Robert Haire	Ada Bryant, Robert Haire? Casamentos
# New York City Ties # Doctors? # renda para # qualidade de # atendimento	Hospitais da cidade de Nova York para amarrar médicos? Pagamento de desempenho para medidas de qualidade
NY Times: Dot Earth Blog: 'Wild West' é para fracking chegando ao fim?	A era 'Wild West' para a perfuração de gás está chegando ao fim?
Crianças algemadas 4 violando o código de vestimenta! # MS preenche # School2Prison Pipeline Reports donatel.	Relatório critica as medidas de disciplina escolar usadas no Mississippi
Parabéns a # Fruitvale e # Bloodbrother! Parece que o # Sundance teve alguns filmes poderosos este ano.	The Carpetbagger: 'Fruitvale', drama com pouco zumbido avançado, vitórias em Sundance
Durma, por acaso para sonhar e nossas memórias não UNSEEM MT: envelhecimento cerebral e declínio da memória relacionado ao sono ”	envelhecimento cerebral ligado ao declínio da memória relacionado ao sono
Minha associação ao PBK, finalmente explicou. pais ? O apoio financeiro pode não ajudar as notas da faculdade:	pais ? apoio financeiro vinculado às notas da faculdade
Tênis: Sharapova assume meninos	Sharapova assume meninos australianos
O FDA pode achar que o cocô é um medicamento. NYTIMES: Quando as pílulas falham, esta, er, opção fornece uma cura	nojento, talvez, mas o tratamento funciona, o estudo encontra
Somente grandes coisas podem acontecer no traficante de queijo: na caixa de laticínios, prosa madura	Creative CheeeseMongers Pen descrições inteligentes
Peter gosta: Dealbook: Dell Shares Rise On News Company pode ser privado	Dealbook: Dell compartilha Surge após o relatório de possível compra
Kaepernick backs aposta de Harbaugh com a vitória dos playoffs	Kaepernick responde a Harbaugh? S Gamble com desempenho retumbante
Os governadores republicanos abrem a nova frente em # debate tributário que oferece soluções em negrito!	The Caucus: Governadores republicanos abrem a nova frente no debate tributário
Para o registro, cortei meu cabelo em "The Karlie" antes de Karlie; )	o ? Karlie? está virando cabeças
familiarize -se: # Northkorea	para a ONU. e Coréia do Norte: jogo em
Novas mutações descobertas em # melanoma são úteis para decodificar como se desenvolve. # câncer	Novas mutações descobertas em melanomas
Não é tão boa notícia .... NYTIMES: A economia alemã encolheu no quarto trimestre	A economia alemã provavelmente encolheu no quarto trimestre
un. Agências: Pare o sofrimento na Síria novamente. impotente.	un. : pare o sofrimento na Síria
Escritor conservador Nicholas Kristof: As armas são "um instrumento não de proteção, mas de escalada".	Colunista de Op-ed: Lições de armas e um ganso
NYTIMES: Os fabricantes de robôs dizem que a automação criará empregos novos e melhores e não apenas excluir empregos	Os fabricantes de robôs espalham o Evangelho Global de Automação
Novo baixo para níveis de água nos Grandes Lagos # seca	A água traz novos baixos em grandes lagos
Grã -Bretanha para leiloar 250 MHz para celular de alta velocidade -	Grã-Bretanha preparada para se juntar à festa móvel de alta velocidade
NYTIMES: Aplicativos e outras ferramentas digitais ajudam ...	Kit de ferramentas: aplicativos e outras ferramentas digitais ajudam a novas mães
Comparou o DNA de 6.000 amostras de sangue visceral leishmaniosis da Índia e Brasil mostra variações semelhantes.	Atualização global: um link genético encontrado para vítimas de forma letal de leishmaniose
Então, podemos simplesmente passar a época agora? Pentágono está pronto para elevar a proibição de combate para as mulheres	Pentágono Bail de levantamento de mulheres em combate
Alemanha para mover 674 toneladas de ouro # Alemanha # Europa # EUA	Alemanha para repatriar algumas de suas reservas de ouro
“: O cão do Serviço Secreto cai até a morte” 😢 🐶 🐶	O cão do Serviço Secreto cai até sua morte enquanto nos detalhes do vice -presidente
* * * * * NYTIMES: A empresa de segurança descobre campanha cibernética * * * * * *	Bits bits: a empresa de segurança descobre a campanha de espionagem global
# Plano Obama: cheques mais difíceis, sem armas de assalto - - de # guuncontrol	GOP Balks em propostas de controle de armas
Ken Salazar saindo para passar mais tempo com seus laços de bolo.	Ken Salazar, do interior, deixando o cargo
Nike revela Rory McIlroy como o herdeiro de Tiger aparente. Negância de US $ 200 mil? ! ? não faz sentido para os negócios para mim.	Nike revela Rory: o herdeiro de Tiger aparente
Os bebês devem ter permissão para 'chorar'? # Anexo # Parenting	Os bebês deveriam apenas 'chorar'?
Olhe do momento: # Taylorswift	T Magazine: Look of the Moment | Taylor Swift
A situação dos Falcons de Atlanta	NFL: Os Falcons podem mudar?
O Estado de Nova York tem um acordo de controle de armas, com foco em males mentais	Os legisladores de Nova York esperam votar rápido em novas leis de armas
lições tribais - 'o mundo até ontem'	? o mundo até ontem,? por Jared Diamond
então . chance . ? : Em suas próprias palavras: Manti te 'o em sua namorada e sua morte - agora revelou ser uma farsa :?	Em suas próprias palavras: Manti te 'o na morte da namorada
A J&J estava ciente da taxa de falha de 40 % nos implantes do quadril depuy.	criador ciente de 40 % de falha no implante de quadril
Seguindo # Colorado # Decisões legais de maconha de perto. Talvez algumas lições para os dispensários da CA bagunça	Colunista de Op-Ed: Colorado? s maconha briga
NY Times - um sprint que está repleto de armadilhas	Slap Shot: N.H.L. ? s correr de uma temporada inclui armadilhas
Retornando Zing para cozinhar holandês? deixar ? S GO holandês? ? # Gartine	Colocando tempero na cozinha holandesa
Obama deve provar a si mesmo na Palestina: NYTIMES: Netanyahu emite a Barbada velada em resposta às críticas de Obama	Netanyahu emite a resposta velada às críticas de Obama
América, a Arábia Saudita de amanhã - boa ou ruim?	América, Arábia Saudita de amanhã
Isso machuca meu estômago.	9 bombas de calorias em restaurantes
você precisa de um "dia de parada"	a importância de um 'dia de parada'
O que aconteceu na Austrália ... eu fui atrás de armas. Obama também pode.	Colaborador de Op-Ed: Austrália proibiu armas de assalto. A América também pode.
As propostas de armas do presidente Obama funcionarão? Recordando a dor, os prefeitos pedem contas? passagem	Recordando a dor de armas? pedágio, prefeitos pedem contas? passagem
NYT Livros - Livros dos tempos :? o nadador do rio ,? Um par de novelas de Jim Harrison :? o nadador do rio ,? ji ...	Livros dos tempos :? o nadador do rio ,? Duas novelas de Jim Harrison
Baby Boomers recebendo conhecimento de tecnologia:	Avós: os novos técnicos?
V Kerry diz que # Irã deve ficar limpo no # programa nuclear	Audiência de confirmação de Kerry
woah. A Fox News não renovou o contrato de Sarah Palin, que acabou de expirado.	Fox News e Sarah Palin se destacam
Awe - Um dos "blogueiros" originais passa. Pauline Phillips, consultora de milhões como querida Abby, morre aos 94	Pauline Phillips, conselheira de Flinty para milhões como querida Abby, morre aos 94
Não tenho nenhuma idéia ,. nós. Terceirizes de programador O próprio trabalho para a China, Videos de CAT de surfs -	nós. Man terceiriza emprego na China, surfs gatos vídeos
O cineasta Jason da Silva sobre os desafios de navegar NY com # MS: The Long Wait? # Sundance	op-docs :? A longa espera?
Essa coisa parece um daqueles artigos de 'morte' pré-escritos. repugnante .	Burt Reynolds em terapia intensiva no hospital da Flórida após a gripe, diz o representante
Deslegrante: Os leitores procuram Lance Armstrong por reembolso de livros após a admissão de doping: O que você acha?	Os leitores procuram Armstrong por reembolso do livro
200 mortos em incêndio de boate	Centenas mortas no incêndio da boate do Brasil
Nyt-Pentágono levanta a proibição de mulheres que servem em papéis de combate	Pentágono Bail de levantamento de mulheres em combate
"Uma versão anterior desta revisão identificou mal o torso que foi apresentado quando o piquenique foi aberto na Broadway ..."	Resenha do teatro :? piquenique? no American Airlines Theatre
Aqui está a mais dois anos de piadas sobre Reince Penis.	Priebus reeleito para liderar o Comitê Nacional Republicano
Nova York passa por uma conta de controle de armas interessante, eu gosto que eles realmente se concentraram na saúde mental.	Nova York para aprovar a primeira conta de controle de armas desde o tiroteio de Newtown
Miss Montana tem uma ótima história para contar. # autismo	Senhorita Montana em seu autismo
CGG - 30 morre quando o ônibus mergulha no penhasco no Nepal -	30 mortos enquanto o ônibus mergulha no penhasco no Nepal
Uma vista surpreendentemente refrescante do velho Johnny Howard. Eu fui atrás de armas. Obama também pode.	Colaborador de Op-Ed: Austrália proibiu armas de assalto. A América também pode.
": No editorial do The Gun Challenge de hoje, Obama deixa a política de lado e toma medidas sobre a reforma das armas".	Editorial: Presidente Obama? S Plano de Reforma das Armas
em N.A.A.C.P. , a indústria se aliará contra a proibição de refrigerantes, não sou um deles!	no tribunal, N.A.A.C.P. Adiciona voz contra a Bloomberg? s proibição de refrigerante
E eles nunca se despertam por quê! ! Os EUA erram no Egito de novo -	Opinião: os EUA erram no Egito, novamente
Carros com inundação de furacões arruinados por compradores involuntários de isca Sandy	Carros com inundação de furacões atraem compradores involuntários
Em Oz, adoramos zombar da política dos EUA, leis de armas etc. Vale lembrar a população de nós, debate anos à frente dos nossos.	Obama buscará o caminho da cidadania em um empurrão rápido
Paging Orval Faubus: "Oregon xerife: as leis de controle de armas 'inconstitucionais' não são aplicadas" # guuncontrol # newtown	O xerife Won Won 'T reforce as leis de armas' inconstitucionais '
Globo de Ouro: Como Tina Fey e Amy Poehler fizeram como anfitriões?	Globo de Ouro inicia a temporada de prêmios de Hollywood
Em # Turquia, os enlutados protestam contra assassinatos de curdos #	Esqueiros em assassinatos de protestos de peru de ativistas curdos
Chim: uma retrospectiva vívida da pós -guerra Europa # fotografia	Chim: uma retrospectiva vívida da Europa
não é? É triste que eventos como o massacre em Conneticut tenham que acontecer para nós percebermos # desafios	Uma missão adicional para o xerife do Arizona? s Posse de imigração: patrulhas escolares
Vídeo: Collosseum colorido de Rome:	O Coliseu de Roma desiste de segredos
O que o quê? ! ? : Voz de Charlie Brown preso, acusado. ?	Boa tristeza! Charlie Brown Ator cobrado
Aqui vamos nós de novo .. um homem diz que ele "ele sabe", ele sabe onde Hoffa está enterrado.	O homem condenado em crimes da máfia diz que está 'certo' onde hoffa está enterrado
Homem realizado após ataque de metrô na Filadélfia	Homem realizado depois que a mulher jogada em trilhas de metrô na Filadélfia
Até pensei que eu baixei # Google Maps para # iPhone, ainda estou usando os mapas incorporados da # Apple. Eles são mais fáceis de usar.	Google ganha com a criação de aplicativos para a oposição
As memórias enterradas conversam sobre uma história verdadeira nunca contou a verdadeira sobrevivência, memória e recuperação.	"Memórias Enterradas" de Katie Beers
Os edifícios 'verdes' do Golfo # Amman # CNN	Edifícios verdes mais legais do Golfo
NYTIMES: N.R.A. Ataques Obama e filhas em vídeo \ repugnant.	N.R.A. Ataca Obama em vídeo
horrível . ": Mais de 800 casos de estupro de Nova York a serem revisados ​​para erros forenses"	Mais de 800 casos de estupro de Nova York revisados ​​por erros
Aqui está minha pergunta: Lance está sendo punido por trapacear ou por trapacear melhor?	Public Churches em Armstrong
O motivo que os Kindles existem: The Onion 'está jogando uma biografia eletrônica de Biden	Artsbeat: Biden recebendo uma autobiografia da cebola (quer ele queira ou não)
O Distrito de Design de Info Miami procura uma atualização: uma renovação proposta de US $ 312 milhões deve transformar T ...	Miami? S Design District procura uma atualização
Membros quebrados, rasgados vive no norte # mali - # islamismo # sharia	membros quebrados, vidas rasgadas no Mali
Jornalistas, dê uma dica de Andrew Sullivan -	Jornalistas, aprendem com o blogueiro Sullivan
Essa doce história de amor me fez chorar. Não, realmente:	A corrida cresce mais doce perto de sua volta final
A Coréia do Norte bate na bateria de guerra ...	n. A Coréia faz novas ameaças contra os EUA.
Influência russa no aumento em # Israel	ascensão dos russos em Israel
Vida sob militantes islâmicos - membros quebrados, vidas rasgadas no norte do Mali	membros quebrados, vidas rasgadas no Mali
Boa tristeza, Charlie Brown é preso	Boa tristeza! Charlie Brown Ator cobrado
“:“: O número de mortos sobe para 220 no incêndio da boate do Brasil, diz oficial. ”Incrivelmente triste” horrível	Centenas mortas no incêndio da boate do Brasil
Triste, mas traz de volta memórias de mãos manchadas de tinta lendo sua coluna. Que vida. NYTIMES: Caro Abby morre aos 94	Pauline Phillips, conselheira de Flinty para milhões como querida Abby, morre aos 94
Nos postos avançados do deserto, os agentes de fronteira mantêm o relógio # elpaso # elchuco # lafrontera # mexico	Em postos avançados remotos, os agentes de fronteira peneiram para pistas
O mais próximo eu vou chegar de Hollywood: # Greenfashion no tapete vermelho	Iht Rendezvous: moda verde no tapete vermelho
Novamente: NYTIMES: 787 Vapa de jato combustível durante o teste de segurança	Japan Airlines diz que 787 Jet vazou combustível durante o teste de segurança
Alguns diariamente sobre crime diário aqui. MT: No Filib. reforma? ininteligível:	O acordo bipartidário de Filibuster está tomando forma no Senado
Coréia do Norte ? s movimentos de mísseis preocupam os EUA Thom Shanker e David e. Sanger	O movimento de mísseis da Coréia do Norte preocupa os EUA.
Estamos empolgados em ver o que acontece! ! ? South Park? Os criadores iniciam "estúdios importantes" # SouthPark	? South Park? Criadores para iniciar a empresa, estúdios importantes
CNN: Helicopter Crash chove detritos na London Street	Helicopter Crashes na hora do rush de Londres
Prodígio on -line Aaron Swartz comete suicídio Deus Por quê?	Ativista on -line Aaron Swartz comete suicídio
O Studio 54 é como os anos 60- se você se lembra, você estava realmente lá? VENDANDO ALGUM ANTIGO SPEKLE FR Studio 54:	Mormes
O clima está mudando, não em um futuro distante, mas agora:	um alarme na operação sobre a mudança climática
Clima extremo: espere o inesperado	O clima extremo cresce em frequência e intensidade em torno do mundo
Ada Bryant e Robert Haire, você vai, garota! !	Ada Bryant, Robert Haire? Casamentos
NYT em Aaron Swartz: um cruzado de dados, um réu e agora, uma causa	Aaron Swartz, um cruzado de dados e agora, uma causa
Ignore a manchete: mais de 220 ... clique no link para atualização via CNN. Estamos vendo os números subirem mais ...	Centenas mortas no incêndio da boate do Brasil
Estou lamentado por ter que chegar a isso para alguns.	tibetano se incendia para protestar contra o domínio chinês
Scaryyyyy ... questionando o crescimento grego	Mundo: perguntas verdes sobre crescimento grego
Notícias trágicas: um cruzado de dados, um réu e agora, uma causa	Aaron Swartz, um cruzado de dados e agora, uma causa
É melhor você acreditar nas mudanças climáticas, é real! @ Relatório Federal vê Big U.S. impactos do aquecimento global	DOT Earth Blog: Rascunho do Relatório Federal vê Big U.S. impactos do aquecimento global
: Popular Gun Nut * Silto tirado em casa, a NRA acha que precisava de mais armas	Produtor de vídeos populares relacionados a armas encontradas fatalmente filmadas
Isso é tão triste “: 245 pessoas mortas no incêndio da boate do Brasil, a polícia contou à agência de notícias do estado.”	Centenas mortas no incêndio da boate do Brasil
O ex -primeiro -ministro australiano diz: "Eu fui atrás de armas. Obama também pode".	Colaborador de Op-Ed: Austrália proibiu armas de assalto. A América também pode.
NYTIMES: Diderot, um exemplo americano? Bien Sûr! um pensador livre	Colaborador de Op-Ed: Diderot, um exemplo americano? bien s? r
Boa tristeza! Charlie Brown Voice Ator cobrado - # Law # Legal	Boa tristeza! Charlie Brown Ator cobrado
SL colocando um número sobre o pedágio de fumar	Bem: efeitos de longo prazo na expectativa de vida de fumar
É uma coincidência que a maior Miss America vem do sul?	Colaborador de Op-Ed: Política Racial e Miss America
Grã-Bretanha oscila em direção à recessão de triplos CNNMoney	Grã -Bretanha arrisca uma nova recessão
Million Man March; promete trazer mudanças no sangramento do Paquistão- # tahirulqadri # 14jan	'Million Man March' promete paralisar a capital paquistanesa
América, a Arábia Saudita da Amanhã - Boa sorte saudita :)	América, Arábia Saudita de amanhã
Caso francês no Twitter envolvendo as identidades por trás dos comentários racistas é apenas o mais recente escaramuça sobre o discurso da Internet	Twitter ordenou para ajudar a revelar fontes de postagens anti-semitas
"Nem todos os smoothies são criados da mesma forma!"	9 bombas de calorias em restaurantes
Hospitais dos EUA recusam visitantes com sintomas de gripe - NYT	Os hospitais fazem restrições aos visitantes de pacientes com gripe
NYTIMES: 232 Morto enquanto o incêndio varre a boate no Brasil (portas de segurança trancadas e pirotecnia da banda)	pontuações mortas enquanto o incêndio varre a boate no Brasil
v? Uma Suprema Corte ouve argumentos sobre o F.C.C. ? s autoridade para governar as torres de celulares	Supremo Tribunal ouve argumentos sobre torres de celulares
IHT: Xiao Shu, ex -jornalista do Southern Weekend, dá a um conjunto de informações sobre o Iron Grip of Censorship.	Colaborador de Op-Ed: Dim esperanças de uma imprensa livre na China
# wtf aconteceu novamente. Polícia: 7 homens de estupro de gangues passageiros em # Índia -	Seis presos por novo estupro de gangue no ônibus
# Juventude: O quer saber: " # Facebook faz você se sentir l-o-u-s-y?" Compartilhe aqui	O Blog da Rede de Aprendizagem: Opinião do Estudante | O Facebook faz você se sentir mal?
da CNN: 'Pelo menos 245 mortos na atualização de incêndio da boate do Brasil'	Centenas mortas no incêndio da boate do Brasil
carne de cavalo descoberta em carne de hambúrgueres no Reino Unido e na Irlanda	Horsemeathed encontrado em hambúrgueres na Grã -Bretanha e na Irlanda
Caro Abby, morre em 94. Caro Abby: As pílulas anticoncepcionais são dedutíveis? Bertie querida Bertie: Só se eles não o fizeram? t trabalho.	Pauline Phillips, conselheira de Flinty para milhões como querida Abby, morre aos 94
Jared Diamond Book vale a pena ler? "O mundo até ontem"	? o mundo até ontem,? por Jared Diamond
# SocialMedia torna as pessoas mais honestas, diz # Cornell Prof # Facebook # LinkedIn	A mídia social nos torna mais honestos
O melhor rafting de água branca do mundo? Geekkenya	O melhor lugar do mundo para rafting aquático?
Casey Anthony tem duas de suas quatro condenações jogadas fora.	Casey Anthony condenações jogadas fora
trabalhadores sendo vistos como apenas um custo ... todos nós construímos essa sociedade e conseguiremos o que pagamos	Opinionador | A Grande Divisão: A ascensão da economia temporária permanente
Sobre a necessidade de humanidade no aprendizado on -line.	Os cursos on -line precisam de elemento humano para educar
Estranho, apenas a voz? ": Voz de Charlie Brown presa, acusada."	Boa tristeza! Charlie Brown Ator cobrado
Opinionador: conceitos errôneos (Linda Greenhouse)	Opinisteiro: conceitos errôneos sobre Roe v. Wade
Frum: EUA O problema das armas não é um problema de corrida (deve ler)	O problema das armas da América não é um problema de corrida
A liberdade de expressão é um direito democrático básico, exceto na França # Twitter	Twitter ordenou para ajudar a revelar fontes de postagens anti-semitas
Goed Initiatief, Inkomen Op Kwaliteit en Niet Op Verrichtingen # New York City lances os médicos? Renda à qualidade do atendimento	Hospitais da cidade de Nova York para amarrar médicos? Pagamento de desempenho para medidas de qualidade
A arte encontra a tecnologia antes da tragédia: Photog Taryn Simon e Genius de Computador Aaron Swartz Crie um projeto, via NY Times	O blog do 6º andar: Taryn Simon e Aaron Swartz Experimente com imagens
Uau, que história: no metrô, uma voz para mexer a alma	Nos metrôs, Geechee Dan? S Voz agita a alma
As vendas do Windows 8 da Microsoft estão bem, não ótimas	As vendas do Windows 8 da Microsoft são grandes - mas não grandes o suficiente
A morte é ruim o suficiente:	Seu dinheiro: uma morte chocante, uma aula financeira e ajuda para os outros
"Maridos de Hollywood"? ? A sátira lasca de gênero da TV de reality show ... e comentários sutis sobre opções limitadas para atores negros.	crítico? S Notebook :? Maridos de verdade de Hollywood? e falta de pistas masculinas negras
Presidente Hillary! Há poucas coisas que eu gostaria mais!	Presidente Hillary Clinton? Se ela quiser
NYT, "O estudo do mouse descobre o DNA que controla o comportamento [escavação] [e se os túneis de fuga são feitos]"	Estudo de mouse descobre o DNA que controla o comportamento
": As mídias sociais nos tornam mais honestas? conversas com"	A mídia social nos torna mais honestos
Pensando em como podemos acalmar nosso discurso cívico. Os rótulos são poderosos.	Opinionador | The Stone: O que é um 'hacktivista'?
O público tira seus tiros em Armstrong-o que vocês pensam no doping de Armstrong?	Public Churches em Armstrong
depois dos EUA Ameaça, a Coréia do Norte vira ira no sul # militar # skorea # nkorea # nós # política	Após ameaças contra os EUA , Coréia do Norte vira ira para o sul
sen. Feinstein anuncia o projeto de lei para limitar as armas semiautomáticas:	O senador revela o projeto de lei para limitar os braços semiautomáticos
NYTIMES: Vitória para Anthony e Knicks	Ganhe para Anthony e Knicks
A troca mexicana de tábuas de armas ...	Vídeo mostra os destroços ardentes de helicóptero
De: cond? NAST OFERTAME	cond? Nast contratos cortados autor? s Compartilhe em ofertas de filmes
Incêndios ameaçam partes da Austrália -	Fotos: Incêndios em toda a Austrália
Sinta -se bom dia Leia! :) Observe um guardanapo: 'Esta refeição está em nós' -	Nota sobre guardanapo: 'Esta refeição está sobre nós'
Exercício pode aumentar a foto da gripe? S Potência # Flushot # Exercício # Saúde	Exercício pode aumentar a potência da gripe
A indústria de telecomunicações acabou de retirar nossos direitos. A partir de hoje, é ilegal escolher um transportador de celular diferente	Bits Blog: o direito de desbloquear os celulares desaparece
incrível ! # Os republicanos não podem ganhar em suas idéias para que mudem as regras! ?	Alguns estados liderados pelo Partido Republicano analisam as mudanças de voto eleitorais
77 % dos americanos usam a pesquisa para encontrar diagnóstico. ? : Voltando à Web para obter um conselho médico?	Bem: Voltando à Web para um diagnóstico médico
Os truques de mudar de Wall Street para Tech # Dealbook	Dealbook: Mudar de Wall Street para o setor de tecnologia é complicado
Os bebês deveriam ser deixados para "chorar?" ...	Os bebês deveriam apenas 'chorar'?
perspectiva interessante sobre # Broncos PlayCalling -	os chamados cautelosos de John Fox
Os rivais assistem como as esperanças de perfuração do Arctic da Shell. $ rds.a # alaska # keystonexl # # política	Os rivais assistem a dificuldades de perfuração do Ártico da Shell
Os militares russos ordenaram que mudasse para as meias, aprendi algo novo hoje! ! !	no blog de guerra: militares russos ordenaram a troca de portyanki para meias
O juiz Clarence Thomas quebra seu silêncio e o artigo de cebola? Não posso dizer	Justiça Thomas quebra seu silêncio no tribunal
Artigo interessante. o mais rápido possível, o parceiro do Hip-Hop é o mais rápido	o mais rápido possível, o parceiro do hip-hop? S o mais rápido possível
Eles eram tão jovens: ( # santamaria # tragedyiThenightclub	Centenas mortas no incêndio da boate do Brasil
Um arquiteto está construindo uma casa de banda Mobius com uma impressora 3D. Eu sabia que essas coisas seriam úteis.	arquiteto para construir em casa usando a impressora 3D
TheWritingGenie Sobrenatural Contos: Manuel Gonzales fala sobre 'a esposa em miniatura': MR. O primeiro colegial de Gonzales ...	Artsbeat: q. e a. : Manuel Gonzales em sua coleção de histórias 'A esposa em miniatura'
Philly High School School, participe da conversa. : Você se sentiria mais seguro com guardas armados em sua escola?	O Blog da Rede de Aprendizagem: Opinião do Estudante | Você se sentiria mais seguro com guardas armados patrulhando sua escola?
Algumas boas notícias para uma mudança mais vidas sendo salvas - as taxas de mortalidade por câncer caem 20 % ...	Mais vidas sendo salvas: as taxas de mortalidade por câncer caem 20 %
Aparentemente, um suicídio	Aaron Swartz, ativista da Internet, morre em 26
Esta é uma exposição inspiradora. o caminho para o futuro. ? Abrindo espaço? na cidade	MISER DO FIM DE SEMANA :? Dando espaço,? no Museu da cidade de Nova York
Jeanne Vertefeuille, que desempenhou um papel fundamental em desmascarar o infame espião Aldrich Ames, morreu recentemente.	Jeanne Vertefeuille morre, 80; ajudou a pegar Aldrich Ames
Espere, o quê? ! - 'Verificações de antecedentes universais' definidas	'Verificação universal de antecedentes': o que isso significa?
Nosso picles econômico: a produtividade da América sobe, mas os salários estagnam	Análise de notícias: America? s produtividade sobe, mas salários estagnados
Leis de proteção fraca para trabalhadores domésticos: execução saudita: brutal, desumano e ilegal? - CNN # P2 # P21 # TCOT # CCOT	decapitando: desumano e ilegal?
Leitura: como obter a América online via	Colaborador de Op-Ed: Como obter Internet de alta velocidade para todos os americanos
New York Times Top Relações Públicas Executivas para partir	Times Communications Executive está saindo
O que há de tão errado em pesquisá -lo? O que não sabemos está nos matando	Editorial: o que não fomos? Eu sei que está nos matando
Benjamin Millepied para assumir o balé de ópera de Paris, com todos os detalhes:	Benjamin Millepied para ser diretor de balé da Paris Opera
# java comprometido tomar as medidas necessárias	Vulnerabilidade crítica de Java devido a um patch anterior incompleto
# Morsi: "Enfermeira nossos filhos e nossos netos com ódio por eles: para sionistas, para judeus"	Morsi diz que insultos de judeus foram retirados do contexto
NYTIMES: Armstrong, uma confissão sem explicação-a mais sofisticada, organizada e profissionalizada? na história	Para Armstrong, uma confissão sem explicação
magro em irmãs .... NYTIMES: Ela é (raramente) o chefe	Colunista de opções: ela? s (raramente) o chefe
As famílias das vítimas de bombas do Paquistão	As vítimas de bombas do Paquistão serão enterradas após o término do protesto
Isso pode ser muito interessante ....	Alguns estados liderados pelo Partido Republicano analisam as mudanças de voto eleitorais
O senador Schumer diz que votará em Chuck Hagel para o Secretário de Defesa Boas notícias!	Schumer diz que ele? está satisfeito com Hagel no Oriente Médio
Este homem pode cantar melhor do que alguns grandes nomes que estarão no Grammy Awards Geechee Dan toca o metrô da 42nd Street	Nova Iorque. / região: Geechie Dan toca o metrô da 42nd Street
A empresa de segurança descobre campanha cibernética # ITSECURITY # CyberSpy	Bits bits: a empresa de segurança descobre a campanha de espionagem global
Great NY Times Artigo: “:“: Um santo em sua cidade: Archie Manning em # Neworleans	Um santo em sua cidade: Archie Manning em Nova Orleans
Ótimo artigo e comentários sobre o que os proprietários de negócios enfrentam tentando descobrir como escolher a margem direita.	Ficar vivo: por que estou procurando um novo banco
Coloque seus armas nucleares [Dukes]! "A Coréia do Norte diz que o novo teste nuclear fará parte da luta contra os EUA" Jacques	n. A Coréia faz novas ameaças contra os EUA.
Desastres de bombardeios de calorias no menu	9 bombas de calorias em restaurantes
ICYMI: "Como os atletas com deficiência competem, questões de logística"	Atletas deficientes se adequam, levantando questões de logística e justiça
Se você não viu # louco # amor, você deveria. NYTIMES: Linda Riss # Pugach, cuja vida foi arrancada das manchetes, morre aos 75	Linda Riss Pugach, 1937-2013: Linda Riss Pugach, cuja vida foi arrancada das manchetes, morre aos 75
A pergunta é: isso significa guerra civil? Provavelmente não. Mas ainda não é uma boa situação # Iraque	Suni Sheikh para al-Maliki: entrega sobre soldados atrás de tiroteios ou 'perdas de rosto'
Não poderia concordar mais com os fatos aqui:	Opinistrador: a Índia está perdendo a corrida
Artigo interessante para os pais que apoiam seus universitários: pais? O apoio financeiro pode não ajudar as notas da faculdade	pais ? apoio financeiro vinculado às notas da faculdade
Cuomo de Nova York assina a conta de controle de armas. 1 Down 49 para ir!	Nova York para aprovar a primeira conta de controle de armas desde o tiroteio de Newtown
Synthax _ Terror 2 :: mais de 800 casos de estupro de Nova York a serem revisados ​​quanto a erros forenses	Mais de 800 casos de estupro de Nova York revisados ​​por erros
WTF Índia? ! ! Isso tem que parar.	Seis presos por novo estupro de gangue no ônibus
A CNN Soccer 'S' Bounty Hunter 'assume a FIFA: um agente de futebol líder multado pela FIFA por usar a mídia social tem ...	'Bounty Hunter' luta contra a FIFA no Facebook
Dey Stay Preppin '... os Preppers ao lado	os preppers do dia do juízo do dia do juiz de Nova York
A família usa maconha para gerenciar o autismo do filho ... uau	Menino que recebeu maconha para gerenciar seu autismo
"Long Island: 'Ataque dos Bloodsuckers!' No Museu das Crianças de Long Island" se você quiser assustar Leo	artes | Long Island :? Ataque dos sufocos de sangue! ? nas crianças de Long Island? s Museu
um deve ler. Minha incrível amiga Cynthis Schneider fez isso de novo, Bravo	Opinião: os EUA erram no Egito, novamente
Por que a rede sofre Aaron Swartz - o inovador que incorporou o que é melhor na rede.	Por que World Grieves Aaron Swartz
As diretoras ganham terreno, lentamente o contador de histórias? s Matra de gênero.	Diretores de cinema feminino ganham lentamente terreno
wtf? ? »": Pelo menos 245 mortos na atualização de incêndio de boate do Brasil: "	Centenas mortas no incêndio da boate do Brasil
# Os Cosmos revelam plano para # estádio de futebol perto de # BelmontPark # NYS # NY # Longisland # Econdev	Cosmos revelou o Plano para o Estádio de Futebol perto de Belmont Park
tema ? ppl tentando vender coisas que não são deles ... CC: # JoyDivision # Music	vidas: éramos divisão de alegria
NYTIMES: Os smartphones se tornam vida? s Controle remoto --- incrível	Os smartphones agora podem administrar consumidores? vidas
Breaks My Heart ": 245 pessoas mortas no incêndio da boate do Brasil, a polícia contou à agência de notícias do estado".	Centenas mortas no incêndio da boate do Brasil
OP -ED - Por que devemos ajudar a salvar # Mali # Africa # helpmali	Colaborador de Op-Ed: Por que devemos ajudar a salvar o Mali
oh meu deus . Pelo menos 245 mortos no incêndio da boate do Brasil	Centenas mortas no incêndio da boate do Brasil
Outra gangue na Índia! WTF! : (7 homens de estupro de gangues passageiros na Índia -	Seis presos por novo estupro de gangue no ônibus
A mídia social pode ser um amigo ou inimigo, mas isso não levanta seu QI - - Polícia: vídeos do YouTube levam ao busto de maconha	Polícia: YouTube leva ao busto de maconha
Ele está morto! ? : Venezuela diz que a condição de Hugo Chavez está melhorando?	Venezuela: Chavez está melhorando
NYTIMES: Frittata de couve -flor assada em estilo tunisina	Receitas para a saúde: Frittata de couve -flor assada em estilo tunisino? Receitas para a saúde
salivando! ? : passeios culinários exóticos de todo o mundo?	Tours culinários exóticos ao redor do mundo
"Ainda possui uma pulseira Livestrong? Conte -nos sobre isso." (CNN)	Ciclismo: Armstrong pede desculpas à equipe
Deixe a um advogado de # Lakechuck fazer com que o juiz Thomas quebre seu silêncio.	Clarence Thomas quebra o silêncio no banco
# codificador # terceiriza o próprio trabalho para # China para um # lucro, é demitido.	nós. Man terceiriza emprego na China, surfs gatos vídeos
África: Os 5 principais andares da semana são ... -	As 5 principais histórias da África nesta semana
estranho ! Notre Dame linebacker diz que ele é vítima de farsa	Notre Dame linebacker diz que é vítima de farsa
Quando as pílulas falham, esta opção fornece uma cura para C-Diff	nojento, talvez, mas o tratamento funciona, o estudo encontra
Caro Abby, já sentimos sua falta. Como você tem a sorte de ter a raposa margalit, escreva seu obit! "Querida Abby, morre aos 94"	Pauline Phillips, conselheira de Flinty para milhões como querida Abby, morre aos 94
um cruzado de dados, um réu e agora, uma causa # aaronswartz # mitfail # badbanding	Aaron Swartz, um cruzado de dados e agora, uma causa
Como um herói americano caiu na terra -. (Para onde se foram todos os verdadeiros heróis?)	Como o herói americano caiu na terra
O homem tibetano se chama em protesto. de novo .	tibetano se incendia para protestar contra o domínio chinês
O título mais preciso (embora menos cativante) seria "a Índia é o segundo lugar" não "perdendo", mas ainda interessante:	Opinistrador: a Índia está perdendo a corrida
Jeanne Vertefuille, incrível, disse para fazer um curso de secretariado de C.I.A. Ela ajudou a pegar um espião notório, morre aos 80	Jeanne Vertefeuille morre, 80; ajudou a pegar Aldrich Ames
Que admiração dos corajosos advogados de direitos russos LGBT nYTimes: 'Propaganda' por Gays enfrenta meio -fio russo em meio à agitação	? propaganda? por gays enfrenta meio -fio russo em meio a inquietação
Famílias de # Newtown Vítimas procuram respostas em # Violência Gun # NRA	Famílias das vítimas de massacre escolares de Newtown se organizam contra a violência armada
realmente ? O homem diz que está 'certo' onde Hoffa está enterrado	O homem condenado em crimes da máfia diz que está 'certo' onde hoffa está enterrado
NYTIMES: Como Get America Online - Excelente artigo por regulamentar os grandes ISPs	Colaborador de Op-Ed: Como obter Internet de alta velocidade para todos os americanos
Hora de proibir NighClubs.	Centenas mortas no incêndio da boate do Brasil
'Aqui está o que acontece quando você lança Lindsey # Lohan em um filme' e obtém acesso ilimitado no set: excelente jornalismo.	Aqui está o que acontece quando você lança Lindsay Lohan em seu filme
Coréia do Norte vira sua ira no sul # norte # sul # corea # un # sanções # war # r2ph	Coréia do Norte vira sua ira na Coréia do Sul
Em completo choque! Hospital Católico argumenta que o feto não uma pessoa	Os advogados do Hospital Católico argumentam que o feto não uma pessoa
O Confess, de Armstrong, arruinou todos os sobreviventes de câncer e fãs de ciclismo que pensavam que sua história de conto de fadas era verdadeira.	Para Armstrong, uma confissão sem explicação
Foi o que aconteceu no Brasil se você não sabe x	Centenas mortas no incêndio da boate do Brasil
Embora a verdade seja um padrão mais alto ...: Os leitores procuram Lance Armstrong por reembolso de livros após a admissão de doping	Os leitores procuram Armstrong por reembolso do livro
NYT História sobre o aterramento do Boeing 787s	F.A.A. Ordens de aterramento de Boeing 787, operados pelos EUA
aww? : Britney Spears chama o engajamento?	Britney Spears, Jason Trawick chama o engajamento
Os principais nomes de bebês de 2013 - (Gee, meu nome não está lá; o)))))))	Os principais nomes de bebês do Parenting.com
Este não deve ser o problema que é. Ready-set-go. NYTIMES: Como os atletas com deficiência competem, questões de logística	Atletas deficientes se adequam, levantando questões de logística e justiça
Maldito SMH ": O número de mortos sobe para 220 no incêndio de boate do Brasil, diz o oficial".	Centenas mortas no incêndio da boate do Brasil
Poderia ser bom? Parece intrigante ... ABC para olhar para a série de TV de ação ao vivo de 'Star Wars' -	ABC para olhar para a série de ação ao vivo de 'Star Wars'
Os cursos online ainda precisam de um elemento humano ...	Os cursos on -line precisam de elemento humano para educar
O argumento da proibição de armas continua, mas isso realmente resolverá qualquer coisa, exceto para desarmar os inocentes? # POLS1101	"Basta", diz Feinstein ao propondo uma nova proibição de armas
A história das agências temporárias: usando o sexismo dos anos 60 para expandir "logo sob o nariz de poderosos sindicatos".	Opinionador | A Grande Divisão: A ascensão da economia temporária permanente
Grande contratação de Robert Wolf e sua nova empresa Austan Goolsbee é um cara legal	Robert Wolf disse para contratar Goolsbee como consultor de sua empresa
Amém ! ": Boas notícias .... meu Shero Robin Roberts Planos de fevereiro retornar ao 'Good Morning America'"	Media Decoder Blog: Robin Roberts Planos de fevereiro Retornar ao 'GMA'
Quem roubou relíquias preciosas do MO. igreja ?	Quem roubou relíquias preciosas da Igreja na cidade do Missouri?
Firefly: 2015 está acontecendo ...... como um navio de mineração da NASA. # FireflyReturnskinda	'Fireflies' para procurar rochas espaciais para mineração
retaliação de greve de campo da Argélia sobre o Mali, dizem relatórios -	britânico morto em ataque de campo de gás da Argélia
Eu gostaria de poder ser este homem # Paultheroux minha # Lista de desejos de viagem via	Paul Theroux? s Lista de desejos de viagem
40 milhas para trabalhar, em uma bicicleta: - Incrível!	Viajando 40 milhas para trabalhar em uma bicicleta, com térmicas e lã
oh tão inteligente, pesa # obesidade luta	A Coca-Cola pesa a luta da obesidade
A Irmandade Muçulmana Confiada	O Egito implanta tropas para processar os confrontos 'fora de controle'
Eu preciso de um 'dia de parada' na minha vida. # cnn	a importância de um 'dia de parada'
Ótima peça de "O terrível pedágio de # de mortais na Síria" -	Tolho horrível de bombas de cluster
A vida judaica esclarecedora em um império muçulmano via Talmud Blog	Documentos iluminam a vida judaica no antigo império muçulmano
Destaques da entrevista de Katie Couric com Manti Te 'O	The Lede Blog: Atualizações sobre a entrevista de Katie Couric com Manti Te 'O
Aplicativos para ajudá -lo a esquiar: via NY Times	App Smart: os aplicativos ajudam os esquiadores a obter mais das encostas - App Smart
Lamentamos a perda de um advogado de acesso aberto no fim de semana passado ~ um cruzado de dados, um réu e agora, uma causa	Aaron Swartz, um cruzado de dados e agora, uma causa
nsfw? : Melhor abertura de obiti que li em muito tempo. Caro Abby morre aos 94?	Pauline Phillips, conselheira de Flinty para milhões como querida Abby, morre aos 94
Tomando a cultura gastronômica talvez um pouco longe demais ... o luxo inacessível de comida	Big City: Nova geração confronta luxo inacessível de comida
Eu gostaria de ler isso. MT: Entrevista com DL Weiss, que colocou seu filho em uma dieta e escreveu sobre isso.	Motherlode Blog: uma entrevista com Dara-Lynn Weiss, que a colocou de 7 anos em uma dieta, e escreveu um livro sobre isso.
NYT Botches Descrição de "Crushed Lata" fiasco em principalmente v. Boa peça sobre os problemas do Ártico da Shell	Os rivais assistem a dificuldades de perfuração do Ártico da Shell
Os Preppers ao lado que querem se juntar ao meu grupo?	os preppers do dia do juízo do dia do juiz de Nova York
impulsionado pela necessidade de competir ou remorso? Armstrong admite doping e diz que testemunhará	Armstrong admite doping e diz que testemunhará contra funcionários do ciclismo
SHERIFF: Eu não aplico as leis de armas de Obama. bom para ele.	O xerife Won Won 'T reforce as leis de armas' inconstitucionais '
amo isso-forma-se no consultório do médico, acabou de me divertir-	formas no médico acabou de se divertir
Bateria de Dreamliner estudada pelo NTSB (via Instapaper)	Nada descartado como NTSB Studies Dreamliner Battery
Definindo a barra, boa jogada! "O Wal-Mart planeja contratar qualquer veterano que queira um emprego"	Wal-Mart para anunciar um extenso plano para contratar veteranos
NYTIMES: A Apple pode ser grande, mas não é um Bellwether (minha coluna)	Estratégias: o estoque de maçã não é? T um sino, mesmo que isso? é grande
Schrecklich! 😢 “: pelo menos 90 mortos no Brasil Nightclub Fire”	Centenas mortas no incêndio da boate do Brasil
Fortunas do Facebook podem depender de pesquisa - essa é a grande revelação?	Fortunas do Facebook podem depender de pesquisas
Qual é o preço de insultar o # King na # Tailândia? 10 anos de prisão # para # ativista Somyot Pruksakasemsuk	ativista recebe 10 anos para o rei insulto
SHERIFF: Eu não aplico as leis de armas de Obama, ele é 1 negro, elas são as leis dos EUA e acalmam a foda # Overparanoia & Racism	O xerife Won Won 'T reforce as leis de armas' inconstitucionais '
Os registros eletrônicos de mineração para dados de saúde podem beneficiar bastante a pesquisa médica, não necessariamente reduz os custos de atendimento	Mineração de registros eletrônicos para revelar dados de saúde
NYTIMES :? homens loucos ? definido para retornar em 7 de abril. Excelente notícia.	Artsbeat: 'Mad Men' pronto para retornar em 7 de abril
FM grego: Pequena Chance Grécia Folhas UE	FM grego: pequena chance de saída do euro
'Pai, é apenas meus livros com quem sou amigo. ' # malala # womenonthefrontline	as linhas de frente em luta pelas mulheres
Adorável tributo, suas respostas aos QTNs dos leitores inestimáveis. Leia a fritura de bacon e você poderá se mover. querida Abby morre aos 94	Pauline Phillips, conselheira de Flinty para milhões como querida Abby, morre aos 94
Qual país tem mais liberdade econômica? # economia # economia	país com economia mais livre é ...
Guru do trabalho de '4 horas' na China OUSTERCER: Bad Karma - CNN International	Guru do trabalho de '4 horas' no terceirizo
Parte 4: Respostas às suas perguntas sobre o # fafsa # finaid # scchat	The Choice Blog: Parte 4: Respostas às suas perguntas sobre o FAFSA
Fato arrepiante de que a maior preocupação de segurança para as mulheres que servem em militar é o risco de ataques sexuais de camaradas.	Colunista de Op-ed: Mulheres militares e as linhas de frente
Finalmente um pouco respeito pelos veterinários! O Wal-Mart planeja contratar qualquer veterano que queira um emprego	Wal-Mart para anunciar um extenso plano para contratar veteranos
": Breaking: 250 morto, 200 mais feridos na boate Brasil Inferno." Crazy	Centenas mortas no incêndio da boate do Brasil
"Ore por mim". Secretário de Defesa Panetta na platéia com papa	O secretário de Defesa Leon Panetta encontra papa
John Cale em Paris e ao longo da fronteira. # música	q. e a. : com John Cale em Paris e ao longo da fronteira
Uma estrela em ascensão na cena de London's Thespian conta sua história de - ser bin Laden	Colaborador de Op-Ed: Eu joguei Osama bin Laden In? zero escuro trinta?
CASTING: Lindsay Lohan, dívidas e estrelas pornôs. O que poderia dar errado? O que acontece quando você contrata ll.	Aqui está o que acontece quando você lança Lindsay Lohan em seu filme
Monstros sauditas tentam defender a execução da empregada do Sri Lanka # p2 # tcot	Saudis defender a decapitação de Maid
Ele nvr prevê uma provisão de visão e ele usará Wheevr2bring It? O canal a cabo de Winfrey está equilibrado.	Winfrey? s canal a cabo de baixa classificação está pronto para romper
Um deve ler! por ! Como # Turquia pode fazer as pazes com os curdos #	Colaborador de Op-Ed: Como a Turquia pode fazer as pazes com os curdos
A adorável peça no NYT em um casamento de 40 anos e como o filho gay deles? A luta se tornou um unificador	Fazendo o último: o conservador encontra o casamento liberal e o casamento de 40 anos
O que exatamente está acontecendo no Mali? @	Os franceses dizem ataques aéreos no Mali? bloqueado? Avanço rebelde
Gabby e Mark: The New Bradys of Gun Control # Tgdn Libs joga sujo como norma	O novo 'Bradys' do controle de armas?
O videogame da NRA cheira a hipocrisia # nra # guuncontrol	Hipocrisia de videogame da NRA
Frum: # nós. # problema de armas não é um problema de corrida	O problema das armas da América não é um problema de corrida
Tudo de uma criança iniciando uma petição online. NYTIMES: PepsiCo interromperá o uso de aditivo em Gatorade	Gatorade ouve um adolescente e muda sua fórmula
Al Pacino para interpretar Joe Paterno no filme tentador de Brian De Palma "Happy Valley" # Sportsbiz	Pacino para interpretar Paterno no filme
Fonte diz que pelo menos 150 ": pelo menos 90 mortos no incêndio de boate brasileiro, dizem as autoridades".	Centenas mortas no incêndio da boate do Brasil
NYTIMES: Desmistribuindo Darwin. Ele estava errado sobre namorar? # sexo # gênero	Opinião: Darwin estava errado sobre o namoro
do grupo de negócios de ela possui ... mais pensamentos sobre o crescimento de seus negócios - e ajudando os funcionários	Você é o blog do chefe: mais pensamentos sobre o crescimento de seus negócios - e ajudando os funcionários
Bem, pelo menos sabemos que os slides funcionam agora.	Boeing 787s são aterrados por companhias aéreas japonesas
NYTIMES: O que não sabemos que está nos matando -pode concordar mais! por exemplo , Pesquisa sobre IPV Homicidas e armas é fundamental.	Editorial: o que não fomos? Eu sei que está nos matando
Proposta de armas BHO 2 olha além dos tiroteios em massa para tomar medidas para desarmar completamente os americanos, para que apenas elite o prtctd	Proposta de armas de Obama para olhar além dos tiroteios em massa
O pedágio mortal de bombas de cluster na # Síria	Tolho horrível de bombas de cluster
! Pague adiante - nota em um guardanapo: 'Esta refeição está em nós' -	Nota sobre guardanapo: 'Esta refeição está sobre nós'
Jacqui Weaver diz ao NY Times :? Eu tenho amigos na Austrália que agora se referem a mim como? Hollywood Jack? ?	Jacki Weaver e o senhor da vila de Greenwich
Flores no inverno? Camellias são algumas das minhas pré -reenais favoritas.	No jardim: Camellias prontas para uma estampa fria
vá # Obama. Obama pede uma ação ampla sobre armas	Obama pedir ao Congresso que endureça as leis de armas
O # Paquistão está se tornando " # Southasia's # Dreamliner"? - Official recusa a prender o primeiro -ministro Ashraf	Oficial paquistanês se recusa a prender o primeiro -ministro
O Google ganha ao criar aplicativos para o # iPhone # Healthit # hcsm	Google ganha com a criação de aplicativos para a oposição
Eu definitivamente estava gastando em partituras obscuras e tickest. # Missentyouth	Big City: Nova geração confronta luxo inacessível de comida
uma lacuna de geração? Não neste site (Harvard Business School)	Um 20 e poucos anos? s site para mulheres com mais de 40 anos
Eddie Huang no NY Times. Eu vibro esse cara com tanta força	Eddie Huang desafia a descrição
Rangel: Militar mais igual? Traga de volta o rascunho # implantação # USAF # militar	Um militar mais igual? Traga de volta o rascunho
França enfrenta jihadistas do Mali	A França promete interromper os jihadistas do Mali
A quantidade de organizações e clubes na # College é esmagadora! Escolha cuidadosamente antes de dedicar seu tempo:	The Choice Blog: Lições de um estudante universitário: encontrando seu ajuste no campus
lol .. errm .. "teste" nos EUA de um. ? # droga ! : A Coréia do Norte diz que o novo teste nuclear fará parte da luta contra os EUA :?	n. A Coréia faz novas ameaças contra os EUA.
# Morsi? S insuficiários contra # judeus provocam preocupação de alguém no governo de # Obama sabe como ler # English?	Morsi? S insuficiários contra os judeus provocam preocupação
"Vine é a tentativa do Twitter de ser o Instagram do vídeo", formam uma frase mais nerd. Não tente! é impossível!	Vine é a tentativa do Twitter de se tornar o 'Instagram do vídeo'
Mark Sanford, o ex-governador da Carolina do Sul e "Caminhando a trilha dos Apalaches", para concorrer ao Congresso	Sanford, ex-governador da Carolina do Sul, para concorrer ao Congresso
Para onde ir em 2013 por! Oferece explorações perspicazes para a maioria delas!	os 46 lugares para ir em 2013
Peter não está entre os dez primeiros, mas Mo, Bertie e Gus são? : "Os principais nomes de bebês de 2013"	Os principais nomes de bebês do Parenting.com
NYTIMES: # Queens # A escola está trancada depois que a # Gun for encontrada na criança de 7 anos? S Backpack não há fim?	arma encontrada em 7 anos de idade? s Mochila na Escola Queens
O que Choo está falando sobre o sr. D ...... RIP Conrad Bain, pai? diff? Alugar golpes? , morre aos 89 anos	Conrad Bain, ator? diff? Alugar golpes ,? morre em 89
O Facebook revela a nova ferramenta de pesquisa:	Bits Blog: Facebook revela uma nova ferramenta de pesquisa
# GunReform para uma geração	Editorial: Presidente Obama? S Plano de Reforma das Armas
Sou eu, ou é o principal ingrediente em açúcar de coque? Nos anúncios, a Coca -Cola confronta refrigerante? s Link para a obesidade	Os anúncios de TV de Coca -Cola enfrentam obesidade e refrigerante? papel
Excelente análise da recuperação do mercado imobiliário - a habitação oferece esperança de força na economia	Finanças altas e baixas: sinais de um ponto de recuperação de habitação para uma economia mais forte
Williams começa rápido, mas o ritmo atende foguetes	Williams começa forte, mas as redes não? T sigo em perda para foguetes
Quebra tudo! ! ! J.J. Abrams para dirigir o próximo filme de 'Guerra nas Estrelas'	J.J. Abrams para dirigir o próximo filme de 'Star Wars'
Uau: anunciando o plano de contratar todos os veteranos que querem um emprego - algumas condições. Eles antecipam 100k + contratações:	Wal-Mart para anunciar um extenso plano para contratar veteranos
Na Grã -Bretanha, o basquete pode ser uma venda difícil.	Na Grã -Bretanha, o basquete é uma venda difícil
Pelo menos 90 mortos no incêndio da boate do Brasil "Kropp deixou esse país no tempo.	Centenas mortas no incêndio da boate do Brasil
Automato holandês retornando Zing para cozinhar holandês	Colocando tempero na cozinha holandesa
Homem realizado após ataque de metrô na Filadélfia OMG!	Homem realizado depois que a mulher jogada em trilhas de metrô na Filadélfia
Quem decide as leis da guerra? Pertence aos tribunais civis.	Análise de notícias: tribunais militares e crimes internacionais de guerra
O ex -governador do Alasca Sarah Palin não é um comentarista para a Fox News	Fox News e Sarah Palin se destacam
Os legisladores de Nova York concordaram com as mudanças nas leis de armas, mal	Os legisladores de Nova York esperam votar rápido em novas leis de armas
Lance Armstrong [finalmente] admite doping, diz que testemunhará	Armstrong admite doping e diz que testemunhará contra funcionários do ciclismo
Hong Kong recebe o título de velocidade da Internet com 54,1 Mbps.	Hong Kong recebe o título de velocidade da Internet
Onde está a justiça? 'Eles o percorreram porque ele era negro'	filho da vítima: foi um crime de ódio
Reflete sobre os médicos que tiram uma folga e começam a ver os pacientes novamente.	médico e paciente: quando o médico retorna ao médico
Sheen quer voltar para '2,5 homens', mas sua imagem passada arruinou isso? # COEPR205	Sheen quer voltar para 'dois homens e meio'
Boa leitura: Desafios para as mulheres na Índia:	Desafios de ser mulher na Índia
NYTIMES: Richard g. severo, escritores? escritor, morre com 84 grandes perdas	Richard G. Stern, escritores? escritor, está morto aos 84
Leia fantástica de sobre a impressão de narrativas: "... histórias, não algoritmos, dê ordem ao nosso mundo agitado".	Opinião: TV, a pessoa que pensa? s entretenimento de escolha
"2012: o ano do extremo # clima": # ClimateChange # seca # NationalClimatESessment # GlobalChangeResearch	Iht Rendezvous: 2012: O ano do clima extremo
La Vision AM? Ricaine Sur M.Kaspersky Estasta de segurança Flatteuse descobre a campanha cibernética	Bits bits: a empresa de segurança descobre a campanha de espionagem global
Doce e doce história. NYTIMES: Uma boneca? s mágico, livre para renovar	A magia de uma boneca, livre para renovar
Um novo boom imobiliário? Não conte com isso - por Robert J. Shiller -	Um novo boom imobiliário? vestir ? t Conte com isso
"(UK Fave)", companheiro, por que não ignora a noite da noite? Está muito frio. "-NYC assassinos nos últimos 9 dias	Murders de corte de ondas frias em Nova York significativamente
Pegue esse Texas. Casa Branca rejeita petições para se separar, mas os texanos lutam	Movimento de secessões do Texas, sem rejeição da Casa Branca
Nenhum acordo sobre as avaliações sindicais do professor; NYC corre o risco de perder US $ 450 milhões	NEW YORK CITY fala sobre avaliações de professores
Perspectiva interessante ... NYTIMES: Um novo boom imobiliário? Não conte com isso	Um novo boom imobiliário? vestir ? t Conte com isso
Batalha por trás do 'firewall' da China	Trabalhando por trás do 'Grande Firewall' da China
NYTIMES: Análise de Armstrong? s entrevista com a vergonha de Winfrey (mas nós sabemos) # congrutalionlance	The Lede Blog: Atualizações ao vivo na entrevista de Oprah de Armstrong
Muitos homens tty tty na Índia: outro estupro de gangue	Seis presos por novo estupro de gangue no ônibus
Vodka está salvando vidas! Bem, a vida de um filhote ...	A bebida salva a vida de Puppy
JL # NYT: EUA Militar para enviar alguns detidos para a custódia afegã # P2 # TopProg	nós. Militares para de enviar detidos a algumas prisões afegãos sobre temores de direitos
amando o estilo de rua do # Couture em # Paris # moda	T Magazine: estilo de rua da alta costura em Paris
perguntou muitas pessoas (incluindo a sua de verdade) se # Lancearmstrong merece outra chance. Vistas interessantes	dar a Lance outra chance?
Fotos de viagem que você gostaria de ter tirado -	Foto de hoje: Templo tailandês
# Pentágono para levantar a proibição de combate para mulheres ... que tal banir combate para homens? ?	Pentágono Bail de levantamento de mulheres em combate
Fazendo bem (e imagens de polimento também) # celebridade # caridade	The Carpetbagger: Fazendo bem (e imagens de polimento também)
A moeda do Irã cai ainda mais na pressão dos EUA sobre as transações dos bancos	A moeda do Irã cai ainda mais nas preocupações sobre o banco
'Kitty Cams Study descobriu que quatro dos gatos estavam com dois tempos' e muito mais nesta história de gatos.	Bem, animais de estimação: Holly the Cat's Incredible Journey
A associação do sindicato cai para 97 anos, 11,3 %. As pessoas ainda encontrarão maneiras de culpá -las por tudo.	A associação do sindicato cai, apesar do crescimento do emprego
Quem gasta tanto dinheiro com comida? Isso é tão retardado :) O luxo inacessível da comida	Big City: Nova geração confronta luxo inacessível de comida
Enviado do aplicativo CNN para Android pelo menos 245 mortos no incêndio de boate do Brasil	Centenas mortas no incêndio da boate do Brasil
# O Google ganha com a criação de aplicativos para # iPhone. O Google Maps é o aplicativo # 1 #.	Google ganha com a criação de aplicativos para a oposição
Reúna -se Sun ( # Oracle)! A Segurança Interna alerta os usuários para desativar o Java. # segurança cibernética	Interrupções: EUA Agência alerta do problema de software Java
irreal? : Se você não ouviu falar do ataque ácido ao diretor de Bolshoi. ?	Ataque ácido ao diretor de balé da Rússia
trágico. Meus pensamentos e orações vão para todos ... "Pelo menos 220 mortos no fogo da boate do Brasil"	Centenas mortas no incêndio da boate do Brasil
Batalha legal potencialmente explosiva: o Hospital Católico argumenta que o feto não uma pessoa	Os advogados do Hospital Católico argumentam que o feto não uma pessoa
Kyle Stanley ganhou com a dor de chumbo desperdiçado em Torrey Pins: Kyle Stanley nesta semana está de volta a Torrey Pines, ...	Kyle Stanley ganhou com a dor de chumbo desperdiçado em Torrey Pines
escassez e tomada de decisão financeira.	Esperando: em dívida e cavando mais fundo para encontrar alívio
puta merda! : ("2 mortos quando o helicóptero colide com Crane no centro de Londres"	Helicopter Crashes na hora do rush de Londres
nós. Malto único # Whisky chegou	Os uísques americanos de grande porte servem a notificação
alergia-bullying? Aparentemente, este é um problema real.	Bullying de alergia: quando a comida é uma arma
O mundo aguarda a entrevista de Armstrong de Oprah, não eu, não estou assistindo	O World aguarda a entrevista de Lance Armstrong de Oprah - mas isso mudará alguma coisa?
Homicídio # 2 Causa de morte em 15 a 24 anos de idade em US-4 em 5 dessas mortes por armas	America repleto de seu exame de saúde
Uma boneca da biblioteca é emprestada a crianças:	A magia de uma boneca, livre para renovar
O Senado é chave para consertar Washington - obrigado por esse insight Ari # P2 # TCOT	Chave do Senado para consertar Washington
# Cuba restringe a viagem para pessoas 'qualificadas'	Cuba limita a viagem para atletas, trabalhadores
O que está impulsionando nosso crescimento no governo gasto # fatos	O que está impulsionando o crescimento dos gastos do governo?
É um começo! Parabéns a este garoto! ! ! PepsiCo interromperá o uso do aditivo no Gatorade	Gatorade ouve um adolescente e muda sua fórmula
A armas apoiadas por Obama contam um tiro no escuro. "Esta é uma questão que eu e o presidente concordamos".	A reforma é um tiro no último Congresso
Além da cobertura da mídia de suas emoções, # Clinton divulgou boas informações: Cinco coisas que aprendemos com as audiências de Benghazi	5 coisas que aprendemos com as audiências de Benghazi
2 # França: Não somos os pacifistas que você pensa	Por que a França não é nação pacifista
Alterar as regras = Prez Romney: “: As mudanças no colégio eleitoral representariam perigo 4 democratas”	FivethirtyEight: as mudanças no colégio eleitoral representariam perigo para os democratas
Como visto na TV! ~ preto e famoso, mas fora de pasto	crítico? S Notebook :? Maridos de verdade de Hollywood? e falta de pistas masculinas negras
: Relatório: 650 reféns libertados pelas forças da Argélia	Medo, confusão na crise de reféns da Argélia
Ore para que eles fiquem juntos pelas razões certas - Kobe Bryant, esposa cancelando o divórcio -	Kobe Bryant e esposa chamam o divórcio
Histórias angustiantes: membros quebrados, vive rasgados no norte # Mali	membros quebrados, vidas rasgadas no Mali
# Os jogadores da NHL começam a votar no acordo trabalhista; aprovação esperada até sábado # abasal # antitruste	Slap Shot: N.H.L. Os jogadores começam a votar no acordo trabalhista; aprovação esperada até sábado
mais de 50 anos, e sob ilusões acima de 50 anos? Invente -se todos os dias!	Como 5 trabalhadores mais velhos viram uma chance de refazer suas carreiras
O poder das revisões de usuários - empunhado para o bem ou o mal? NYTIMES: Enxames um livro online	Uma vítima no campo de batalha da Amazon? s críticas de livros partidários
Coisas legais: 6 tendências que vimos na CES 2013 -	6 tendências da CES 2013
Pelo menos 233 mortos no incêndio de boate brasileiro. : (	Centenas mortas no incêndio da boate do Brasil
Notícias tão tristes: 245 pessoas mortas no incêndio da boate do Brasil.	Centenas mortas no incêndio da boate do Brasil
ai, possivelmente? ": NYTIMES: a cultura de negócios do Japão paira sobre a escolha da bateria da Boeing"	senso comum: seleção do Boeing 787? Sorker de bateria levanta questões
Que perda de uma mente ótima e inspiradora! Ativista da Internet, um criador de RSS, está morto aos 26 anos, aparentemente um suicídio	Aaron Swartz, ativista da Internet, morre em 26
É hora da prisão, Charlie Brown	Boa tristeza! Charlie Brown Ator cobrado
Por fim, a verdade ... Armstrong admite doping e diz que testemunhará	Armstrong admite doping e diz que testemunhará contra funcionários do ciclismo
Estou chamando BS! ! ! NYTIMES: Morsi diz que seus insultos de judeus foram retirados do contexto	Morsi diz que insultos de judeus foram retirados do contexto
Se você é um esquiador ou um carrinho de neve, você vai cavar estes: em encostas nevadas, os dedos deslizam na tela de toque.	App Smart: os aplicativos ajudam os esquiadores a obter mais das encostas - App Smart
David Gergen diz que a 2ª inauguração de Obama aprofundará a divisão. # não foi o dianteiro	O discurso histórico de Obama foi divisivo?
Por favor, leia: A peça do terrível pedágio de bombas de cluster mortais em # Síria:	Tolho horrível de bombas de cluster
# csis388 _ Dave Facebook interrompendo o namoro online	Como a pesquisa de gráficos do Facebook pode atrapalhar o namoro online
nós. Aumenta o envolvimento em Mallpp # PPPJ # # P # PL # # P # # # P	nós. Passar um envolvimento no Mali
Eu fui atrás de armas. Obama também pode. Uma das únicas coisas que eu concordo com Howard.	Colaborador de Op-Ed: Austrália proibiu armas de assalto. A América também pode.
Então, Wang Lijun construiu uma rede de vigilância. - Oficiais do partido chinês e de negócios demitiram em escândalo sexual	Autoridades chinesas dispararam sobre escândalo sexual
NYTIMES: Ela é (raramente) o chefe inteligente, como sempre	Colunista de opções: ela? s (raramente) o chefe
WOW ": pelo menos 245 mortos na atualização do incêndio de boate do Brasil:"	Centenas mortas no incêndio da boate do Brasil
HOT # Notícias de luxo: as companhias aéreas japonesas suspendem os voos da Dreamliner após a terra de emergência? , veja mais	As companhias aéreas japonesas suspendem voos Dreamliner após pouso de emergência
Todos devem ler a coluna CNN de hoje:	O problema das armas da América não é um problema de corrida
# Breaking: # Police Clash com # manifestantes pedindo dissolução do governo do # Paquistão -	Polícia, manifestantes colidem no Paquistão
Mubarak vai para a prisão	Hosni Mubarak, do Egito
Honestamente, onde os direitos das pessoas estão sendo arruinados em Obama? proposta de controle de armas	o que ? está em Obama? proposta de controle de armas
Isso é estranho! TSK! - Hospital Católico argumenta que o feto não uma pessoa	Os advogados do Hospital Católico argumentam que o feto não uma pessoa
Ótimo de ter no pool de imprensa para discutir sua peça sobre o impulso do presidente pelo controle de armas.	Biden se reúne com os democratas da Câmara em propostas de violência de armas
O clássico jogo da fama americana e culpa. o ponto de lança	Colunista de Op-Ed: o ponto de Lance Armstrong
# Djokovic define miras na # Paris Party	Djokovic: 3 vitórias australianas
# O primeiro -ministro do Paquistão intervém no inquérito de incêndio	Paquistão? s Ashraf intervém na investigação fatal de incêndio
Cuidados e irmãos de parentesco: Depois de # FosterCare Yrs, uma mulher se torna um modelo para suas irmãs	Os casos mais necessitados: depois de um orfanato, tornando -se um modelo para suas irmãs
Parece que poderíamos acertar algo	GOP Balks em propostas de controle de armas
Você deve ler isso: o levantamento de um véu, discretamente	O relógio da TV: Jodie Foster levanta um véu no Globo de Ouro
peça interessante! sendo bin Laden # filmes # zerodarkthirty	Colaborador de Op-Ed: Eu joguei Osama bin Laden In? zero escuro trinta?
u ds boi ehn ": piers bate convidados sobre os ar-15s"	Piers, convidados colidem com os AR-15s
Tweet ruim (notícias) do dia ": Para vítimas de estupro na Índia, a polícia é frequentemente parte dos relatórios de problemas"	Para vítimas de estupro na Índia, a polícia geralmente faz parte do problema
Esses agentes da lei vão parar em nada	Revisão do filme :? Esquadrão de gângster? Com Sean Penn, Ryan Gosling e Emma Stone
Populista sem uma espinha dorsal eleita pelo voto popular apoiado pela campanha de mídia pesada # Zeman # Czechrepublic	Ex -primeiro -ministro é eleito presidente da República Tcheca
Artley: Obtendo 10 milhões de seguidores no Twitter	Como conseguir 10 milhões de seguidores no Twitter
Hmmm ela está pedindo falência ..	Casey Anthony arquiva a falência
# Mali não precisa ser França? é o Afeganistão	Iht Rendezvous: Mali não precisa ser o Afeganistão da França
Guerra ao mal? Guerra contra os sociopatas? A proibição de armas parece que funcionará muito melhor do que as coisas de guerra às drogas.	Proposta de armas de Obama para olhar além dos tiroteios em massa
estar seguro. Ouvi dizer as notícias sobre a poluição do ar da China que é terrível	A China permite que a mídia relate uma crise alarmante de poluição do ar
Um médico heróico retorna ao Congo	Doutor retorna ao Congo e é aclamado como um herói
NYTIMES: D. Brainerd Holmes, líder em corrida espacial, morre em 91	d. Brainerd Holmes, o principal oficial da NASA, morre em 91
179 Republicanos Vote não ... A Câmara aprova US $ 50,7 bilhões em ajuda de emergência para # vítimas de areia	Câmara aprova US $ 50,7 bilhões em ajuda de emergência para vítimas de tempestades
Economista vencedor do Nobel sobre por que devemos nos preocupar com # mudanças climáticas.	Sobre a não equivalência de gases de efeito estufa e gastos com direitos
NYT a maioria por e -mail: Pentágono definido para elevar a proibição de mulheres em papéis de combate: a decisão inovadora derruba um 199 ...	Pentágono Bail de levantamento de mulheres em combate
É risível acreditar em toda a história, eles nunca se conheceram? A imagem se torna um quebra -cabeça como teorias no TE? Ó balança	Imagem de Manti Te? o se torna quebra -cabeça à medida que as teorias giram
Quem pensou que um herói americano poderia ser canadense? NYT: Homem que abrigou os americanos em Teerã, morre aos 88 anos	John Sheardown, canadense que protegeu os americanos em Teerã, morre aos 88 anos
O spinoff de 'Vampire Diaries chegando à CW, é baseado em Nola!	O piloto de spinoff 'dos' Vampire Diaries 'chegando ao CW
Pobre criatura mt em meio a 2d adivinhação, os socorristas marinhos decidem não remover o golfinho atingido do canal de Gowanus.	a decisão difícil de não resgatar um golfinho doente
CNN: Confrontos do Egito: uma decisão da corte egípcia severa amarrada a um tumulto de futebol estimulou confrontos que deixaram pelo menos 30 pe ...	O Egito implanta tropas para processar os confrontos 'fora de controle'
Lance Armstrong Citações, ouro puro	Citações clássicas de Lance
Os preços do gás aparecem um pouco	Os preços do gás passam um pouco
A estrela indiana (Sania Mirza) fala de vida e casamento na mídia de peixe	Conjuntos retos: a estrela indiana conta sobre a vida e o casamento na mídia de peixes
O pai é definido como um ponto de origem. Não fiz sendo o melhor pai que posso ser para Ben. não por uma medida muito longa	Famílias das vítimas de massacre escolares de Newtown se organizam contra a violência armada
Novo # o Facebook muda em andamento - não para o seu perfil (ufa!) - Um novo recurso, # GraphSearch.	O Facebook apresenta 'Pesquisa de Gráfico'
Analisando o que Jodie Foster fez (e não disse) que deve ser honesto: eu não tinha idéia do que ela estava dizendo. # Goldenglobes	The Carpetbagger: analisando o que Jodie Foster fez (e não disse)
Aaron Swartz, ativista da Internet e criador do RSS, está morto aos 26 anos, aparentemente um suicídio.	Aaron Swartz, ativista da Internet, morre em 26
MT: NY Health Chief defende a decisão de não evacuar hospitais \ \ \ \ \ \ \ \ \ \ \ \ \ \ \ \ \ \ \ \ \ \ \ \ \ \ \ \ \ \ \ \ \ \ \ \ \ \ \ \ \ \ \ \ \ \ \ \ \ \ \ \ \ \ \ \ \ \ \ \ \ \ \ \ \ \ \ \ \ \ \ \ \ \ \ \ \ \ \ \ \ \ \ \ \ \ \ \ \ \ \ \ \ \ \ \ \ \ \ \ \ \ \ \ \ \ \ \ \ \ \ \ \ \ \ \ \ \ \ \ \ \ \ \ \ \ \ \ \ \ \ \ \ \ a importância	O chefe de saúde de Nova York defende a decisão de não evacuar hospitais
um caso quando você pode querer tirar a merda de outra pessoa ...	nojento, talvez, mas o tratamento funciona, o estudo encontra
Bom artigo sobre a economia e a cultura que alimenta o ciclismo profissional. NYTIMES: Olhando upstream em casos de doping	Os críticos dão uma olhada em escândalos de doping
# Wal-Mart planeja contratar qualquer # veterano que queira um # emprego	Wal-Mart para anunciar um extenso plano para contratar veteranos
maneira horrível de sair ... ": pelo menos 220 mortos no fogo da boate do Brasil"	Centenas mortas no incêndio da boate do Brasil
a importância de tirar um dia de folga	a importância de um 'dia de parada'
Cuidado com idosos: a oportunidade da comida é mais do que refeições sobre rodas.	Estudo: mais para entrega de refeições do que alimentos
NYTIMES: Falando, objetos de caminhada (este é um mundo de fantasia para mim nerd)	Opinião: Nossos objetos falantes, ambulantes
Eu acho que um monte de ternos da UCI precisam trocar suas calças no tempo: Armstrong admite doping e diz que testemunhará	Armstrong admite doping e diz que testemunhará contra funcionários do ciclismo
Que droga (r) ... NYTIMES: Armstrong admite doping e diz que testemunhará	Armstrong admite doping e diz que testemunhará contra funcionários do ciclismo
'Million Man March' ameaça # Paquistão Capital - CNN,	'Million Man March' promete paralisar a capital paquistanesa
Isso vai ser fantástico para entretenimento:	? South Park? Criadores para iniciar a empresa, estúdios importantes
": Voz de Charlie Brown preso, acusado." Por favor, diga -me que ele disse boa dor ...	Boa tristeza! Charlie Brown Ator cobrado
, este discurso anti-livre novo direito francês sobre o Twitter deve identificar pôsteres racistas e anti-semitas, via	Tribunal francês: o Twitter deve identificar usuários racistas
A temporada de gripe está aqui, vamos claramente algo: "Eu preciso de um tiro de gripe se eu tivesse gripe?"	Pergunte bem: eu preciso de um tiro de gripe se tive gripe?
Kobe Bryant, esposa diz que está diminuindo # divórcio -	Kobe Bryant e esposa chamam o divórcio
Artigo inspirador de Chelsea Clinton sobre o voluntariado neste sábado - Dia Nacional de Serviço	Clinton: Podemos fazer a diferença
Você leu o # Opinistrador o relacionamento entre pais e professores? Liza Lee foi entrevistada. # Edchat	Opinionador | Escola: o dueto de pais e professores
MT Design agora rivaliza com a tecnologia em importância	Interrupções: Interrupções: o design está impulsionando a tecnologia para a frente
uhhhh 10 razões pelas quais não podemos obter o suficiente yummie	Por que não podemos obter o suficiente (duh!)
Vulnerabilidade Java devido ao patch incompleto (de)	Vulnerabilidade crítica de Java devido a um patch anterior incompleto
NYTIMES: Ótimo obit em Dear Abby.	Pauline Phillips, conselheira de Flinty para milhões como querida Abby, morre aos 94
Robôs nos tornando mais competitivos na fabricação:	Os fabricantes de robôs espalham o Evangelho Global de Automação
A edição de python birmaneses da Flórida leva ao concurso de assassinato de cobras. - ...	Florida enfrentando o problema do Python com o concurso de caça
Site de rastreamento de homicídios em expansão para # Chicago adora. Ótima chamada e parabéns	Blog de decodificador de mídia: site de rastreamento de homicídios em expansão para Chicago
180! “: Pelo menos 90 mortos no Brasil Nightclub Fire”	Centenas mortas no incêndio da boate do Brasil
Você está melhor "tocando para um empate" em # investindo:	Estratégias: Ao investir, pelo menos, faz sentido jogar por um empate
Aumente sua resposta à gripe com exercício	Exercício pode aumentar a potência da gripe
Para Obama? s Novo termo, comece aqui - Nick Kristof para NYT	Colunista de Op-Ed: Para Obama? s Segundo termo, comece aqui
Pior pesadelo! ": Pelo menos 245 mortos na atualização de incêndio da boate do Brasil:"	Centenas mortas no incêndio da boate do Brasil
Alguém tentou isso? ? Amazon dando a você mp3s grátis seus CDs	Amazon dando a você mp3s grátis de seus CDs
Porra, talvez eu não deva ser tão otimista sobre o nevoeiro de Londres:	Helicopter Crashes na hora do rush de Londres
# Os motoristas de ônibus escolares de Nova York entram em greve de corrupção de ônibus escolares de Nova York e, em alguns casos, o crime organizado	Os motoristas de ônibus escolares de Nova York entram em greve
Que tal um caminho para # cidadania para aqueles que já foram pegos atravessando a fronteira #? # Caminho da cidadania em um empurrão rápido	Obama buscará o caminho da cidadania em um empurrão rápido
boa leitura. Concordo - principalmente ": pais? O apoio financeiro pode não ajudar as notas da faculdade"	pais ? apoio financeiro vinculado às notas da faculdade
J.J. Abrams definido para dirigir? Guerra nas Estrelas: Episódio VII?	J.J. Abrams para dirigir o próximo filme de 'Star Wars'
Para enfrentar alguém que já atirou em um aluno .. ": Eu não sou herói, diz o professor que falou com um aluno armado."	O professor fala sobre o aluno armado a desistir, diz a polícia
() O Brasil recebe o maior desfile de FAG do mundo. # FagsdoomNations 245 pessoas mortas no Brasil Club Fire.	Centenas mortas no incêndio da boate do Brasil
Tea Party infeliz. Fox News dispara Sarah # Palin	Fox News e Sarah Palin se destacam
no ponto ... 5 palavras de vinho para não temer	o derramamento: ao descrever vinhos, 5 palavras para não temer
Veja também: NYTIMES: Em Quebec, uma celebração em esquis	em Quebec, uma celebração de inverno em esquis
A vida começa na concepção, a menos que o CAS esteja envolvido.	Os advogados do Hospital Católico argumentam que o feto não uma pessoa
Essa seria uma idéia muito, muito ruim. A Coréia do Norte ameaça a Coréia do Sul ONE Sanções:	Coréia do Norte vira sua ira na Coréia do Sul
em N.A.A.C.P. , a indústria se alia contra a proibição de refrigerantes hmmmmmmmm. . . .	no tribunal, N.A.A.C.P. Adiciona voz contra a Bloomberg? s proibição de refrigerante
sobre maldito tempo! ! ! O governador de Nova York assina a primeira lei de controle de armas da nação desde Newtown -	Nova York para aprovar a primeira conta de controle de armas desde o tiroteio de Newtown
Desemprego em # Espanha sobe novamente, sem alívio à vista ...	O desemprego espanhol sobe novamente, sem alívio à vista
Timothy Cook, Apple? S CEO, disse que o pipeline de produtos era? Chock-Full. ? ? Nós nos sentimos ótimos com o que temos reservado?	maçã ? Os lucros são planos e gotas de estoque
Leia que o Facebook lançou uma nova ferramenta () para pesquisar seu enorme banco de dados de dados de gráficos sociais.	Bits Blog: Facebook revela uma nova ferramenta de pesquisa
Não sei por que eu não consigo parar de ler sobre ele - um cruzado de dados, um réu e agora, uma causa	Aaron Swartz, um cruzado de dados e agora, uma causa
Eu gostaria de poder ver isso, parece legal! Segundo estágio acrescenta 'ninguém te ama'	ArtsBeat: O Second Stage Theatre acrescenta 'ninguém te ama'
NYTIMES: # Lindarisspugach, cuja vida foi arrancada de manchetes, morre a 75 # Crazylove	Linda Riss Pugach, 1937-2013: Linda Riss Pugach, cuja vida foi arrancada das manchetes, morre aos 75
Versão 3D de? Gun superior? foi rejeitado pelos censores da # China. A linha "religião é escuridão 'em" vida de pi "gt o x também	Nos filmes de Hollywood para a China, os burocratas querem dizer uma opinião
. Kobe acabou de economizar cerca de US $ 100 mil	Kobe Bryant e esposa chamam o divórcio
O executivo de comunicações do NY Times, Bob Christie, está saindo. Um dos poucos bons porta -vozes da indústria.	Times Communications Executive está saindo
RIP eu não tenho palavras: (pelo menos 245 mortos no Brasil Nightclub Fire -	Centenas mortas no incêndio da boate do Brasil
Valores da propriedade: o que você ganha por ... US $ 1,6 milhão	Valores da propriedade: imóveis por US $ 1,6 milhão
# Os fãs de Twolves devem ler esta peça sobre KG no NYTIMES	com ele ou contra ele
A Índia é um lugar chocantemente ruim para ser uma mulher - como pode ser tão para trás? ?	Índia ? O novo foco no estupro mostra apenas a superfície das mulheres? s perigos
Cuidado com o que você come - principalmente em restaurantes! ! !	9 bombas de calorias em restaurantes
# O primeiro -ministro da Grã -Bretanha defende a decisão de procurar votar no # Europeanunion	Reino Unido. O primeiro -ministro defende a decisão de buscar a UE. voto
Onde no mundo está africa? A seleção do fabricante de baterias do Boeing 787 levanta questões	senso comum: seleção do Boeing 787? Sorker de bateria levanta questões
As mulheres fizeram seus posts com uma calma tão perfeita que o país mal notou. '	Colunista de Op-ed: Mulheres militares e as linhas de frente
O juiz Thomas não disse uma única palavra na Suprema Corte em 7 anos. Ele quebrou seu silêncio. Ele disse "bem, ele não" não o fez "	Justiça Thomas quebra seu silêncio no tribunal
As crianças não podem confiar em qualquer um! ! ": 50 presos na picada de sexo infantil da Flórida - incluindo vários professores:"	professores entre 50 presos em picada de sexo infantil
Pentágono para levantar a proibição de combate	Pentágono termina a proibição de mulheres em combate
nós. , outras nações fundamentadas na Boeing Dreamliners sobre o risco de incêndio (CNN)	nós. , outras nações fundam os Dreamliners
Normalmente, eu não concordo com o ex -primeiro -ministro John Howard - mas ele está no controle de armas nos EUA	Colaborador de Op-Ed: Austrália proibiu armas de assalto. A América também pode.
Precisa de um selo de borracha do presidente Mao ou Lady Godiva em seu cavalo? almofada de tinta no w. A vila os pegou. # nabejoint	Ponto da vizinhança | West Village: 10.000 carimbos de borracha no bloco de tinta no West Village
O produtor da batida de artes diz que James Brown biografia é finalmente uma tentativa: os produtores dizem que ele obteve os direitos de ...	ArtsBeat: James Brown Biopic finalmente vá em frente
Isso é interessante - NYTIMES: PAIS? O apoio financeiro pode não ajudar as notas da faculdade	pais ? apoio financeiro vinculado às notas da faculdade
Ishikawa e Wiratchant convidados para Augusta	Ryo Ishikawa e Waworn Wiratchant recebem convites para mestres
Ótima idéia ": deve tornar os ganhos de capital regressivos ao longo do tempo, com base em quanto tempo o capital investiu # startupact"	Estamos vivendo o dilema do capitalista?
Notícias do Pentágono, isso será um grande debate.	Pentágono para abrir empregos de combate para mulheres
Omo dey go tey: Opinião: Nigerianos ainda esperando por sua 'primavera africana' Sowore -	Nigéria espera por 'primavera africana'
Não na minha dieta, mas os comedores de hambúrguer devem estar cientes * carne de cavalo encontrada em hambúrgueres na Grã -Bretanha e Irlanda -	Horsemeathed encontrado em hambúrgueres na Grã -Bretanha e na Irlanda
Internet online Aaron Swartz comete suicídio, diz um parente	Ativista on -line Aaron Swartz comete suicídio
Tem um tiro de gripe? O exercício pode fazer com que funcione ainda melhor. de	Exercício pode aumentar a potência da gripe
Para # Armstrong, é sobre a reconstrução de um fluxo de receita da mesma forma que sempre. # doprah	Para Armstrong, uma confissão sem explicação
Interrupções: Design rivais Tecnologia em importância: citações agradáveis!	Interrupções: Interrupções: o design está impulsionando a tecnologia para a frente
Antes que houvesse caro açúcar, havia Deary Abby: Pauline Phillips, conselheira de Flinty para milhões, morre aos 94	Pauline Phillips, conselheira de Flinty para milhões como querida Abby, morre aos 94
"A França está aumentando a segurança nos sites em # Niger e em casa." # Uranium # Mali	A França está aumentando a segurança nos locais de urânio no Níger
Em julgamento pelo uso ilegal de peças de unicórnio marítimo: # DailyWhale	2 Ligado a contrabando de presas Narwhal se declararam inocentes
n. Coréia desafiadora na ONU. sanções	un. O Conselho de Segurança bate a Coréia do Norte, expande as sanções
Dicas de treinamento de atletas estelares # motivação # fitness	Melhor pessoal: Insights de treinamento de atletas estrelas
Artigo interessante! Ela é (raramente) o chefe	Colunista de opções: ela? s (raramente) o chefe
Christensen: Somos o dilema de Capitalista Vivo	Estamos vivendo o dilema do capitalista?
O gengibre em mim ama o Bachelor # 1 do mundo faz parte da # Gingerfamily	Príncipe Harry Bacharel mais elegível
: - \ hmv entrou no equivalente à falência ...	Dealbook: o varejista britânico HMV entra em equivalente à falência
Realmente pessoas? ? ? ? : Os leitores procuram Lance Armstrong por reembolso de livros após a admissão de doping?	Os leitores procuram Armstrong por reembolso do livro
Mulher britânica condenada à morte no caso de drogas de Bali	Avó britânica condenada à morte por contrabando de cocaína para Bali
Revisão diária: Cartas selecionadas de William Styron # Revisão	? Cartas selecionadas de William Styron?