O México deseja garantir a segurança dos cidadãos.	O México deseja evitar mais violência.
Atualmente, a Espanha detém a presidência rotativa da OSCE.	Atualmente, a Espanha detém a presidência da OSCE.
O tratado foi assinado pela primeira vez em 1990.	O tratado CFE foi assinado em 1990.
Gorgich e Pashtoon foram executados na prisão.	Gorgich e Pashtoon foram executados para tráfico de heroína na província de Sistão-Baluchestão.
O seguro Bourada foi condenado a 15 anos de prisão.	Djamel Badaoui foi condenado a cinco anos.
Santos afirmou que o material radioativo era a base primária para gerar armas brutas de destruição em massa e terrorismo.	O urânio é um material radioativo que é a base principal para gerar armas sujas de destruição em massa e terrorismo.
Fulvio Berghella afirmou que o verme digital chamado SQ Hell era particularmente virulento e se replicou na taxa de 8000 vezes por hora.	Fulvio Berghella afirmou que o verme digital chamado SQ Hell tem uma capacidade muito alta para se replicar e o verme digital chamado SQ Hell está desacelerando a rede de computadores Poste Italiane e tornando alguns computadores inoperante.
Ingo Kober declarou que há maior interesse em direitos de propriedade intelectual agora do que há 20 ou 30 anos.	Ingo Kober afirmou que algumas nações tinham direitos de propriedade intelectual mais fortes que outros.
Os investigadores afirmam que a empresa britânica era uma cobertura da CIA.	Os investigadores russos afirmaram que a empresa britânica era uma cobertura da CIA.
Os países membros da Rússia e da OTAN realizarão reuniões neste outono nas forças convencionais na Europa (CFE).	O Parlamento russo votou por unanimidade para suspender a participação da Rússia nas forças convencionais na Europa (CFE).
O governo dos Estados Unidos e outros membros da OTAN se recusaram a ratificar o tratado alterado até que as autoridades de Moscou retiram tropas das antigas repúblicas soviéticas da Moldávia e da Geórgia.	Os Estados Unidos e outros membros da OTAN recusaram ratificar o tratado alterado até que a Rússia se retire completamente da Moldávia e da Geórgia.
A Rússia não aumentaria imediatamente a força militar ao longo das fronteiras russas.	A Rússia não hesitaria em aumentar a força militar ao longo das fronteiras russas, se necessário.
O centro estará operacional em agosto de 2008.	O centro abrirá formalmente em 2009.
A polícia brasileira em torno das favelas ao norte do Rio de Janeiro para livrá -las de traficantes violentos de drogas.	Os policiais cercaram as favelas ao norte do Rio de Janeiro para livrá -los de traficantes violentos de drogas e apreender armas e drogas.
Questões regionais e internacionais de não proliferação devem ser tratadas por meio de diálogo e negociações.	A segunda proposta era que questões regionais e internacionais de não proliferação deveriam ser tratadas por meio de diálogo e negociações.
O bombardeio ocorreu no Afeganistão, à medida que os ataques de insurgentes antigovernamentais aumentam nos últimos dias.	Um bombardeio ocorreu no Afeganistão, mas a polícia ainda não declarou quem é responsável.
Os sites do governo da Geórgia estão sob intenso ataque cibernético após ataques militares russos contra a Geórgia no final da semana passada.	Os ataques cibernéticos seguem ataques militares russos lançados contra a Geórgia no final da semana passada.
As relações comerciais e diplomáticas da Suíça com o Irã foram criticadas nos últimos meses depois que o ministro das Relações Exteriores Micheline Calmy-Rey viajou para Teerã em março de 2008 para assinar um acordo com a empresa estatal de gás do Irã.	As relações comerciais e diplomáticas da Suíça com a República Islâmica foram criticadas nos últimos meses depois que o ministro das Relações Exteriores Micheline Calmy-Rey viajou para Teerã em março de 2008 para assinar um acordo de gás.
As forças convencionais na Europa limitam o número de aeronaves militares, tanques e outras armas pesadas não nucleares na Europa.	As forças convencionais no Tratado da Europa foram assinadas por membros russos e da OTAN em 1990.
A União Africana propôs uma missão de manutenção da paz para ajudar o governo de transição da Somália a estabilizar a Somália.	A União Africana propôs uma missão de manutenção da paz para ajudar o governo de transição em dificuldades na estabilização da Somália, principalmente após a retirada das forças etíopes.
Os relatórios afirmam que o governo sírio estava escondendo uma instalação nuclear no local atacado.	un. Especialistas começaram a analisar relatos de que afirmam que o governo sírio estava escondendo uma instalação nuclear no local atacado.
A droga também é conhecida como gelo ou shabu.	A metanfetamina também é conhecida como gelo.
Esforços nacionais, regionais e internacionais para acabar com o comércio ilícito de armas pequenas e armas leves.	A comunidade global deve cooperar para acabar com o comércio ilícito de armas pequenas e armas leves.
O extremismo religioso continua no Paquistão, apesar da proibição de grupos militantes.	O extremismo religioso continua no Paquistão, apesar da proibição de grupos militantes pelo governo paquistanês.
As autoridades russas pediram uma conferência sobre as forças convencionais na Europa para discutir a ratificação do tratado alterado.	Antonov falou no dia anterior a uma conferência sobre as forças convencionais na Europa.
O presidente russo Putin assina o decreto suspendendo a aplicação da Rússia do Tratado de Controle de Armas Europeias.	O presidente Vladimir Putin assinou um decreto suspendendo a participação da Rússia nas forças convencionais na Europa.
Mianmar era anteriormente conhecido como Birmânia.	Mianmar era anteriormente chamado de Birmânia.
Alto Huallaga está localizado a nordeste da capital Lima.	Puerto Cabezas está localizado a 557 km a nordeste de Manágua, na Nicarágua.
A OTAN lamenta a decisão da Rússia de suspender a participação no CFE.	A decisão da Rússia de suspender a participação no CFE é um passo na direção errada.
As violações dos direitos humanos em Mianmar incluem execuções sumárias, tortura e recrutamento de crianças soldados.	Essas violações dos direitos humanos incluem execuções sumárias, tortura e recrutamento de criança
General Nikolai n. Urakov declarou por telefone que o Centro Científico do Estado de Microbiologia Aplicada possui sistemas de proteção bastante confiáveis ​​em caso de emergência.	General Nikolai n. Urakov é o diretor de longa data do Centro Científico do Estado de Microbiologia Aplicada.
A Alstom está em competição com países japoneses e alemães pelo contrato.	A Alstom está competindo contra a empresa japonesa Shinkansen e a empresa alemã ICE pelo contrato.
A legislação é o esforço mais recente do Japão para atribuir mais liberdade a seus militares fortemente controlados e anularia a proibição do uso militar do espaço.	A legislação é o esforço mais recente do Japão para atribuir mais liberdade aos militares bem controlados tecnicamente conhecidos como uma força de autodefesa.
A Coréia do Sul lança um novo trem de bala atingindo 300 km / h.	A Coréia do Sul tem um sistema de trem -bala desde os anos 80.
A Rússia é membro do quarteto no Oriente Médio.	A Rússia é membro do NSG.
Anatoly Sokolov anunciou-o sistema de defesa de mísseis A-135, construído soviético, em torno de Moscou, é obsoleto e ineficiente.	O sistema de defesa de mísseis A-135 construído soviético em torno de Moscou é obsoleto e ineficiente.
O acordo está em processo há vários anos.	A AIEA está investigando as atividades nucleares do Irã há 4 anos.
A adesão às obrigações de não proliferação aumentará a confiança mútua e promoverá a cooperação internacional em energia nuclear.	Zhang Yan afirmou que todos os países deveriam cumprir as obrigações de não proliferação, a fim de melhorar a confiança mútua e criar um ambiente sólido para a cooperação internacional em energia nuclear.
A empresa francesa de energia e transporte Alstom pode assinar um contrato para construir uma ligação ferroviária de alta velocidade entre Pequim e Xangai.	A Alstom pode assinar um contrato para construir uma ligação ferroviária de alta velocidade entre Pequim e Xangai.
Nenhum outro medicamento se tornou tão integrante em décadas.	A droga existe de outras formas há anos.
A Agência Internacional de Energia Atômica chegou a um acordo com autoridades iranianas que afirmavam que não havia questões e ambiguidades remanescentes em relação ao programa e atividades nucleares do Irã.	O acordo disse que não havia questões e ambiguidades restantes sobre o programa e as atividades nucleares do Irã.
A polícia de Pequim apreende mais de 20 pessoas, incluindo 8 estrangeiros em suspeita de usar e tráfico de drogas em 2 bares em uma área popular do centro da cidade.	A polícia de Pequim prendeu mais de 20 pessoas em suspeita de usar e tráfico de drogas em 2 bares no centro da cidade.
A Rússia ratificou o tratado atualizado em 2004, mas os Estados Unidos e outros membros da OTAN se recusaram a fazê-lo, argumentando que Moscou deve primeiro cumprir as obrigações de retirar as forças da Geórgia e da região separatista da Moldávia.	A Rússia ratificou a versão alterada, mas os Estados Unidos e outros membros da OTAN se recusaram a fazê -lo até que o governo russo retire as tropas das antigas repúblicas soviéticas da Moldávia e da Geórgia.
Há uma opinião conflitante quanto à extensão dos danos sofridos pela insurgência.	A violência continua apesar da opinião conflitante sobre a extensão dos danos sofridos pelos grupos rebeldes.
A Província de Helmand é a maior região mundial de produção de ópio.	A Província de Helmand é o maior produtor de ópio do mundo.
A polícia afirmou que Tsai Wen-Huang seria extraditado para Taiwan.	A polícia afirmou que- Chung esteve em fuga.
2 dos indivíduos presos foram libertados.	2 dos zambianos presos são jovens.
O presidente mexicano Felipe Calderon enviou 2800 agentes especiais e soldados a Sinaloa devido ao alto grau de crime organizado e tráfico de drogas.	O presidente mexicano Felipe Calderon enviou 2800 agentes especiais e soldados a Sinaloa para combater o tráfico de drogas.
Berlim sediará reuniões de nível superior em outubro para salvar as principais forças convencionais do Tratado de Controle de Armas Europeias na Europa (CFE).	A Rússia suspendeu sua participação em um importante tratado de controle europeu de armas que governa a implantação de tropas na Europa.
A reunião da OSCE durou dois dias.	A reunião da OSCE foi realizada em Madri.
O tratado CFE foi assinado em 1990.	O tratado CFE foi estabelecido em 1990.
O Irã insiste que o programa é destinado apenas a atividades pacíficas, como a geração de	O Irã insiste que seu programa nuclear é para fins pacíficos
A China é uma força importante para proteger a paz mundial.	A China é uma força importante para promover o desenvolvimento mundial.
A Coréia do Norte nega o envolvimento em qualquer programa nuclear na Síria.	A Coréia do Norte nega o envolvimento em qualquer projeto nuclear sírio.
Um porta -voz do Stockwell Day não estava disponível imediatamente para	As autoridades chinesas não estavam disponíveis imediatamente para comentar.
Kim Myong-chol alertou que, se houvesse uma interdição de navios norte-coreanos, o governo norte-coreano retaliaria com um ataque de mísseis nucleares a grandes cidades como Nova York e Washington.	Kim Myong-Chol afirmou que a Coréia do Norte retaliaria com um ataque de mísseis nucleares às principais cidades como Nova York e Washington DC.
O Irã é o aparelho mais prolífico da pena de morte do mundo depois da China.	A República Islâmica é o aparelho mais prolífico da pena de morte no mundo depois da China.
John Duncan é o embaixador da Grã -Bretanha para controle e desarmamento multilateral de armas.	Na Assembléia da ONU, o governo chinês pede maior esforço para o controle e o desarmamento globais de armas.
O tratado foi alterado em 1999 após o colapso da União Soviética.	O tratado foi alterado em 1999 para refletir mudanças desde o rompimento soviético.
A Caxemira é dividida entre a Índia e o Paquistão.	A Caxemira é reivindicada pela Índia e pelo Paquistão.
A Coréia do Sul e Israel se opõem à proliferação de armas de destruição em massa e uma corrida armamentista.	A China se oporá resolutamente à proliferação de armas destrutivas em massa.
Kadhafi adverte que o fracasso da Grã -Bretanha em compensar a Líbia pelo desarmamento nuclear impedirá o Irã e a Coréia do Norte de desarmar.	O fracasso dos países ocidentais em compensar suficientemente a Líbia impedirá o Irã e a Coréia do Norte do desarmamento.
A Rússia ratificou o tratado alterado.	A Rússia ratificou o tratado atualizado em 2004.
Uma equipe de 30 especialistas conduzirá pesquisas e treinamento sobre guerra cibernética e estará preparada para ajudar os membros da OTAN a resposta a futuros ataques cibernéticos.	Uma equipe de 30 especialistas conduzirá pesquisas e treinamento sobre guerra cibernética.
A ala juvenil de Jamaat-i-i-Islami realizou uma demonstração separada na Caxemira.	A manifestação de Jamaat-i-Islami da ala da juventude foi contra um ataque dos EUA ao Iraque.
O Irã é o aparelho mais prolífico da pena de morte do mundo depois da China.	A República Islâmica é o aparelho mais prolífico da pena de morte no mundo depois da China.
A China se oporá resolutamente aos meios da entrega de armas destrutivas em massa.	A China sempre se opôs à proliferação de armas de destruição em massa.
Um colapso da ordem na China levará a uma turbulência global significativa.	Um colapso da ordem na China será pior do que no Afeganistão ou na Iugoslávia.
A Coréia do Norte reivindicou ambições nucleares e atualmente a Coréia do Norte tem mísseis destinados ao Japão.	A Coréia do Norte se gabou de ambições nucleares e agora é relatado que a Coréia do Norte tem mísseis treinados em
Abuja é a capital de	Tskhinvali é a capital da Geórgia.
O governo dos Estados Unidos acusou o governo iraniano de tentar desenvolver armas nucleares sob a cobertura de um programa nuclear civil.	Os EUA e os aliados acusaram o Irã de tentar desenvolver armas nucleares sob o disfarce de um programa nuclear civil.
Tirana é a capital de	Abuja é a capital de
Em um conflito armado, a polícia iraniana mata 4 supostos traficantes de drogas, a prisão 2 e apreende quase 5 toneladas de ópio e morfina.	Durante confrontos armados no sudeste da polícia do Irã, apreendeu quase 5 toneladas (5,5 toneladas) de ópio e morfina.
Os projetos nucleares do Irã são para fins pacíficos.	O Irã insiste que seu programa nuclear é para fins pacíficos
A China se oporá resolutamente à proliferação de armas destrutivas em massa.	A China se oporá resolutamente aos meios da entrega de armas destrutivas em massa.
A China é o aliado mais próximo da Coréia do Norte.	A Coréia do Norte é um estado recluso.
O ministro das Relações Exteriores da Líbia, Abdel Rahman Shalgam, visitou Londres durante a primeira visita de um ministro das Relações Exteriores da Líbia desde 1969.	A visita de Shalgam a Londres é a primeira de um ministro das Relações Exteriores da Líbia desde 1969.
Goff afirmou que isso apresenta uma grande ameaça à segurança global.	Apresenta uma grande ameaça à segurança global.
O Camboja e o Vietnã finalizaram um acordo para interromper os traficantes de drogas asiáticos e europeus.	Autoridades sírias e russas assinaram um acordo de cooperação no combate ao tráfico de drogas.
Ativistas afirmaram que a Rússia está aprisionando as pessoas sem evidências de atividade ilegal.	A Rússia aprisiona as pessoas sem evidências de atividade ilegal.
Os grupos extremistas de restrição estão se tornando cada vez mais difíceis por causa de como os grupos são financiados.	Bruguiere afirmou- restringir grupos extremistas, particularmente em toda a Europa, estava se tornando cada vez mais difícil por causa de como os grupos são financiados.
Zabol é uma cidade no sudeste do Irã.	Khoramabad é uma cidade no oeste do Irã.
detidos a serem acusados ​​de homicídio, colaboração criminal, seqüestro e financiamento do terrorismo e incluem membros do militar e da polícia.	Iguaran afirmou que os detidos serão acusados ​​de homicídio, colaboração criminal, seqüestros e financiamento do terrorismo.
As hastes existentes podem produzir 3-6 bombas atômicas em 6-8 meses.	Especialistas afirmaram que as hastes podem produzir 3-6 bombas atômicas em 6-8 meses.
A Agência Internacional de Energia Atômica pode ter sido enganada porque estava ansiosa por um acordo.	O Plano Internacional da Agência de Energia Atômica extrai negociações por muitos meses.
O governo de Mianmar declarou que Mianmar se tornará livre de ópio até 2014.	O governo de Mianmar afirmou que Mianmar está a caminho de ser livre de drogas até 2014.
Grupo Judaico-Americano A Liga Anti-Difamação (ADL) publicou anúncios de página inteira em documentos suíços e internacionais em abril de 2008 acusando a Suíça de financiar o terrorismo através do acordo.	A Liga Anti-Difamação realizou anúncios de página inteira em jornais suíços e internacionais no início de abril de 2008 acusando a Suíça de financiar o terrorismo através do acordo.
A França fornece foguetes, armas e motores.	A Grã -Bretanha fornece tanques de combustível e caixas de câmbio.
As ofensas capitais na Arábia Saudita incluem estupro, assassinato, apostasia, assalto à mão armada e tráfico de drogas.	As ofensas capitais no Irã incluem assassinato, estupro, assalto à mão armada, tráfico de drogas grave e adultério.
A BAE Systems é a maior empresa de defesa do Reino Unido.	BAE Systems é o maior militar do Reino Unido
Lavrov disse a nós, secretário de Estado Condoleezza Rice, que a Rússia permanece aberta ao diálogo.	nós. O secretário de Estado Condoleezza Rice exigiu que a Rússia retirasse suas forças.
Indivíduos e entidades adicionais estão sujeitos a um congelamento de ativos.	A resolução inclui uma lista ampliada de indivíduos e entidades sujeitas a um congelamento de ativos.
A retirada do Tratado permitiria à Rússia reforçar as forças perto das fronteiras russas.	A retirada das forças convencionais na Europa permitiria à Rússia reforçar as forças perto das fronteiras russas.
Fan declarou que a Comissão está preocupada principalmente com o termo de investimento futuro em Taiwan.	Fan declarou que a Comissão garantirá que os compromissos sejam confirmados assim que os investimentos estiverem em andamento.
O porta -voz do governo, Maseko, afirmou que, se os documentos administrativos forem para o governo da África do Sul não puder intervir para impedir que as armas sejam transportadas por seu território para um país de litoral vizinho.	O porta -voz Themba Maseko afirmou que os documentos administrativos estão em ordem na África do Sul não podem intervir para impedir que as armas que sejam transportadas pelo território sul -africano para o Zimbábue.
A declaração do Presidente Dmitry Medvedev foi publicada no site do Kremlin e transportada por meio das agências de notícias do estado.	A declaração foi publicada no site do Kremlin e transportada pelas agências de notícias do estado.
Turquemenistão faz fronteira com o Afeganistão.	Sistan-Baluchestan faz fronteira no Afeganistão e no Paquistão.
O número de execuções aumentou no Irã no ano passado em meio a uma campanha que visa melhorar a segurança na sociedade.	O número de execuções aumentou dramaticamente em 2007 em meio a uma campanha que as autoridades iranianas estaduais visam melhorar a segurança na sociedade.
A Síria nega ter um programa nuclear não declarado.	A Síria nega a existência de um programa nuclear não declarado.
A Anistia Internacional é um grupo de direitos sediado em Londres.	O Instituto Internacional de Estudos Estratégicos está localizado em Londres.
O número 254 foi tabulado com uma contagem de AFP compilada dos relatórios da imprensa e das testemunhas.	O número de execuções no Irã em 2007 foi calculado por uma contagem de AFP compilada a partir de relatórios de imprensa.
O governo iraniano afirmou- o programa nuclear iraniano permanece pacífico.	O governo iraniano diz que o programa nuclear é pacífico.
Shingarev disse que é muito difícil fazer uma arma nuclear com o plutônio nesse combustível.	Donohue disse que é muito difícil manipular isótopos radioativos sem deixar uma trilha.
Paris é a capital da França.	Lima é a capital de
Um funcionário do governo indiano falou sob condição de anonimato.	O oficial falou sob condição de anonimato.
A Rússia ameaçou várias vezes para se retirar do CFE quando estava em desacordo com os Estados Unidos sobre os EUA planeja instalar um escudo de defesa de mísseis no leste	A Rússia ameaçou repetidamente a retirada do CFE em oposição aos planos para a extensão do escudo de defesa de mísseis dos EUA para a Europa Oriental.
O plano para a Tunísia é a criação de bancos de dados eletrônicos para facilitar a cobrança de impostos.	O plano para a Nigéria e Moçambique é a criação de um banco de dados eletrônico para imóveis.
A China foi elogiada pela Comunidade Internacional por esforços para resolver a questão nuclear da Península Coreana.	A China foi elogiada especialmente pelos estados da Ásia-Pacífico por esforços para resolver a questão nuclear da península coreana.
O Ministério das Relações Exteriores da Rússia declarou que a Rússia não suspendeu o diálogo.	As autoridades russas afirmaram que a Rússia não reconsiderará a suspensão.
Os contrabandistas de armas e os cartéis de drogas devem ser eliminados do sudeste da Ásia.	contrabandistas de armas e cartéis de drogas incentivados.
A nova lei tenta remover quaisquer obstáculos legais para construir satélites de espionagem mais avançados e ajudar a inovação na indústria espacial dos japoneses.	O objetivo da nova lei é remover quaisquer obstáculos legais para a construção de satélites de espionagem mais avançados e incentivar a inovação na indústria espacial dos japoneses.
Zhang afirmou-a China se opõe à restrição do uso pacífico da energia nuclear por estados não nucleares com base na não proliferação, porque o uso pacífico da energia nuclear é um objetivo crucial do TNP.	Zhang Yan afirmou que a China se opõe ao uso da não proliferação como pretexto para restringir e privar os estados de armas não nucleares do direito ao uso pacífico da energia nuclear.
O especialista em proliferação do Instituto Internacional de Estudos Estratégicos Mark Fitzpatrick afirmou que o relatório da AIEA-tinha um teor incomumente forte.	Sênior do Instituto Internacional de Estudos Estratégicos Mark Fitzpatrick afirmou que- o plano da Agência Internacional de Energia Atômica é superficial.
O tratado limita o número de aeronaves, tanques e outras armas pesadas não nucleares na Europa.	As forças convencionais na Europa limitam o número de aeronaves militares, tanques e outras armas pesadas não nucleares na Europa.
As autoridades da Estônia declararam que alguns dos ataques cibernéticos que fizeram com que os sites do governo da Estônia fossem interrompidos temporariamente de computadores na administração da Rússia, inclusive no escritório do presidente Vladimir Putin.	Funcionários da Estônia, incluindo o primeiro -ministro Andrus Ansip, alegaram que alguns dos ataques cibernéticos vieram de computadores do governo russo, incluindo computadores no escritório do presidente russo Vladimir Putin.
A Grã -Bretanha fez um acordo para fornecer a Jets de Tufão Saudita em um acordo no valor de cerca de 8 bilhões de libras (cerca de 13,9 bilhões de dólares).	O Reino Unido concordou em fornecer a Jets Typhoon em um acordo estimado em cerca de 8 bilhões de libras (aproximadamente 13,9 bilhões de dólares) para a empresa de defesa do Reino Unido BAE Systems.
O ópio é o ingrediente cru para heroína.	As papoulas renderam o ingrediente cru para heroína.
O WI Sung-Lac recusou-se a fornecer detalhes sobre o projeto do Reator Nuclear norte-coreano.	Até agora, a Coréia do Sul adotou uma posição cautelosa sobre a questão do projeto de reator nuclear norte -coreano.
O acordo teve como objetivo estabelecer uma cooperação mais ampla, cobrindo a segurança nacional e a luta contra o terrorismo global.	Em um comunicado que o Ministério da Defesa Britânico declarou- o acordo visa estabelecer uma cooperação mais ampla que cobre a segurança nacional e a luta contra o terrorismo global.
Muitos dos executados no Irã estão enforcados em público.	Muitas das pessoas executadas são enforcadas em público.
Os Estados Unidos e os Aliados dos Estados Unidos acreditam que o Irã está buscando armas nucleares.	Os Estados Unidos e algumas nações européias acreditam que os projetos nucleares do Irã têm o objetivo de fazer armas nucleares.
O CFE é muito importante para a segurança européia.	O CFE é uma pedra angular da segurança européia.
As tropas indianas já lutando contra rebeldes na Caxemira estão agora envolvidas em uma campanha enorme para destruir as culturas de papoula na região.	As tropas indianas que já estão lutando contra rebeldes também estão envolvidas em uma operação maciça para destruir as culturas de papoula na Caxemira.
o assunto é delicado.	O relatório da AIEA é restrito.
Na semana passada, a Rússia anunciou que suspenderá a participação no CFE.	A OTAN lamenta a decisão da Rússia de suspender a participação no CFE.
os EUA , outras nações ocidentais e a OTAN condenaram a violência.	os EUA , outras nações ocidentais e a OTAN exigiram um cessar-fogo.
Os nacionais indianos constituem o maior número de presos estrangeiros nas prisões do Nepal.	Os traficantes de drogas de países estrangeiros constituem a maior porcentagem de presos estrangeiros no Nepal.
A ordem judicial acusou Raghad de financiar o terrorismo.	O tribunal acusou Raghad Saddam Hussein de financiar o terrorismo.
Os governantes militares de Mianmar queimaram aproximadamente 250 milhões de dólares em drogas ilegais para marcar o Dia Internacional contra o abuso de drogas e o tráfico ilícito.	Os governantes militares de Mianmar incineraram as drogas para marcar o Dia Internacional contra o abuso de drogas e o tráfico ilícito.
As autoridades iranianas aumentaram as execuções em 2007, à medida que as autoridades aplicam uma campanha que pretendia promover a virtude e aumentar a segurança na sociedade.	O número de execuções aumentou no Irã no ano passado em meio a uma campanha que visa melhorar a segurança na sociedade.
A Índia acusa Islamabad de guerrilheiros de financiamento e treinamento.	A Índia acusa o Paquistão de financiar e treinar os guerrilheiros transfronteiriços.
A batalha e os ataques aéreos que se seguiram mataram pelo menos 10 militantes.	Uma batalha que se seguiu matou pelo menos 10 militantes.
O comunicado do Ministério das Relações Exteriores do Panamenho declarou que a força -tarefa facilitará a transferência tecnológica e promoverá a produção e o consumo de biocombustíveis.	O comunicado do Ministério das Relações Exteriores do Panamenho afirmou que o Panamá e o Brasil assinaram 3 tratados de comissão jurídica que incluíram uma extradição
O Vietnã tem entre as leis mais duras do mundo.	As leis das drogas do Vietnã estão entre as leis mais rígidas do mundo.
O governo indiano proibiu a exportação direta ou indireta e a importação de todos os itens, materiais, bens e tecnologia que poderiam contribuir para atividades relacionadas ao enriquecimento, reprocessamento, reprocessamento ou pesado da água do Irã.	A Índia proibiu a exportação direta ou indireta e a importação de todos os itens, materiais, bens e tecnologia que poderiam contribuir para os sistemas de entrega de armas nucleares do Irã.
A Agência de Notícias do Vietnã informou que o Ministério da Segurança Pública declarou que os estrangeiros envolvidos em casos de tráfico de drogas no Vietnã vieram principalmente do Laos, Camboja, Austrália, China, Estados Unidos e Taiwan.	A Agência de Notícias do Vietnã informou que o Ministério da Segurança Pública declarou que a polícia admitiu que o tráfico de drogas para o Vietnã está aumentando, mas as ações para prevenir e impedir o tráfico de drogas ao longo das fronteiras permaneceram limitadas.
O líder da equipe do Saferworld nos controles de transferência e nas armas pequenas Roy Isbister afirmou- o embargo da UE proíbe a oferta direta ou indireta de equipamentos militares para uso em Mianmar.	O líder da equipe do Saferworld nos controles de transferência e nas armas pequenas Roy Isbister afirmou que - o embargo da UE afirma explicitamente que nenhum equipamento militar deve ser fornecido direta ou indiretamente para uso em Mianmar.
Os Estados Unidos e outros membros da OTAN se recusaram a ratificar o tratado alterado.	Os Estados Unidos e outros membros da OTAN se recusaram a ratificar as atualizações do CFE.
O CFE limita o uso de forças armadas e armas pesadas e prescreve medidas destinadas à construção de confiança, transparência e cooperação entre os Estados-Membros.	O tratado limita as implantações de tanques e tropas na OTAN e no antigo países do Pacto de Varsóvia da Europa da Páscoa e estabelece medidas de construção de confiança, transparência e cooperação entre membro
A Bulgária está localizada na parte sudeste da Península dos Balcãs.	A atividade de tráfico de drogas é galopante na parte sudeste da Península dos Balcãs.
Elbaradei afirmou que esta é a última chance de construir segurança no Oriente Médio com base na confiança e na cooperação e não na posse de armas nucleares.	Esta é a última chance de construir segurança no Oriente Médio, com base na confiança e na cooperação, e não na posse de armas nucleares.
O governo iraniano rejeitou as alegações na inteligência apresentada ao Conselho Internacional da Agência de Energia Atômica como infundada e a inteligência usada para apoiar as alegações como falsas.	A Agência Internacional de Energia Atômica insiste que as simples negações do governo iraniano da inteligência apresentadas ao Conselho Internacional da Agência de Energia Atômica não são boas o suficiente para aliviar as suspeitas dos países ocidentais.
O tratado CFE foi estabelecido em 1990.	O tratamento foi originalmente assinado em 1990.
As forças convencionais no Tratado da Europa são consideradas um tratado -chave de controle de armas.	As forças convencionais no Tratado da Europa foram um tratado fundamental de controle de armas da era soviética.
A Nicarágua comemorou o 25º aniversário da Revolução Sandinista que derrubou a ditadura de Anastasio Somoza, mas impôs um regime de esquerda no estilo cubano.	A Nicarágua comemorou o 25º aniversário da Revolução Sandinista.
13 Curdos da Turquia foram presos perto de Paris por suspeita de lavagem de dinheiro para o Partido dos Trabalhadores do Curdistão (PKK).	10 Os curdos estão sob investigação na França por suspeita de lavagem de dinheiro para uma organização terrorista conhecida como Partido dos Trabalhadores do Curdistão (PKK).
As reuniões duraram 2 dias.	A reunião da OSCE durou dois dias.
Os moradores estão inadvertidamente envolvendo -se no tráfico de drogas.	105 presos estão cumprindo sentenças para o tráfico de drogas.
O governo russo se opõe fortemente aos EUA planeja instalar defesas antimissiles na Europa e descarta os EUA Afirmações de que os interceptores são necessários para se defender contra ameaças do Irã.	Depois de negociações na sede da OTAN, Baluyevsky repetiu a oposição da Rússia aos EUA planeja instalar defesas antimissile na Europa e demitido dos EUA Afirmações de que os interceptores eram necessários para se defender contra ameaças em potencial do Irã.
As universidades de Hong Kong colaboram com universidades, empresas e setores governamentais da China continental para coordenar programas de treinamento e centros de pesquisa para promover pesquisas, comercialização e transferência de tecnologia de alta tecnologia.	As universidades de Hong Kong colaboraram com os setores de ensino superior, negócios e governamentais da China continental para direcionar programas de treinamento e centros de pesquisa para promover a comercialização de pesquisas e a transferência de tecnologia.
O governo chinês deu cooperação e assistência ativa à organização para a proibição de inspeções de armas químicas.	O Ministério das Relações Exteriores do Equador disse em comunicado que os delegados da organização para a proibição de armas químicas (OPAQ) também participarão da reunião.
O governo mexicano adotou uma série de medidas contra o tráfico de drogas e o crime organizado no México desde 2006.	Desde 2006, o México adotou uma série de medidas contra tráfico de drogas e crimes organizados.
A declaração não especificou a quantidade de ogivas que o míssil é capaz de transportar.	A declaração não especificou quantas ogivas o míssil pode transportar.
É uma séria ameaça à segurança internacional.	Apresenta uma grande ameaça à segurança global.
A Nicarágua comemorou o 25º aniversário da Revolução Sandinista.	A Nicarágua não reconciliou como abordar o aniversário da Revolução Sandinista.
O presidente russo Vladimir Putin afirma que a decisão de interromper a implementação das forças convencionais na Europa é uma resposta aos EUA planeja estabelecer locais de defesa de mísseis na Europa Oriental e para o fracasso da OTAN em ratificar uma versão alterada do tratado.	O presidente russo Vladimir Putin afirma que a decisão é uma resposta aos EUA planeja estabelecer locais de defesa de mísseis na Europa Oriental e para o fracasso da OTAN em ratificar uma versão alterada do tratado.
O Instituto Nacional de Pesquisa Holandês TNO realizou experimentos de armas químicas para o Ministério da Defesa Holandesa durante a década de 1950.	Um jornalista HP / Detijd aprendeu sobre os experimentos de armas químicas da TNO com os arquivos do Ministério da Defesa.
Um relatório emitido pelo fornecedor de software de segurança McAfee Inc. , Os hackers afiliados ao governo na China estão na vanguarda de uma guerra fria cibernética.	Os hackers afiliados ao governo na China estão na vanguarda de uma crescente Guerra Fria cibernética.
O tratado limita o número de aeronaves, tanques e outras armas pesadas não nucleares na Europa e foi assinado pela primeira vez em 1990.	O tratado limita o número de aeronaves, tanques e outras armas pesadas não nucleares na Europa.
Muitos dos ataques se originaram no exterior.	As autoridades da Estônia declararam que os ataques se originaram na Rússia.
A polícia prendeu 2 suspeitos de tráfico de drogas hondurenho.	Polícia búlgara prenda o chefe do grupo de tráfico de drogas.
Se o Japão nascer para a ocasião no Japão, o Japão nunca será espancado, mesmo em termos de poder militar.	Ozawa disse que, se o Japão subir para a ocasião, o Japão nunca será espancado, mesmo em termos de poder militar.
O Egito e a Jordânia assinaram o tratado de não proliferação nuclear e há muito exigem um Oriente Médio livre de armas de destruição em massa.	A Síria assinou o tratado de não proliferação nuclear e permitiu que os especialistas da agência inspecionassem sua única instalação nuclear conhecida.
A Rússia já participa da agência espacial européia	A França é líder na Agência Espacial Europeia.
Mianmar é um estado militar.	Mianmar tem uma junta militar.
Não disse se os homens foram enforcados na prisão.	Dezenas de tais criminosos foram enforcadas em público.
O relatório da Anistia Internacional foi compilado por organizações européias e internacionais não-governamentais, como o Saferworld, que se opõe à violência armada.	O Relatório Internacional da Anistia foi compilado por fóruns não-governamentais europeus e internacionais.
Um relatório do Instituto de Pesquisa de Políticas Públicas disse que existem 27 estados fracos que representam uma ameaça à segurança nacional da Grã -Bretanha, pois os estados podem fornecer bases para terroristas.	O relatório disse que existem 27 estados fracos que representam uma ameaça à segurança nacional da Grã -Bretanha, pois os estados poderiam fornecer bases para terroristas.
O governo iraniano negou a acusação e insiste que o programa nuclear é apenas para fins pacíficos.	O Irã insiste que seu programa nuclear é para fins pacíficos
A iniciativa de segurança de proliferação exige parar e procurar navios suspeitos de transportar armas de destruição em massa.	Os membros da iniciativa de segurança de proliferação estão considerando maneiras de interceptar navios ou aeronaves suspeitos de transportar armas de destruição em massa.
A comunidade internacional deve modernizar e buscar uma maneira justa, razoável e eficaz de aprimorar o regime de não proliferação nuclear por meio de extensas consultas.	A terceira proposta era que os países avançavam com o Times e busquem uma maneira justa, razoável e eficaz de aprimorar o regime de não proliferação nuclear por meio de amplas consultas.
A Anistia Internacional publicou um relatório afirmando que um projeto indiano para vender helicópteros de ataque a Mianmar ameaça um embargo de armas da União Europeia contra Mianmar.	O relatório da Anistia Internacional foi intitulado Helicópteros Indianos para Mianmar: zombando do embargo de armas da UE?
naeem m. contrabandeou 10 kg (22 libras) de heroína.	Os réus contrabandearam mais de 11 kg (24 libras) de heroína.
29 pessoas foram condenadas pelo Tribunal do Povo de Quang Ninh por participar de um anel de drogas que traficou heroína do Vietnã para a China.	O funcionário do tribunal Tran Dao afirmou que as 12 pessoas estavam entre as 29 pessoas condenadas pelo Tribunal de Quang Ninh em participar de um anel de drogas que traficavam heroína do Vietnã para a China.
O advogado de Michael Karras nomeou S.S. Dhillon não foi encontrado para comentar.	As autoridades portuárias de Durban e os inspetores de explosivos policiais não foram encontrados para comentar.
Os países se opõem à arma do espaço e uma corrida armamentista no espaço.	A China enfatizou que a oposição de armas e uma corrida armamentista no espaço sideral.
França, Bélgica, Alemanha, Suécia, Itália e Grã -Bretanha fornecem peças e tecnologia para o helicóptero leve avançado (ALH).	França, Bélgica, Alemanha, Suécia, Itália e Grã -Bretanha fornecem peças e tecnologia para o helicóptero leve avançado que a Índia planeja vender para Mianmar.
O tráfico ilegal de armas aumenta no Quênia devido à fácil disponibilidade e conflitos vizinhos.	O tráfico ilegal de armas aumentou no Quênia e aumentou a preocupação com a segurança.
N.R. Mohanty afirmou que um acordo havia sido assinado entre a Organização de Pesquisa e Desenvolvimento de Defesa, a Hindustan Aeronautics Limited e a Força Aérea Indiana para atualizar a frota envelhecida da Índia de aeronaves MIG-27 M.	Mohanty afirmou que a atualização será feita em breve, pois quase foi finalizada pela organização de pesquisa e desenvolvimento de defesa, Hindustan Aeronautics Limited e pela Força Aérea Indiana.
Elbaradei afirma que um acordo de paz no Oriente Médio só pode ser alcançado em paralelo com um acordo de segurança com base na erradicação de todas as armas de destruição em massa da região.	Elbaradei foi citado como tendo dito que um acordo de paz entre Israel e seus vizinhos árabes deve ser alcançado em paralelo com um acordo de segurança baseado na erradicação de todas as armas de destruição em massa da região.
Os traficantes de drogas enfrentam a pena de morte sob a lei tadjique.	O traficante de drogas afegão foi pego no Tajiquistão.
A International Atomic Energy Association é o vigia das Nações Unidas.	A Agência Internacional de Energia Atômica é a ONU. O cão de vigilância nuclear.
Wen afirma que o principal objetivo da Alemanha é promover o comércio, trocas econômicas e tecnológicas.	Wen afirmou que o objetivo de sua visita à Alemanha é promover o comércio, trocas econômicas e tecnológicas.
As autoridades dos Estados Unidos não sabem até que ponto o programa de armas nucleares da Coréia do Norte progrediu.	Hill é o chefe de negociador americano no programa de armas nucleares da Coréia do Norte.
7 policiais foram mortos e 4 policiais foram feridos.	Durante o Clash, 7 sete policiais foram mortos e 4 feridos seriamente.
Chefes de defesa da Estônia, Letônia, Lituânia, Alemanha, Itália, Espanha e Eslováquia assinarão o acordo para fornecer funcionários e financiamento para o centro.	Chefes de defesa da Estônia, Letônia, Lituânia, Alemanha, Itália, Espanha e Eslováquia assinaram o acordo.
O projeto de lei que propõe a nova lei que permite o uso de programas espaciais para defesa já foi aprovado pelo governo do Japão na semana passada.	O projeto de lei para a nova lei já foi aprovado pela câmara baixa do governo japonês na semana passada.
Van der Merwe condenou Geiges a um total de 13 anos de prisão.	Van der Merwe suspendeu a sentença de Geiges a 5 anos de prisão.
Zahedan é uma cidade no sudeste	Bam é uma cidade no sudeste
O Presidente Putin afirmou que a Rússia aceitaria contramedidas.	Putin alertou que a Rússia tomaria ações retaliatórias.
Até agora, a China se recusou à pressão dos Estados Unidos sobre a China para parar e procurar navios norte -coreanos.	A China afirmou que a pressão dos Estados Unidos sobre a China para parar e procurar navios norte -coreanos pode desencadear confrontos militares.
O ministro de Assuntos Estratégicos do Brasil, Roberto Mangabeira Unger, declarou que o novo plano de defesa nacional do Brasil exige estabelecer parcerias com países, incluindo Rússia e França, para construir uma indústria de armas de última geração.	A Unger declarou que o novo plano de defesa nacional do Brasil exige estabelecer parcerias com países, incluindo Rússia e França, para construir uma indústria de armas de ponta.
O acusado será acusado de tráfico internacional de drogas.	Alguns dos acusados ​​também serão acusados ​​de lavagem de dinheiro, sonegação e corrupção.
Variantes do helicóptero leve avançado (ALH) contêm lançadores de foguetes da Bélgica; foguetes, armas e motores da França; sistemas de freio da Itália; tanques de combustível e caixas de câmbio da Grã -Bretanha; Equipamentos de autoproteção de uma empresa sueca e receberam desenvolvimento crucial de design e controle de motores de empresas alemãs.	O arsenal do ALH inclui-lançadores de foguetes de foguetes da Bélgica, armas e motores da França Sistemas de freio de tanques de combustível da Itália e caixas de câmbio da Grã-Bretanha Autoproteção de uma empresa sueca.
O Ministério da Defesa da Índia aumentou os gastos com compras de defesa.	O Ministério da Defesa da Índia aumentou os gastos com defesa em 33 %.
O relatório da AIEA é restrito.	Os assassinos escaparam.
As forças convencionais no Tratado da Europa foram assinadas por membros russos e da OTAN em 1990.	As forças convencionais na Europa foram alteradas em 1999.
Sheik Doon Salad Ilmi disse que as baixas civis resultantes de ataques de argamassa e foguetes durante a noite acontecem todos os dias.	Sheik Doon Salad Ilmi afirmou que as baixas civis resultantes de ataques de argamassa e foguetes durante a noite são admitidos no hospital quase todos os dias.
O governo sul -africano mantém relações muito boas com o governo dos Estados Unidos.	O CFE tem 1 de várias questões que afetam negativamente as relações da Rússia com os Estados Unidos e a Europa.
Os sistemas de armas nucleares em um alto nível de prontidão aumentam o risco de que essas armas sejam usadas, incluindo involuntariamente com consequências catastróficas.	A resolução diz que o alto nível de prontidão aumenta o risco de uso de tais armas e que o uso não intencional ou acidental teria consequências catastróficas.
Blix afirmou que é essencial aumentar os esforços para eliminar os braços nucleares e as armas de destruição em massa.	Blix estava visitando a Nova Zelândia e disse que é essencial que sejam feitos maiores esforços para eliminar os braços nucleares e armas de destruição em massa.
A Província de Helmand é o maior produtor de ópio do mundo.	O grupo Areva é a maior empresa de engenharia nuclear do mundo.
A região fronteiriça do Afeganistão-Irã tem sido palco de frequentes confrontos entre a polícia e os contrabandistas de drogas.	A área perto da cidade de Mirjaveh foi palco de conflitos frequentes entre a polícia iraniana e os contrabandistas de drogas.
O físico Danilov foi condenado por vender informações classificadas sobre tecnologia espacial para a China.	O físico Valentin Danilov foi considerado culpado de vender informações classificadas sobre tecnologia espacial para a China.
Mianmar é o maior produtor mundial de ópio ilegal, mas possui recursos financeiros e técnicos limitados para acabar com o comércio de drogas.	Mianmar é o maior produtor mundial de ópio ilícito, de acordo com os mais recentes EUA Relatório anti-narcóticos do Departamento de Estado.
O Grupo de Apoio ao Abductário espera que o Parlamento mude as leis em breve.	O Grupo de Apoio ao Abductário usará a pesquisa para pressionar o Parlamento para aprovar novas leis.
Santos afirmou que a polícia colombiana encontrou as evidências em 2 computadores descobertos com o líder rebelde morto Raul Reyes.	Francisco Santos afirmou que a polícia colombiana encontrou as evidências em dois computadores descobertos com Raul Reyes.
Do Quy Doan é um porta -voz do Ministério da Cultura e Informação do Vietnã.	GRENELL é porta -voz dos EUA Missão para as Nações Unidas.
Um porta-voz da Siemens na Alemanha afirmou que Heinrich von Pierer afirmou que a Siemens estava começando as conversas com as festas chinesas interessadas sobre uma venda da instalação de processamento de plutônio.	Um porta-voz da Siemens na Alemanha afirmou que Heinrich von Pierer afirmou que Gerhard Schroeder afirmou que Gerhard Schroeder não é contra a venda da instalação de processamento de plutônio em princípio.
O Vietnã tem entre as leis mais estritas de drogas do mundo.	As leis das drogas do Vietnã estão entre as leis mais rígidas do mundo.
As iniciativas do governo para desarmar foram ineficazes.	As instituições de governança têm sido ineficazes há muito tempo na Somália.
Putin afirmou que o governo russo poderia se retirar do tratado se as nações ocidentais se recusarem a ratificar o tratado alterado.	Putin afirmou que a Rússia poderia descartar o tratado inteiramente se as nações ocidentais se recusarem a ratificar sua versão alterada.
A Rússia ratificou a versão alterada do tratado.	A Rússia ratificou o tratado alterado.
A OSCE discutiu a possível extensão da missão da OSCE no Kosovo.	A OSCE discutiu a tentativa do Cazaquistão de manter a presidência da OSCE em 2009.
Elbaradei é o chefe da Agência Internacional de Energia Atômica.	Mohammed Elbarade é o diretor geral da Agência Internacional de Energia Atômica.
O tratado de não proliferação nuclear tem 37 anos.	O tratado de não proliferação nuclear é revisado a cada 5 anos.
A porta -voz do Ministério das Relações Exteriores da China, Jiang Yu, afirmou que hackers cibernéticos é uma questão global.	O porta -voz do Ministério das Relações Exteriores chinês, Qin Gang, foi convidado a responder ao discurso de Cheney sobre o desenvolvimento militar da China.
A planta será construída ao lado de uma planta existente e está projetada para estar operacional em 7 anos.	A planta será construída ao lado de uma planta existente também fornecida pela China e operacional desde 1999.
Os ataques cibernéticos são considerados uma ameaça crescente para redes de computadores militares e civis.	A OTAN considera cibernética uma ameaça crescente às redes de computadores militares e militares.
Se a Índia culpa militantes estrangeiros, faz parte de sua propaganda enganar a comunidade internacional.	Abe pediu política externa mais assertiva para o Japão e a comunidade internacional.
A Academia Arábica de Segurança, com sede em Riyadh, disse em comunicado que estava administrando um workshop de duas semanas para 50 especialistas em antiterrorismo.	Em um comunicado, a Academia Árabe da NAIF para ciências de segurança anunciou-patrocinará um workshop de duas semanas para 50 especialistas em antiterrorismo.
88 % do Partido Democrata Liberal apóia as sanções econômicas.	80 % do Partido Democrata da oposição apóia as sanções econômicas.
A sharia é a lei islâmica.	O Irã é uma república islâmica.
Vários militantes islâmicos suspeitos com supostos vínculos da Al Qaeda foram presos na Malásia e em Cingapura, e as autoridades declararam que a rede dos militantes se estende à Indonésia.	Os suspeitos de militantes islâmicos com supostos vínculos da Al Qaeda foram presos na Malásia e em Cingapura.
Em setembro de 2007, a Jordânia assinou um acordo com os Estados Unidos com o objetivo de apoiar o desenvolvimento pacífico do nascente programa nuclear da Jordânia.	Em setembro de 2007, os Estados Unidos assinaram um acordo com a Jordânia com o objetivo de apoiar o desenvolvimento pacífico do novo programa nuclear de Jodran.
Segundo a declaração, o RS-24 reforça o potencial militar das forças estratégicas para superar os sistemas de defesa anti-míssil.	De acordo com o comunicado, o foguete protótipo RS-24 é diferente do Topol-M, pois está equipado com várias ogivas de independência de independência para sobrecarregar os sistemas de defesa.
naeem m. foi enforcado em Zabol, província de Sistan-Baluchestan.	Zahedan é a capital da província de Sistan-Baluchestan.
O Irã está em uma grande rota de drogas entre o Afeganistão e a Europa e os estados do Golfo Pérsico.	O Irã está em uma grande rota de tráfico de drogas entre o Afeganistão e a Europa, bem como os estados do Golfo Pérsico.
Será hospedado pelo governo australiano.	os EUA Os planos irritaram o governo russo.
Os 5 membros permanentes do Conselho de Segurança das Nações Unidas são a Grã -Bretanha, China, França, Rússia e Estados Unidos.	Os membros P5 + 1 são Grã -Bretanha, China, França, Rússia, Alemanha e Estados Unidos.
Em julho de 2006, o primeiro-ministro da Jordânia, Maaruf Bakhit, afirmou que- Raghdad Hussein e Family estavam vivendo sob a proteção do rei Abdullah II.	O primeiro -ministro da Jordânia, Maaruf Bakhit
Um porta-voz da Siemens na Alemanha declarou à Agence France-Presse que Siemens estava confiante sobre o resultado das negociações para vender a instalação de processamento de plutônio.	Um porta-voz da Siemens na Alemanha se absteve de comentar sobre o aspecto político da venda da instalação de processamento de plutônio.
O ataque cibernético ocorreu após a reunião do presidente francês Sarkozy com o Dalai Lama irritou o governo chinês.	O ataque cibernético ocorreu após a reunião do presidente francês Nicolas Sarkozy com o líder espiritual tibetano exilado, o Dalai Lama.
O governo sul -africano impôs uma proibição que proíbe o recrutamento de pessoas dentro ou fora da África do Sul para assistência militar mercenária ou estrangeira.	O Ministério das Relações Exteriores da África do Sul declarou que a Lei de Assistência Militar Estrangeira da África do Sul proíbe o recrutamento de pessoas dentro ou fora da África do Sul para assistência militar mercenária ou estrangeira.
A Ucrânia quase tem todas as aprovações necessárias para ingressar no programa da Agência Espacial Europeia.	A França é líder na Agência Espacial Europeia.
O governo norte -coreano alertou o governo sul -coreano contra a participação no Programa de Iniciativa de Segurança de Proliferação.	O governo norte -coreano declarou que se o governo sul -coreano participar do Programa de Iniciativa de Segurança de Proliferação, resultaria em consequências catastróficas não especificadas.
O Conselho de Agricultura da China abre um escritório especial responsável por transferências de tecnologia agrícola e gestão e consultoria de direitos de propriedade intelectual para melhorar o desenvolvimento da agricultura e aplicações da tecnologia agrícola baseadas no conhecimento da China.	Lee afirmou que o COA passou os últimos anos estabelecendo mecanismos relevantes e redigindo um conjunto de medidas promocionais para melhorar o desenvolvimento da agricultura e aplicações da tecnologia agrícola baseadas no conhecimento da China.
O presidente parlamentar iraniano Gholam-Ali Haddad-Arel visitou Cuba.	Os acordos foram assinados durante a visita do Irã Majlis (Parliament) Gholam-Ali Haddad-Adel a Cuba.
O Tibete suspeita do governo chinês de criar o vírus para espionar exilados tibetanos e o Dalai Lama.	O Tibete suspeita do governo chinês de lançar o ataque.
As autoridades chinesas não estavam disponíveis imediatamente para comentar.	Os advogados de Godzhayev e Godzhayev não estavam imediatamente disponíveis para comentar.
A União Europeia e os Estados Unidos congelaram os ativos de Al-Qadi.	Os governos ocidentais incluem os Estados Unidos e a França.
O governo chinês fortaleceu a capacidade anti-proliferação da China nos últimos anos.	O governo chinês censurou estritamente as importações e exportações químicas da China, de acordo com a lei nos últimos anos.
Um grupo representando principalmente sul -africanos brancos chamado Afriforum afirmou que organizaria protestos ao longo da rota para o Zimbábue.	Afriforum afirmou que o grupo organizaria protestos ao longo da rota para o Zimbábue.
Putin anunciou que o Tratado do CFE não protege devidamente os interesses de segurança da Rússia.	O Tratado do CFE não protege devidamente os interesses de segurança da Federação Russa.
Ahmad está lutando contra a extradição para os Estados Unidos e apresentou uma queixa formal, alegando que a polícia britânica inventou relatórios de inteligência para implicar Ahmad em atividades terroristas e profanou o Alcorão.	Ahmad apresentou uma queixa formal com a Comissão de queixas policiais independentes, alegando que a polícia britânica inventou relatórios de inteligência para implicar Ahmad em atividades terroristas e profanar a cópia de Ahmad do livro sagrado islâmico, o Alcorão, colocando o Alcorão no chão durante uma busca na casa de Ahmad.
A Rússia ratificou a versão alterada, mas os Estados Unidos e outros membros da OTAN se recusaram a fazê -lo até que o governo russo retire as tropas das antigas repúblicas soviéticas da Moldávia e da Geórgia.	Os Estados Unidos e outros membros da OTAN se recusaram a ratificar a versão alterada até que a Rússia retire as tropas da antiga Moldávia e da Geórgia.
A parte do objetivo do plano dos Estados Unidos é aumentar a pressão sobre a Coréia do Norte.	Os Estados Unidos e os Aliados dos Estados Unidos acreditam que o Irã está buscando armas nucleares.
Tskhinvali é a capital da Geórgia.	Paris é a capital da França.
Um funcionário do governo indiano declarou que a Índia não atribui muita credibilidade aos relatórios da Anistia Internacional.	Um funcionário do governo indiano que estudou as plantas declarou que a ciência era antiga e datada, mas ainda funcional.
Gabinete da China O Conselho de Estado anunciou que alterará os regulamentos sobre a tecnologia nuclear de "uso duplo" para impedir o terrorismo nuclear.	A alteração dos regulamentos sobre a tecnologia nuclear de uso duplo impedirá o terrorismo nuclear.
O primeiro -ministro japonês Junichiro Koizumi disse que a mudança das hastes era proativa.	Em 2002, o primeiro -ministro japonês Junichiro Koizumi participou de uma cúpula na Coréia do Norte com o líder norte -coreano Kim Jong Il.
O partido comunista japonês da oposição era contra a nova lei e temia que isso levasse a um exército mais forte.	O Partido Comunista Japonês da oposição era contra o projeto que propondo a nova lei.
Algumas autoridades da ASEAN declararam que essa padronização seria difícil devido aos sistemas políticos de diferentes países.	Algumas autoridades afirmaram que a tarefa seria difícil para os membros da ASEAN por causa de variados sistemas legais e políticos.
O Iraque está fazendo lobby para o Conselho de Segurança parar de usar a receita do petróleo do país para pagar uma compensação às vítimas da Guerra do Golfo de 1991 e aos salários do monitoramento das Nações Unidas, de verificação e inspeção dos inspetores da Comissão de Inspeção e que restringam todo o dinheiro nas contas de petróleo da United Nation-Food transferidas para o fundo do governo.	Os novos líderes do Iraque estão fazendo lobby para o Conselho de Segurança das Nações Unidas para parar de usar a receita do petróleo do Iraque para pagar os salários dos inspetores e ter todo o dinheiro restante na conta de petróleo por alimentos da nação unida transferida para o governo iraquiano.
Um tratado importante de controle europeu de armas deve ser mantido.	O tratado CFE é um tratado importante de controle europeu de armas.
A região do Triângulo Dourado era 1 dos maiores produtores de ópio do mundo.	A Província de Helmand é o maior produtor de ópio do mundo.
Os Estados Unidos descartaram a ação como chantagem nuclear.	Os Estados Unidos disseram que enfrentariam chantagem nuclear e descartaram negociações.
A reunião durou 3 dias.	As reuniões duraram 2 dias.
Os ministros da China, Laos, Índia, Mianmar e Tailândia também abordarão iniciativas de substituição de culturas para minorias étnicas empobrecidas que ainda dependem do cultivo de ópio.	Os ministros da China, Laos, Índia, Mianmar e Tailândia discutirão como encontrar mercados para mercadorias produzidas sob substituição de culturas e outros programas relacionados, como ecoturismo e fabricação de artesanato.
A China é uma energia nuclear e membro da ONU. Conselho de Segurança.	A China é um membro permanente da segurança da ONU
As autoridades norte -coreanas são suspeitas de construir armas nucleares.	A Coréia do Norte está atualmente em processo de desmontagem de seu programa de armas nucleares.
O repórter de televisão australiano Peter Lloyd enfrenta 3 novas acusações de drogas em Cingapura.	De acordo com documentos do tribunal - em 25 de julho, o repórter de televisão australiano Peter Lloyd enfrentou 3 novas acusações de drogas em Cingapura.
O presidente Vladimir Putin assinou um decreto suspendendo a participação da Rússia nas forças convencionais na Europa.	O presidente russo Vladimir Putin assinou um decreto suspendendo a participação da Rússia nas forças convencionais na Europa devido a circunstâncias que afetam a segurança da Federação Russa e exigem medida imediata.
As condições de extradição estipulam que o tunisino só pode ser processado pela acusação única de falsificar documentos que as autoridades italianas podem fornecer evidências suficientes para processar.	O porta -voz do Ministério da Justiça da Suíça Folco Galli afirmou que as condições de extradição estipulam que Mejri só pode ser processado por uma única acusação de falsificação de documentos pelos quais as autoridades italianas poderiam fornecer evidências suficientes para processar.
Acredita -se que os ataques tenham vindo de endereços IP do governo russo em resposta à realocação de uma estátua soviética na Estônia.	Os ataques ocorreram após uma disputa entre os governos da Rússia e a Estônia sobre a realocação de um memorial de guerra soviético.
A Índia e o Paquistão permanecem fora do tratado.	Israel permanece fora do tratado.
A China é membro do Ballistic Missile Club.	A Rússia é membro do quarteto no Oriente Médio.
A Rússia pode sair do tratado se os EUA e outros aliados da OTAN se recusarem a ratificar a versão alterada.	alertou que a Rússia se retiraria do tratado se as nações ocidentais se recusassem a ratificar sua versão alterada.
Isso é particularmente verdadeiro nos países mais pobres.	Isso foi particularmente depois que a Etiópia retira suas forças.
O Irã aumentou visivelmente o número de execuções nos últimos meses, à medida que as autoridades aplicam uma campanha destinada a promover a virtude e aumentar a segurança em	As autoridades iranianas aumentaram as execuções em 2007, à medida que as autoridades aplicam uma campanha que pretendia promover a virtude e aumentar a segurança na sociedade.
Um comunicado divulgado pela agência de notícias oficial do SPA afirmou que-al-Dosari foi condenado por tráfico de drogas.	O estuprador foi identificado como Hossein Safarlou e também foi condenado por tráfico de drogas.
Tanto o Tajiquistão quanto o Uzbequistão compartilham uma fronteira com o Afeganistão e experimentaram ataques por militantes islâmicos apoiados pelo Taliban nos últimos anos.	O vizinho Quirguistão também sofreu ataques de militantes islâmicos apoiados pelo Taliban nos últimos anos.
A Rússia disse que o sistema é uma ameaça clara à segurança russa.	É uma séria ameaça à segurança internacional.
A gangue se envolveu em atividades ilegais, incluindo extorsão, chantagem, contrabando de armas, contrabando de cigarros e lavagem de dinheiro e supostamente usou os recursos para financiar grupos terroristas na Chechênia.	Os Dans declararam que a gangue se envolveu em atividades ilegais, incluindo extorsão, chantagem, contrabando de armas, contrabando de cigarros e lavagem de dinheiro.
No Centro Científico da Microbiologia Aplicada do Estado, existem todos os tipos de bactérias mortais que foram estudadas para uso no programa secreto de armas biológicas da União Soviética.	O Centro Científico do Estado de Microbiologia Aplicada tem trabalhado com cientistas ocidentais para converter o complexo em um local de fabricação biomédica.
A Agência Internacional de Energia Atômica não tem acesso a pessoas, documentos, sites.	A Agência Internacional de Energia Atômica está baseada em
O livro afirma que o medicamento transmite uma imagem completamente positiva.	O funcionário afirmou que essa era uma transferência completa de tecnologia.
40 presos estão cumprindo sentenças por assassinato.	105 presos estão cumprindo sentenças para o tráfico de drogas.
A Rússia está cumprindo obrigações e forças decrescentes.	A suspensão das obrigações da Rússia sob o Tratado do CFE é temporária.
O diretor executivo da Associação de Controle de Armas em Washington Daryl Kimball afirmou que- o relatório da AIEA é 1 em uma série de sinais de mau.	O diretor executivo da Associação de Controle de Armas em Washington Daryl Kimball afirmou que o documento israelense poderia afetar o debate sobre a Índia.
O CFE tem 1 de várias questões que afetam negativamente as relações da Rússia com os Estados Unidos e a Europa.	O tratado é uma das várias questões que causam relações tensas entre os governos da Rússia e os EUA e Europa.
O laboratório de Korobeynichev trabalhou com os EUA Lawrence Livermore Laboratório Nacional.	O laboratório de Korobeynichev trabalhou com outros institutos científicos.
Lugar e Nunn são senadores.	Lugar e Nunn concederam uma medalha ao primeiro -ministro.
As autoridades afirmam que a decisão sobre o tratado dependerá dos EUA Ação sobre seus planos de implantar sistemas de defesa de mísseis na Polônia e na República Tcheca.	Oficiais militares russos declararam que a decisão dependeria de os Estados Unidos proceder com seu plano de implantar componentes de defesa de mísseis na Polônia e na República Tcheca.
A assinatura do acordo é uma questão periférica da reunião do Estado -Maior dos Chefes de Defesa dos 26 países de aliado da OTAN.	O acordo foi assinado durante uma reunião regular do Estado -Maior dos Chefes de Defesa dos 26 aliados da OTAN.
No início de maio de 2002, funcionários das Filipinas, Malásia e Indonésia, assinaram um acordo antiterrorismo para compartilhar listas de passageiros de companhias aéreas e outras inteligências.	No início de maio de 2002, as Filipinas, Malásia e Indonésia assinaram um acordo para compartilhar a inteligência do terrorismo.
Após o primeiro encontro entre líderes da União Europeia e líderes da Albânia, Bósnia e Herzegowina, Croácia, Macedônia e Sérvia e Montenegro, líderes dos países dos Balcãs ocidentais comprometem -se a diminuir o crime e a corrupção organizados nos Bálcãs para atender aos requisitos da União Europeia.	Líderes da Albânia, Bósnia e Herzegowina, Croácia, Macedônia e Sérvia e Montenegro se reuniram pela primeira vez com os líderes da União Europeia para se juntar à União Europeia.
A resolução exige que todos os 192 Estados-Membros das Nações Unidas adotem leis para impedir que terroristas, profissionais de marketing negros e outros atores não estatais de fabricação, adquirir ou tráfico de armas nucleares, biológicas ou químicas ou materiais para fabricá-las.	A Resolução 1540 exige que todos os países adotem leis para impedir que os atores não estatais fabricam, adquirissem ou tráfego em armas nucleares, biológicas ou químicas, os materiais para fabricá-los e os mísseis e outros sistemas para entregá-los.
A Associação Internacional de Energia Atômica afirmou que a Jordânia concordou com as medidas adicionais.	A International Atomic Energy Association é o vigia das Nações Unidas.
Há muita preocupação com a droga.	Há muito trabalho a ser feito.
O Relatório Internacional da Anistia sugeriu que- a Bélgica iniciou conversas imediatas com a Índia para impedir as vendas futuras do ALH, componentes ou tecnologia militar para Mianmar.	O relatório instou a Bélgica a iniciar conversas imediatas com a Índia, a fim de impedir a venda futura de armas a Mianmar.
Os crimes de capital no Irã incluem assassinato, estupro, roubo armado, apostasia, blasfêmia, tráfico de drogas grave, sodomia repetida, adultério, prostituição, traição e espionagem.	As ofensas capitais no Irã incluem assassinato, estupro, assalto à mão armada, tráfico de drogas grave e adultério.
A Arábia Saudita é uma monarquia absoluta que tomou medidas para a reforma.	A Arábia Saudita é uma monarquia absoluta e tem um conselho consultivo nomeado pelo governo.
O porta -voz disse que haverá uma troca de opiniões sobre questões tópicas internacionais e regionais baseadas em uma relação de trabalho conjunta no coração da ONU. Kamynin disse que a Rússia reconhece a participação da Líbia na obra da ONU. Conselho de Segurança.	Kamynin disse que haverá uma troca de opiniões sobre questões tópicas internacionais e regionais baseadas em uma relação de trabalho conjunta no coração da ONU.
A visita de Shalgam a Londres é a primeira de um ministro das Relações Exteriores da Líbia desde 1969.	Foi anunciada uma visita à Líbia pelo ministro das Relações Exteriores da Rússia.
Os governos indianos e paquistaneses quase se envolveram em um quarto conflito em 1999.	Os governos indianos e paquistaneses realizaram testes nucleares em maio de 1998.
Iguaran afirmou que os detidos serão acusados ​​de homicídio, colaboração criminal, seqüestros e financiamento do terrorismo.	Iguaran afirmou que os detidos também estavam envolvidos nos assassinatos de membros da polícia de um grupo anti-kidnapping.
3 suspeitos de extremistas foram libertados sob fiança.	1 suspeito extremista foi libertado provisoriamente sem fiança.
6 Os funcionários do Hospital Tcheco são acusados ​​de tráfico de órgãos humanos.	O acusado será acusado de tráfico internacional de drogas.
Isso agravou ainda mais a situação.	A Coréia do Norte não deve agir ainda mais para agravar a situação.