Os atacantes do shopping usaram 'menos é mais' estratégia	No Quênia, os atacantes usaram 'menos é mais' estratégia
Os líderes da oposição emergem para comemorar as mortes dos trabalhadores cambojanos	Líderes da oposição do Camboja convocados ao tribunal
Os ganhos fracos arrastam estoques de arrasto	Os ganhos fracos arrastam estoques mais baixos em Wall Street
6.8 Quake atinge as Ilhas Salomão	Magnitude 6.3 Quake atinge as Ilhas Salomão: USGS
O vazamento de amônia líquida mata 15 em Xangai	O vazamento de amônia líquida mata pelo menos 15 em Xangai
Amigos da Síria reconhece a coalizão da oposição como representante legítima do povo sírio	nós. , Amigos da Síria reconhecem a oposição como o único representante
Weiner fica na raça do prefeito de Nova York em meio a um novo escândalo de sexting	Weiner encolhe os ombros no último escândalo sexual online
O número de mortos aumenta no acidente de avião da Rússia	O número de mortos aumenta para 39 no acidente de treinador da Itália
Mídia indiana: Commonwealth Summit	O primeiro -ministro indiano Snubs Commonwealth Summit
Bomber suicídio atinge o funeral no Iraque	Greves de bombardeiro suicida na Síria
7 detidos para o escândalo da 'irmã da casa'	A China detém 7 para o escândalo da "irmã da casa"
Chefe da polícia militar da Síria defende a oposição	Chefe de Polícia Militar da Síria defende os rebeldes
Boeing 787 Dreamliner pega fogo; Estoque leva uma surra	O estoque da Boeing cai após o fogo em 787 Dreamliner
Yvette Cooper apoia a conta de casamento gay	Casa Branca apoia o casamento gay
Cinco mortos no acidente de treinador belga	Adolescentes entre 5 mortos no acidente de ônibus belga
homens armados seqüestram sete trabalhadores estrangeiros na Nigéria	sete trabalhadores estrangeiros sequestrados na Nigéria
Turista suíço 'estuprado' na Índia	Gangue turística suíça estuprada na Índia, diz que a polícia
Os palestinos colidem com as forças israelenses na Cisjordânia, Jerusalém	Os palestinos se chocam com forças de segurança em w. banco
Os aviões de Israel atacam dentro da Síria	Israel lança o Airstrike na Síria
Iranianos votam nas eleições presidenciais	Keita ganha eleição presidencial do Mali
100 mortos em novos confrontos tribais de Darfur	'9 Dead' em New Darfur Tribal Clash
protestar contra os greves dos drones nos EUA em Pak adiado	6 mortos nos EUA Drone Strike no NW Paquistão
12 mortos em acidente de ônibus no Paquistão	10 mortos em acidente de viação no Paquistão NW
Carney define o alto bar para mudar no Boe	Carney define o alto bar para mudanças no Bank of England
8 presos após o colapso mortal de Bangladesh	Quatro presos quando o pedágio de Bangladesh aumenta para 352
Bomber suicida mata 3 na Base dos EUA no Afeganistão	Bombeiros suicidas atacam a base dos EUA no Afeganistão
Os afegãos se reúnem para as faculdades, mesmo como o tear do Taliban	O governador do distrito afegão defende o Taliban
A Coréia do Norte adia reuniões familiares com o sul	A Coréia do Norte adia os sindicatos da família com a Coréia do Sul
A Apple Revenue perde novamente, o iPhone decepciona	nós. Regras da agência comercial para Samsung, proíbe as importações do iPhone 4
pistoleiros matam 10 turistas estrangeiros no norte do Paquistão	Gunmens matam 11 alpinistas estrangeiros no Paquistão
David Beckham anuncia a aposentadoria do futebol	David Beckham se aposenta do futebol
Matt Smith para deixar Doctor Who após 4 anos	Matt Smith deixa o médico da BBC que
gerações divididas sobre casamento gay	Cúpula G20 termina dividida sobre a Síria
23 mortos em carros -bomba no Iraque	10 mortos no ataque de bomba do Iraque
Homem que incendiava -se no National Mall Dies de ferimentos	Homem 'que se incendiava' no National Mall Dies
Ataques do Taliban matam 17 civis no Afeganistão	Série de ataques matam 10 policiais no Afeganistão
China Yuan se fortalece para 6,168 contra USD na segunda -feira	China Yuan se fortalece para 6.1696 contra USD na quinta -feira
O ministro do Egito sobrevive à tentativa de assassinato	O primeiro -ministro sírio 'sobrevive a tentativa de assassinato'
Os moradores do Texas buscam cura na igreja após explosão mortal	Os moradores retornam ao site de explosão do Texas
Shinzo Abe selecionou como o primeiro -ministro do Japão	Shinzo Abe é o primeiro -ministro do Japão
Ex-primeiro Lady Lady Barbara Bush sai do Texas Hospital	Ex -primeira -dama Barbara Bush Leaves Hospital
2 mortos em Bangladesh Clashes sobre a execução do líder do Jamaat	Líder islâmico de Bangladesh executado
Schumacher em coma após acidente de esqui	Michael Schumacher ainda em coma lutando por sua vida após acidente de esqui
11 mortos no ataque da delegacia chinesa	Onze mortos no ataque da delegacia da China
Mali devido a votar no presidente	Mali conta votos após o escoamento presidencial
Bradley Cooper e JJ Abrams em conversas sobre filmar uma biografia de Lance Armstrong	Bradley Cooper em negociações para jogar Lance Armstrong na Biopic
A Boeing Airliner cai na Rússia, 50 mortos	A Boeing Airliner cai na cidade russa de Kazan, 50 mortos
Os ministros da UE "determinados" para resolver o escândalo de carne de cavalo	Os ministros da UE realizam conversas sobre crise sobre o escândalo de carne de cavalo
De Blasio jurou como prefeito de Nova York, sucedendo a Bloomberg	Bill de Blasio jurou como prefeito de Nova York, sucedendo Michael Bloomberg
Partido da oposição tailandesa para boicotar a eleição geral	A oposição tailandesa anuncia boicote eleitoral
Bangladesh Building Collapse Death Toll Hits 540: Exército	Bangladesh Building Collapse Death Toll Pass 1.000
Alyokhina, membro da Pussy Riot, libertado da prisão na Rússia	Maria Alyokhina, membro do chumbo de buceta, libertado da prisão
Jagan Reddy mudou para o hospital, a crise do poder continua em Seemandhra	Telangana: Jagan para passar quinta -feira no hospital; Blackout continua em Seemandhra
ASIANA JET CRASC Lands no aeroporto de São Francisco	Crash de avião terras no aeroporto de São Francisco
Presidente da República da África Central derrubada por rebeldes	Presidente da República da África Central, PM deixando o cargo
O Brasil empatou em 2-2 pela Inglaterra quando Maracana reabre	Brasil realizado pela Inglaterra por 2-2 como Maracana reabre
China para retomar as negociações de investimento nos EUA	China e Taiwan realizam palestras históricas
California Wildfire: 1.900 nas linhas como bombeiros trabalhistas para limitar os danos ( + vídeo)	California Wildfire cresce, mas as autoridades dizem que as equipes de bombeiros estão progredindo
George w. Bush adverte contra o amargo debate sobre imigração	George W Bush pesa em debate sobre imigração
Mandela hospitalizou, respondendo ao tratamento	Mandela hospitalizou depois que ele para de falar
A Rússia condena o teste nuclear norte -coreano	A Coréia do Sul confirma que a Coréia do Norte realizou um terceiro teste nuclear controverso
Centenas de trabalhadores da fábrica de roupas de Bangladesh, doente	Centenas de adoecem na fábrica de Bangladesh
O bombardeio suicida do Iêmen mata soldados	Bomber feminino mata 16 na estação russa
18 presos na explosão de mina de carvão russo	Dez mortos na Rússia Coal Mina Blast
Os manifestantes tailandeses invadem a sede do exército	Os manifestantes tailandeses tempestadem sede do exército
Israel conduz ataque aéreo na Síria	Israel lança um novo ataque aéreo contra a Síria
Police Fire Limke Gas para dispersar manifestantes em Tunis	Police Fire Limke Gas para manifestantes no Cairo
Blizzard Hammers U.S. Nordeste, cinco mortos, 700.000 perdem energia	Blizzard Wallops nos nordeste, fecha as estradas
A principal oposição do Egito rejeita o chamado do diálogo do presidente	O oposição do Egito reflete a resposta à chamada de diálogo de Morsi
Tóquio para sediar os Jogos Olímpicos de 2020	luta livre para aparecer nas Olimpíadas de Tóquio de 2020
'Cerca de 100 mortos ou feridos' após o terremoto da China	Centenas de mortos ou feridos no terremoto da China
A moradia começa 6,8 % em maio	May Housing começa 6,8 %
2 jornalistas franceses mortos no Mali	Dois jornalistas franceses mortos no Mali
& gt; Castro de Cuba assume a presidência da CELAC	Castro de Cuba para assumir a presidência da CELAC
Veículos em chamas no túnel do Japão desmoronado	Os veículos 'queimam' quando a fumaça emite do túnel do Japão
6.9 Terremoto de magnitude atinge a Nova Zelândia	5.6 Terremoto de magnitude sacode o Irã
Dezenas temiam presas na Índia colapso do edifício	Os resgatadores correm para encontrar 20 ainda presos na Índia colapso do edifício
Nelson Mandela levada para o hospital	Nelson Mandela libertado do hospital
Briefing diário da imprensa: Sudão do Sul	Briefing diário da imprensa: Síria
Islâmicos atacam o norte da cidade do Mali após atentados suicidas	Islâmicos atacam tropas da Maliana em Gao
Os cardeais entram no Vaticano para votação histórica	Os cardeais entram na capela sistina para eleger o papa
Grã -Bretanha preparada para deportar Abu Qatada	A Grã -Bretanha perde a tentativa de deportar clérigo radical Abu Qatada
O Parlamento Francês apóia a reforma da lei sobre prostituição	Parlamento russo para considerar a proibição dos EUA adoções
tiros, explosões ouvidas como taxas continuam protestando em Bangkok	tiros, explosões do dia do protesto tailandês antes das pesquisas
Militar israelense se concentra na fronteira norte	Os militares do Egito assumem o controle da Irmandade Muçulmana, apoiadores
A Coréia do Norte bloqueia o acesso de Kaesong	A Coréia do Norte promete reiniciar instalações nucleares
Líderes da AU se reúnem para o Dia da África	Líder da juventude do Egito detido por quatro dias
hoje na história, 23 de abril	Hoje na história, janeiro. 21
Manning condenado a 35 anos de prisão	Ariel Castro condenado a 1.000 anos de prisão
O Senado dos EUA aprova o acordo fiscal do penhasco	É oficial: o acordo alcançado em "Fiscal Cliff"
Zimmerman parou para acelerar no Texas, lançado com aviso	Zimmerman parou no Texas por excesso de velocidade, dado aviso
Rouhani do Irã alerta sobre a talibanização na Síria	Rússia, China preocupada com ataques aéreos israelenses na Síria
Síria nega relatos de ataque de gás nervoso mortal de Damasco	Os aliados dos EUA recebemos ajuda para repelir ataques de computador iranianos
As ações da China se aproximam mais após a reunião econômica	As ações da China se aproximam mais na quarta -feira
A Rússia revela US $ 30 bilhões em link para o Pacífico	A Rússia revela o link de petróleo de US $ 25 bilhões para o Pacífico
A polícia mata o atirador, encontre mais 3 mortos em colo. lar	4 mortos após o impasse policial com o atirador barricado em casa nos EUA
Dolce e Gabbana condenados por evasão fiscal	Dolce e Gabbana multados no caso tributário italiano
7.2 Quake de magnitude atinge o Paquistão: CENC	7.7 Terremoto de magnitude atinge o SW Paquistão
Alerta do Reino Unido sobre os braços químicos da Síria	West levanta apostas sobre reivindicações químicas da Síria
As ações da China se aproximam da sexta -feira	As ações da China se aproximam mais na quarta -feira
Asteróides coloca entre a Terra e os satélites	asteróides passa a terra em voar
Luta pela cidade do Mali reflete táticas islâmicas	UE para treinar o exército do Mali para combater militantes islâmicos do norte
Dois rastreadores de Papai Noel competindo neste Natal	Espanha voltando o relógio nas sestas
Navios treinam para transporte de armas químicas sírias	A Síria carrega armas químicas em bombas, aguardando a ordem de Assad
O prefeito diz 14 mortos na explosão de plantas de fertilizantes do Texas	Resgatadores Pesquisar por Sobreviventes da Planta de Fertilizantes do Texas Blast
2 mortos, 11 feridos em ataques no Iraque	15 mortos, 90 feridos em novos ataques no Iraque
os EUA podem Confie na Síria para entregar armas químicas?	EUA dizem que a Síria pode ter usado gás sarin em armas químicas
A cantora mexicana Jenni Rivera acreditava morto em acidente de avião	Jenni Rivera, estrela da música mexicana, morre em acidente de avião
O tribunal de Bangladesh sentencia o primeiro legislador até a morte por crimes de guerra	O primeiro -ministro britânico empurra o Sri Lanka em crimes de guerra
Mugabe declarou vencedor das eleições disputadas	Zimbábue: Mugabe declarou vencedor em votação disputada
O número de mortos sobe para 15 no barco da Indonésia afundando	Indonésia: o número de mortos sobe para 11 na Indonésia Capsize
Tribunal Egípcio proíbe a Irmandade Muçulmana	O Tribunal do Egito proíbe as atividades da Irmandade Muçulmana '
Rouhani lidera na votação presidencial do Irã - resultados preliminares	Rouhani lidera na contagem inicial do Irã
Israelenses, palestinos se convocam sobre a troca de prisioneiros	Os legisladores israelenses pedem uma investigação interna no caso do prisioneiro x
A polícia atacou em protestos de bandeira de Belfast	Políticos em conversas de violência de bandeira
A CBN reitera o plano de eliminar as notas de polímero	Nigéria anuncia planos para mudar as notas de polímero naira
S.Korea propõe 'N. Korea' final 'fala sobre Kaesong	Coréia do Norte propõe conversas de alto nível conosco
vítima de estupro de gangues da Índia "lutando contra as probabilidades"	Vítima de estupro indiano morre no Hospital Singapura
pistoleiros matam 9 turistas estrangeiros, 1 paquistanês	pistoleiros matam 11 turistas estrangeiros no Paquistão
Declaração do porta -voz da Alta Representante Catherine Ashton na última série de ataques no Iraque	Declaração do porta -voz do Alto Representante da UE, Catherine Ashton, sobre a retomada de execuções no Iraque
O Egito aumenta a segurança antes dos protestos pró-Morsi	Brace do Egito para protestos maciços
Yacimovich pede ao gabinete que aprove a libertação dos prisioneiros palestinos	Israel concorda em libertar 104 prisioneiros palestinos
nós. Arquivos cobra de espionagem novamente NSA Leaker	Os arquivos dos EUA cobrem cobranças de espionagem contra Snowden por vazamentos
Os palestinos constroem outro protesto da barraca da margem oeste	Primeiro voto da ONU dos palestinos, simbólico, mas histórico
Bangladesh Building colapso Death Toll Hits 362	Bangladesh Building-Collapse Death Toll Suba para 580
Enviados israelenses convocados sobre planos de liquidação	Grã -Bretanha convoca enviado israelense sobre assentamentos
O filho do general chinês recebe 10 anos de prisão por estupro	O filho do general chinês recebe 10 anos de prisão por estupro de gangue
2 mortos, 2 feridos no tiroteio na escola de Nevada	Nevada: 2 Dead, 2 doeu no tiroteio no ensino médio
Terremoto moderado Jolts nw Paquistão	Terremoto moderado atinge o sul do Paquistão
Ban Ban Schools Mixed Schools entra em vigor	Hamas em 'proibição' da escola de sexo misto
32 morre em protesto de Bangladesh	1 morto no protesto de Bangladesh
homem preso depois que o policial atirou em Leeds	Painel da Marinha pede que a expulsão de oficial que falsasse a morte
O primeiro -ministro ucraniano renuncia em meio a protestos	O primeiro -ministro turco sinaliza o retorno à linha dura para os manifestantes
Obama para se concentrar novamente na economia no estado da união	FACTBOX: O que procurar no discurso do Estado da União de Obama
O Google lança balões que causam a Internet	Google 'está jogando jogo de impostos internacionais'
O Iraque apóia a repressão do Egito aos apoiadores de Morsi	O Iraque apóia a repressão do Egito aos apoiadores de Mohamed Morsi
A Rússia dá ok inicial à proibição de adoção americana	A Rússia dá aprovação inicial à proibição de adoção
Cinco condenados no caso de tráfico de órgãos do Kosovo	Kosovo: 3 Obtenha tempo de prisão no caso de tráfico de órgãos
Hrithik Roshan, esposa Sussanne se destaca	Hrithik Roshan, Sussanne para se divorciar
Gunman entre 7 mortos após o tiroteio de apartamento da Flórida	Gunman entre 7 mortos depois da FLA. tiroteio no apartamento
Obama elogia o progresso dos direitos dos gays no endereço inaugural	Milhares protestam contra o casamento gay na França
Onda de atentados mata 15 no Iraque	Bombas de carro matam pelo menos 49 no Iraque
Em choque, Obama coloca a Síria em espera	Obama coloca a Síria em espera
Israel atinge a Síria à medida que as tensões aumentam em armas	Os ataques aéreos feriram civis em Deraa da Síria
pistoleiros matam nove pessoas no noroeste do Paquistão	Militantes matam 6 soldados no noroeste do Paquistão
O acidente de avião de São Francisco em uma devolução	Dois mortos, 181 doer em São Francisco Crash Air
8 presos após o colapso mortal de Bangladesh	Os trabalhadores protestam após o colapso do prédio de Bangladesh
X 'Mass Cruise passageiros atingidos por norovírus	Passageiro de cruzeiro ausente é um NSW AMBO
Reivindicação de assassinato sobre a morte de Diana, novas informações que foram passadas para a polícia relacionadas à morte da princesa Diana e Dodi Fayed deverá incluir uma alegação de que eles foram assassinados	Diana e as informações da morte em Fayed receberam novas mortes da princesa Diana e Dodi Al Fayed estão sendo analisadas novamente pela polícia depois que receberam informações.
Snowden pede para ficar na Rússia	Snowden lança o primeiro vídeo da Rússia
As ações chinesas fecham a quarta -feira mais baixa	As ações chinesas fecham na sexta -feira
Bug estomacal para causar doente Nadal a Miss Australian Open	Rafa Nadal para Miss Australian Open
Narendra Modi se compromete com um suporte difícil contra o Paquistão	Modi da Índia promete postura difícil contra o Paquistão
A polícia tailandesa usa gás lacrimogêneo contra manifestantes	O líder do Brasil quebra o silêncio sobre protestos
O homem da Califórnia se declara inocente no caso de seqüestro de meninas	Califórnia. O homem se declara inocente no caso do terrorismo
Tribunal Egípcio considera a libertação de Mubarak	Ordens do Tribunal do Egito Liberação de Mubarak
Escoteiros de menino Decisão de atraso sobre admitir gays	Escoteiros da América atrasam o voto na proibição de levantamento de gays
2 bombas de carro matam 8 no sul do Iraque	Carros -bombardeios mata 14 no norte do Iraque
van der Sloot para se casar na prisão	Joran van der Sloots planeja se casar na prisão do Peru
Os estoques de Tóquio fecham 0,26pc	Os estoques de Tóquio fecham 1,53 %
Futuros do índice de ações da China Close mais alto - dez. 4	O índice de ações da China Futuros Fechar mais baixo - Jan. 24
Fotos do dia: 7 de agosto de 2013	Fotos do dia: 11 de abril de 2013
Hit 'Hit' Palestinians por Israeli Fire in Gaza	Dois palestinos mortos em um ataque aéreo israelense em Gaza
Onde está enferrujado? panda vermelha desaparece do zoológico nacional	A falta de panda vermelha desapareceu em segurança ao zoológico nacional
Jesse Jackson Jr. e esposa para se declarar culpado de fraude	Jesse Jackson Jr. , esposa de se declarar culpada de fraude
EUA expulam diplomatas da Venezuela em fila	nós. expulsar diplomatas venezuelanos
BBC Veterano Hall admite abuso sexual infantil	Stuart Hall admite ataques sexuais em crianças
7 mortos, 3 feridos no acidente rodoviário do sul da China	20 mortos, 44 feridos no acidente de estrada das Filipinas
A Ryanair relata que registra lucros, mas alerta o crescimento que provavelmente diminuirá este ano	Stansted: Ryanair relata um aumento de 13 % nos lucros anuais, mas alerta sobre crescimento mais lento este ano
ações para assistir perto na segunda -feira	ações para assistir perto na quinta -feira
50º aniversário da morte de JFK lembrada	No 50º aniversário da JFK Death, Dallas mantém seu primeiro memorial
6.3 terremoto de magnitude atinge Taiwan	7.7 Terremoto de magnitude atinge o SW Paquistão
Livros para ajudar as crianças a falar sobre as notícias de Boston Marathon	Relatório de duas explosões na linha de chegada da maratona de Boston
O setor de tecnologia aquece: Google e IBM post ganhos fortes	As ações do Google passam por US $ 1.000 em ganhos fortes
Rainha Beatrix da Holanda para abdicar para filho	A rainha Beatrix da Holanda abdica em favor do filho
motoristas mortos após o túnel japonês cai	Carros presos em túnel colapso fora de Tóquio
Perfis dos candidatos presidenciais do Quênia	Jornalista italiano escolhido como candidato presidencial
Israel libera prisioneiros palestinos	O Comitê do Gov 'T aprova a liberação de 26 prisioneiros palestinos
Philadelphia Building cai, 8 a 10 pessoas podem ficar presas	O prédio da Filadélfia entra em colapso; Relatórios de pessoas presas
Obama se reúne com a família Mandela	Obama conhece Zuma e presta homenagem a Mandela
nós. Senado desencadeia o debate sobre controle de armas	nós. Senado estabelecido para votar no projeto de lei de controle de armas
As ações chinesas se aproximam na quarta -feira	Estudantes chineses atacaram na França
Carros -bomba mata 53 em Damasco	Carros -bombardeios matam 13 civis na capital iraquiana
'Amigos da Síria' em Doha fala sobre armar rebeldes	As negociações da Síria concordam que a ajuda militar dos rebeldes
A Síria condena ataques aéreos israelenses.	Série de ataques mortais atinge o Iraque
O líder do Egito impõe estado de emergência em 3 cidades	O presidente do Egito declara o estado de emergência em três cidades
Os manifestantes da ABVP se chocam com a polícia em Jantar Mantar, jogue pedras	Os manifestantes se chocam com a polícia em Jantar Mantar, 5 pessoas detidas
O PM turco indica os protestos em Istambul	Polícia Turca Fire Gas Legic em manifestantes em Istambul
Uvas vermelhas e mirtilos aumentam o sistema imunológico, dizem os cientistas	uvas vermelhas, mirtilos aumentam a imunidade humana
Dois homens acusados ​​de crimes terrorismo	Nigeriano nascido na Arábia Saudita acusado de terrorismo em Nova York
UE recebe Prêmio Nobel da Paz	UE recebe Prêmio Nobel de Paz 2012
Start of San Fermin Bull Running Festival brevemente atrasado como vista obstruída pela bandeira basca	O festival San Fermin Bull-Running começa
Até 21, principalmente estrangeiros, mortos no ataque de suicídio de Cabul	britânico entre mortos no ataque de suicídio de Cabul
Ex -oficial da polícia de Los Angeles procurou em Irvine Slayings	Ex -oficial da CIA condenado a 30 meses de prisão por vazamento de informações
As ações de Tóquio fecham 0,88pc mais baixo	As ações de Cingapura fecham 0,44 pct mais baixo
Tribunal do Paquistão exige respostas de tumulto de "blasfêmia"	O relatório do Paquistão-UN revela níveis alarmantes de uso de drogas
A McAfee da Intel compra o especialista em firewall em rede baseado em nuvem Stonesoft por US $ 389 milhões em dinheiro	McAfee para adquirir o Firewall Stonesoft por US $ 389 milhões
4.1 Quake de magnitude atinge os EUA	7.2 Terremoto de magnitude atinge as Filipinas
Líder da oposição de Bangladesh condenado à morte por crimes de guerra	Bangladesh: fugitivo condenado à morte pelo tribunal de crimes de guerra
suposto policial assassino morreu de tiro para cabeça	suposto policial assassino morreu de tiro
2 Polícia morta no leste de explosão afegão	Pelo menos 28 pessoas morrem na explosão de mina de carvão chinesa
carro bomba no Consulado Sueco no Benghazi da Líbia, sem baixas	O carro -bomba atinge o consulado sueco em Benghazi, nenhum doeu
Musharraf preso no caso Lal Masjid	Musharraf preso no Paquistão
O Irã espera que as negociações nucleares rendam 'roteiro'	As negociações nucleares do Irã em Genebra estimulavam grandes esperanças
35 militantes mortos em ataques afegãos: oficial	12 militantes mortos em ataques afegãos: ministério
A Coréia do Norte teria testado mísseis de curto alcance	Coréia do Norte lança mísseis de curto alcance
Os manifestantes tailandeses obstruem o voto; 1 morto em violência	Os manifestantes tailandeses bloqueiam as assembleias de voto em Bangkok
Hugo Chavez da Venezuela morre de câncer	Hugo Chavez: Oficiais venezuelanos para a unidade
O terceiro teste da Coréia do Norte aproxima -o do status de energia nuclear	OTAN diz que o teste nuclear da Coréia do Norte é uma ameaça grave à paz mundial
Coréia do Norte realiza terceiro teste nuclear	Coréia do Norte confirma o terceiro teste nuclear
Estoques indianos abertos	Estoques indianos abrem mais baixo
Macau Gambling Revenue Hits Record $ 38 bilhões em 2012	Macau Gambling Revenue Hits Record Record US $ 38 bilhões em 2012
israelenses, palestinos retomam as negociações em nós	israelenses, palestinos começam as negociações
As leituras obrigatórias da nota para segunda-feira, 25 de novembro de 2013	As leituras obrigatórias da nota para terça-feira, 8 de outubro de 2013
Nelson Mandela Memorial Service	Nelson Mandela morre: cobertura ao vivo
NM County se prepara para a audiência de casamentos entre pessoas do mesmo sexo	Algumas autoridades do condado abrem o caminho para o casamento entre pessoas do mesmo sexo
As empresas do Líbano atacam em protesto pelo impasse político	O presidente da Tunísia diz que confiante pode superar a crise política
quatro EUA Os membros da tripulação de helicópteros da Força Aérea mortos no britânico Crash	Tripulação de helicóptero da Força Aérea dos EUA morta em Crash British
Tóquio para sediar os Jogos Olímpicos de 2020	Tóquio ganha correr para sediar as Olimpíadas de 2020
Malásia detém senador australiano no aeroporto	Malásia detém o legislador australiano no aeroporto
Polícia indiana reuniu todos os cinco suspeitos no caso de estupro de Mumbai	A polícia de Mumbai prende o quinto suspeito em caso de estupro de gangue
A segurança se aperta para o funeral Thatcher	As agências de segurança se preocupam com novas ameaças terroristas no Quênia
Coréia do Sul diz mísseis de disparos norte	Coréia do Norte lança mísseis de curto alcance
A Grã -Bretanha desliga as plantas quando o escândalo de carne de cavalo chega à França	Os ministros da UE "determinados" para resolver o escândalo de carne de cavalo
US adverte a Síria sobre armas químicas	nós. As preocupações crescem sobre as armas químicas da Síria
37 mortos no acidente de ônibus na Itália	12 mortos em acidente de ônibus no Paquistão
nós. lixeiras bombas em grande barreira recife	nós. Jettisons militares bombas perto da grande barreira da Austrália Recife
38 militantes do Taliban mortos no Afeganistão	O Taliban ataca a base dos EUA no Afeganistão
China Yuan se fortalece para 6.2689 contra USD	Yuan chinês enfraquece para 6.2816 contra USD
nós. reconhece a oposição síria	Rússia convida a oposição síria para negociações
O Google investe US $ 200 milhões no parque eólico do Texas	O Google investe 200 milhões de dólares no projeto do parque eólico do Texas
Egito votos na nova constituição	Os egípcios votam em nova constituição
A lenda de Preston e a Inglaterra Tom Finney morre aos 91	O ex -grande Tom Finney morre aos 91 anos
A China se esforça para evitar armadilhas econômicas	O seguro é essencial para promover o crescimento econômico
O carro -bomba mata um e feriu cinco em Benghazi	O carro -bomba atinge o Ministério das Relações Exteriores da Líbia em Benghazi
Bombas na estrada matam 5 no Afeganistão	A bomba na estrada mata 3 policiais no Afeganistão
Os tâmeis do Sri Lanka votam em maior autonomia	Síria fala para Cameron e Putin
Tropas lideradas por francês se aproximam de Timbuktu	As tropas lideradas por francês controlam o acesso a Timbuktu
ataque aéreo da OTAN mata duas crianças afegãs	Solider da OTAN morre no Afeganistão
pistoleiros matam 11 turistas estrangeiros no Paquistão	Gunmens matam 11 alpinistas estrangeiros no Paquistão
n Coréia para interromper o trabalho na zona industrial conjunta	A Coréia do Norte bloqueia o acesso à zona industrial conjunta
O estupro de gangue de Delhi suspeito 'espancado, envenenado'	O veredicto de estupro de gangues de Delhi adiado novamente
O trabalho de demolição começa no Don Valley Stadium	Demolição trabalha para começar no estádio
A França promete ajuda militar no Mali	A maioria dos franceses apóia a operação militar no Mali
O tufão mais poderoso de 2013 atinge as Filipinas	23 desaparecendo como tufão utor atinge as Filipinas
Os egípcios votam na constituição divisória	Os egípcios votam na mudança de constituição
Reid cita 'tremendo progresso' nas negociações de teto de dívida	Líderes do Senado aparecem perto do acordo de teto da dívida dos EUA
chama mais protestos do Egito	O número de mortos dos protestos do Egito aumenta para 49
6.2 Quake de magnitude Jolts Sarangani	4,3 terremoto de magnitude Jolts SW China
um morto, 11 doeu no caos do carro La	6 mortos, 33 doer na explosão de cotabato
Presidente da EasyJet para renunciar	Presidente da companhia aérea britânica sem frescuras easyJet para renunciar
Obama Renews se oferece para cortar a rede de segurança social em um grande negócio de orçamento: assessor	Japão pede EUA Para lidar rapidamente com o impasse orçamentário
Bomber suicida mata 14 no Conselho da Província Afeganistão	Bomber suicida mata 11 no Afeganistão
EUA confirmam que o líder da Al-Qaeda foi capturado	Nós captura o líder da Al-Qaeda, mas falha no ataque da Somália
Comitê se aproxima de grandes decisões de imigração	Comitê Judiciário do Senado que se aproxima das grandes decisões finais na formação da lei de imigração
Tropas dos EUA mortos no ataque de insider afegão	Tropas da OTAN mortas no 'ataque insider' afegão
mãe presa por suspeita de homicídio culposo depois que o cachorro mata a filha	homem preso por suspeita de assassinato depois de esfaquear em Suffolk
A Maratona de Londres observa o silêncio para as vítimas de bombas de Boston	A Maratona de Londres observa o silêncio para as vítimas de Boston
Messi Nets 300º, 301º gols na vitória do Barcelona	Futebol: Messi atinge o 300º gol do Barcelona na vitória de retorno
Cinco mortos, 40 desaparecidos no desastre de trem do Canadá	40 ainda ausentes nos acidente de trem canadense
Político da oposição da Tunisina morta a tiros	Líder da oposição da Tunísia morta; protestos entram em erupção
O primeiro -ministro ucraniano Azarov e todo o governo renunciar	As autoridades ucranianas barradas do Canadá enquanto os protestos continuam
As prensas da ONU precisam de grande impulso na ajuda síria	Presses principais da ONU por grande impulso na ajuda síria
Os estoques voam no Wall St Lead	estoques cair em Wall Street
George Zimmerman achou inocente de assassinato de Trayvon Martin	protestos e apelos por calma depois que Zimmerman absolveu o assassinato de Trayvon Martin
O denunciante Edward Snowden voa para Moscou	NSA Whistleblower Edward Snowden deixa Hong Kong em vôo para Moscou
17 mortos, 133 feridos em ataques de bombas no norte do Iraque	2 mortos, 6 feridos em confrontos no norte do Líbano
Insiders revelam segredos eleitorais de 2012	Todos os olhos em Capris como Conjunto Eleitoral da Venezuela
tristeza real sobre a morte da enfermeira	Radio Prankster em lágrimas sobre a morte da enfermeira
N Coréia diz que pode atrasar o controverso lançamento do foguete	n. A Coréia parece pronta para atrasar o controverso lançamento do foguete
Dois soldados da Otan mortos no Afeganistão	soldado da OTAN morto no ataque afegão
Governo dos EUA 'à beira do desligamento'	Obama rejeita a oferta do Partido Republicano para facilitar o desligamento
Gates críticos Memórias Rocks Obama Administration	Gates Blast Rocks Obama Administração
Jeff Bezos aposta US $ 250 milhões em reviver Washington Post	Jeff Bezos paga US $ 250 milhões pelo Washington Post
Brooks se declara inocente de acusações de hackers	Brooks se declara inocente na audiência de hacking por telefone
Purge envia uma mensagem arrepiante para a elite da Coréia do Norte	Purge of Kim tio envia uma mensagem arrepiante para a elite da Coréia do Norte
Os sul -africanos marcam o 95º aniversário de Mandela de Mandela	O ex -primeiro -ministro da África do Sul Nelson Mandela de volta ao hospital
Obama declara	Obama promete fazer com que novas leis de saúde funcionem
chuva forte levanta a ameaça de inundações do dia de Natal	Chuva fresca traz mais inundações
Milhares protestam contra o casamento gay	Milhares protestam contra o casamento gay em Paris
O líder de gangue de Taiwan pegou no aeroporto após 17 anos	A Zâmbia detém o ex-líder de Banda sobre o negócio de petróleo
As leituras obrigatórias da nota para sexta-feira, 6 de dezembro de 2013	As leituras obrigatórias da nota para sexta-feira, 12 de julho de 2013
As negociações no Irã Nuke começam em meio a esperanças de progresso	As negociações nucleares do Irã começam em Genebra
Protestos políticos tailandeses paralisam mais ministérios	Os manifestantes tailandeses sitiam mais ministérios
Bezos da Amazon para comprar o Washington Post por US $ 250 milhões	Bezos da Amazon compra o Washington Post por US $ 250 m
O Tour Econômico de Obama foi buffetado por baixas expectativas	Obama incentiva os escoteiros a terminar a proibição de gays
Israel promete negar o Hezbollah após o ataque aéreo	O carro -bomba mata quatro no Bastião do Hezbollah Beirute: Ministro
A França recebe o acordo EUA-Rússia na Síria	A Liga Árabe recebe o acordo americano-russo na Síria
Mais soldados franceses para a República da África Central	As batalhas de armas na capital da África Central criam pânico fresco
On Resolução Ordens Síria Os braços químicos destruídos	Alemanha pronta para ajudar a missão química da Síria
Update exclusivo 2-Egypt Pro-Mursi Alliance sinaliza flexibilidade em negociações	Update exclusivo 1-Egypt Pro-Mursi Alliance sinaliza flexibilidade em negociações
David Beckham para se aposentar no final da temporada	David Beckham se aposenta do futebol
Mortes confirmadas após o helicóptero colidir com o pub escocês	A polícia escocesa diz que pelo menos um morto depois que o helicóptero colide com o pub
Líbia fecha abruptamente suas fronteiras com quatro países	A Líbia fecha as fronteiras, declara a lei marcial no sul
6.0 Magnitude Quake atinge a Grécia-USGS	5.0 Magnitude Quake Jolts Japan
Pesquise depois que o homem varreu o mar	Lara Planos visitam o Nepal
Militantes cenários no Paquistão Jailbreak	Freak da prisão do Taliban: 250 militantes escapam após ataques à prisão do Paquistão
Meteorito atinge a Rússia central, mais de 500 pessoas machucam	Meteorito atinge a Rússia Central, 400 danos
Teste nuclear da Coréia do Norte Sparks se preocupa	Teste nuclear da Coréia do Norte
Blizzard nos leva a nordeste	Blizzard Wallops nos nordeste, fecha as estradas
Manifestantes da OTAN absolvido de acusações de terrorismo	manifestantes da OTAN condenados por acusações de não terrorismo
'Credibilidade na linha sobre a Síria'	Obama: Congresso, credibilidade mundial on -line
Talibã na agenda para nós no Paquistão	Pelo menos 33 mortos quando Big Quake atinge o Paquistão
123 mortos em luta no norte da Síria	Muitos mortos no ataque aéreo sírio
Ministro do Interior do Egito sobrevive à bomba	O ministro do Interior do Egito sobrevive ao ataque de bomba
O Yuan da China enfraquece para 6.2767 contra USD na quinta -feira	China Yuan enfraquece para 6.1818 contra US $ terça -feira
Obama mantém conversas sobre a ação da Síria	Cameron perde a votação parlamentar sobre ação militar da Síria
O Egito 'congela os ativos da Irmandade Muçulmana'	Egito congela fundos da Irmandade Muçulmana
Relatório Zen: Ain 'T Fácil de ser de alta manutenção	folhas de meteorito russo construindo abertura aberta
Os críticos dizem que as restrições de segurança de Putin violam direitos	O decreto de segurança de Putin para Sochi atrai ira de críticos
Tony Abbott jurou como novo PM australiano	Tony Abbott jurou como Austrália PM
Exército do Egito reprimir a irmandade	Os militares do Egito reprimem a irmandade muçulmana
A Assembléia da Venezuela se reúne em meio à crise de saúde de Chavez	a assembléia se reúne em meio à crise de Chavez
Egito aparece para mais protestos, ora por calma	Egito aparece para mais protestos sobre Morsi, ora por calma
A oposição da Síria ameaça sair das negociações	A oposição da Síria concorda em negociações
Os apoiadores de Morsi protestam no Egito	Morsi Batchers desafiadores diante da ameaça do governo do Egito
O bombardeiro suicida mata o policial no Paquistão	Bombeiros suicidas matam 3 soldados no Paquistão
Manifestantes antigovernamentais invadiram as ruas de Kyiv	Os manifestantes da Ucrânia derrubaram a estátua de Lenin
Homem de Chicago a ser condenado por condenações ao terror	Chefes do Banco de Cabul condenados por corrupção
A Greve dos Drones dos EUA mata três no noroeste do Paquistão	A Greve dos Drones dos EUA mata sete no Waziristão do Norte
A falha de rastreamento interrompe o serviço de trem entre o Raffles Place, Marina Bay	Serviço de trem interrompido entre os sorteios e Marina Bay
As ações aumentam no comércio inicial	As ações dos EUA facilitam a negociação agitada
Manning condenado a 35 anos por vazar segredos do governo	britânico preso por 10 anos por vender detectores de bombas falsas
A polícia do Reino Unido diz que nenhum link para terrorismo para acidente de helicóptero	A polícia da China busca oito suspeitos por acidente
Bomber suicida mata 13 no sul da Rússia	Bomber suicida mata 16 no Volgogrado da Rússia
41 mortos, 22 feridos em ataques violentos no Iraque	15 mortos, 90 feridos em novos ataques no Iraque
Bangladesh Building Collapse Death Toll Hits 540: Exército	Bangladesh Building-Collapse Toll Tops 600
Kerry para visitar a Jordânia, Israel-Palestina Paz na Agenda	Kerry adia a visita a Israel em uma semana
A Zona de Zona do Euro atinge o recorde fresco	UE desempregado acerta recorde fresco
Defiant Mugabe jurou para o sétimo mandato 'vil' oeste	Mugabe jurou para outro termo
O verdadeiro herói de Nelson Mandela não era Gandhi, mas Nehru	A saúde de Nelson Mandela 'instável'
Enfrentando o imposto de resgate, os cipriotas tentam obter dinheiro dos bancos	Termos de resgate Prompt de execução em bancos de Chipre
Obama se inscreve para Obamacare	Os americanos lutam para se inscrever no Obamacare por prazo
Lance Armstrong confessa tudo a Oprah	Lance Armstrong confessa à entrevista de doping na Oprah
Andy Murray merece cavalaria, diz David Cameron	David Cameron: Andy Murray merece uma cavalaria
O índice Hushen 300 se fecha mais alto - out. 14	Hushen 300 Índice fecha mais baixo - 12 de março
Departamento de Estado dos EUA criticou Benghazi	O chefe de segurança do Departamento Estadual renuncia depois de Benghazi
Soccer-France para sediar a Austrália pela primeira vez em outubro	NRA Oficial para enfrentar perguntas pela primeira vez desde observações controversas
embaixador hondurenho na Colômbia demitido após uma festa selvagem	O embaixador de Honduras renuncia após a suposta orgia da embaixada
Síria deve destruir armas químicas	Líbia 'destrói as últimas armas químicas'
Tremor moderado no Mediterrâneo central	Irã: candidato moderado ganha voto presidencial
Três afegãos mortos em ataque suicida	Três afegãos mortos em nova explosão na Base dos EUA, no East Afeganistão
Bombas suicidas atingem o Egito militar no Sinai, mate 6	Bombas suicidas atingem o Egito militar no Sinai, mate 4
Os mercados asiáticos ganham dados econômicos otimistas dos EUA	Mercados asiáticos levantados por dados positivos, dados da China
Nelson Mandela no Hospital para testes	África do Sul: Mandela no Hospital para testes
Irã, seis potências globais assinam acordo nuclear de referência	Irã, as potências mundiais concordam
Bomber suicida mata 9 no comício político do Paquistão	O bombardeiro suicida mata guarda na embaixada dos EUA na Turquia
Quatro apoiadores de Morsi mortos nos confrontos do Egito	Dezenas feridas quando os apoiadores de Morsi se chocam com forças de segurança
Os alunos fazem uma carona em ondas de rádio	5.5 Magnitude Quake atinge Taiwan
Oficial de Pistorius caiu do caso	Oficial de Pistorius por tentativa de assassinato
Vinnie Jones revela a batalha contra o câncer novo	Vinnie Jones revela que ele tem câncer de pele
as ações fecham 0,39 % mais altas	as ações fecham 2,47 % mais altas
Hakimullah Mehsud, chefe do Talebano Paquistão, morto em Drone Strike	O Paquistão Taliban promete vingança, para retribuir o assassinato de Hakimullah em derramamento de sangue
Dezenas mortas no ataque aéreo na padaria no centro da Síria	'Dezenas matadas' na greve aérea síria na padaria
pistoleiros matam um soldado, ferindo outros dois no Paquistão	pistoleiros matam 6 trabalhadores da poliomielite no Paquistão
A polícia confirma como o suspeito foi capturado	Raid no Suspeito de bombardeio de maratona de Boston capturado no filme
A destruição das armas químicas da Síria começa	Destruição das armas químicas da Síria pode ser difícil
inundações nas forças do Canadá evacuação de outra cidade	Evacuação das forças de incêndio da Califórnia de casas, universidade
ONU diz que os drones dos EUA violam a soberania do Paquistão	ONU: os greves dos drones nos EUA violam a soberania do Paquistão
Obama elogia a 'inspiração' de Mandela	Obama é o efeito de inspiração de Mandela
Obama vindo 'para ouvir' Israel, palestinos	Kerry recebe o plano árabe para palestras israelenses-palestinas
Os e -mails - a empresa de petróleo perguntou ao Trader sobre a reunião com o Ministro	A empresa de petróleo perguntou a Rogue Trader sobre se encontrar com o ministro
Toll Toll na Nigéria O ataque policial aumenta para 30	Toll de morte no ataque de ônibus do Quênia sobe para seis
Síria 'declarar armas químicas e assinar a convenção'	Rússia, Síria trabalha no plano de armas químicas 'concreto'
Austrália para descartar o teto nacional de dívida nacional	O PM australiano não insiste nenhum argumento com a Indonésia
Mercados asiáticos atingiram 3 semanas na esperança de acordo com a dívida dos EUA	As ações asiáticas atingiram o máximo de três semanas na esperança dos EUA acordo de dívida
O primeiro -ministro italiano Mario Monti renuncia	'Primeiro -ministro palestino Fayyad renuncia'
África do Sul admite erro sobre o signatário "esquizofrênico" Mandela	A África do Sul admite possível 'erro' sobre o assinante surdo no Mandela Memorial
O Irã diz que questões sérias permanecem em negociações nucleares	O Irã promete preservar o programa nuclear "pacífico"
multidões se reúnem em Belém para o Natal	Oh, pequena cidade de Belém - de verdade
Sete forças de paz mortas no Darfur do Sudão	Pazekeeper morto no confronto de Abyei
OTAN: bateria de mísseis patriota operacional na fronteira síria	Obama: baterias de mísseis Patriot, tropas para ficar na Jordânia perto da fronteira síria
As ações dos EUA caem no terceiro dia de desligamento	As ações caem no terceiro dia de desligamento do governo
Votos da Guiné em Legislativa Delida há muito tempo	Equatoguineanos votam em pesquisas legislativas
OTAN: 3 tropas mortas no ataque do Afeganistão	Tropas da OTAN mortas no 'ataque insider' afegão
O soldado israelense atinge a criança palestina em Hebron	Soldados israelenses matam a mulher palestina na margem ocidental
ONU Voices Alarme com ataques israelenses na Síria	Oficial israelense confirma o segundo ataque aéreo na Síria
O Exército do Egito lança novos ataques aéreos aos militantes do Sinai	O Egito lança novos ataques contra militantes do Sinai
As forças francesas atacam os aliados do Mali da Al-Qaeda	Uma batalha para retomar o Mali do Norte: Centenas de tropas frances
Polícia Egípcia Fire Limbo Gas nos manifestantes da Irmandade	Índia: gás lacrimogêneo disparado contra manifestantes de estupro de gangues
O regime da Síria concorda em participar da conferência da paz	Síria, oposição concorda 'em princípio' para participar da conferência da paz
Os legisladores afegãos aprovam uma nova lei eleitoral	Presidente afegão aprova a nova lei eleitoral
A Argélia monta a operação militar para resgatar reféns da Al Qaeda	Argélia reflete a força internacional para reféns
Dezenas feridas como Boeing 777 Jet Crash Lands no aeroporto de São Francisco	Asiana Air Boeing 777 Crash Lands no aeroporto de São Francisco
13 crianças morrem no fogo Mianmar Mesquita Fogo	A polícia de Mianmar diz que 13 crianças morrem em incêndio elétrico na mesquita
O Senado dos EUA para votar no acordo fiscal do penhasco quando o prazo se aproxima	Cliff fiscal: atrasos na Câmara Vote no acordo fiscal do penhasco - ao vivo
A vítima de estupro de gangues de Delhi morre no hospital de Cingapura	Vítima de estupro de gangues de Delhi voou para o Hospital Singapura
Controle de natalidade ligado ao maior risco de glaucoma	pílula contraceptiva 'dobra o risco de glaucoma'
Homem com faca presa na entrada do Palácio de Buckingham	Homem acusado após a prisão do Palácio de Buckingham
5 pessoas enterradas no Colorado Avalanche	'5 snowboarders mortos no Colorado Avalanche'
Ban Ki-moon para revisar o Accord de armas químicas da Síria	proibição de revisar o acordo de armas químicas da Síria
Presidente iraquiano no hospital devido a um problema de saúde	Presidente iraquiano no hospital depois de sofrer derrame
A coalizão de longa chuva da Malásia se apega ao poder	A coalizão dominante da Malásia ganha a maioria
Almagor explode Netanyahu sobre a libertação do prisioneiro	Yacimovich pede ao gabinete que aprove a libertação dos prisioneiros palestinos
Explosões perto da embaixada iraniana em Beirute	duas explosões perto da embaixada iraniana em Beirute
19 doer no tiroteio de Nova Orleans	Polícia: 19 doeu no tiroteio do dia da mãe de Nola
Hagel lamenta mudanças "políticas" no orçamento de defesa dos EUA	Hagel defende cortes propostos nos gastos com defesa
nós. proíbe líquidos de mão, géis em voos para a Rússia	Us proibir líquidos de mão em voos diretos para a Rússia
A Irmandade do Egito fica moída após os assassinatos	Egito: Irmandade muçulmana está atrás de Morsi
Conjuntos da Malásia 5 de maio como data para eleição disputada de perto	A Malásia está data para as eleições marcantes
Tropas da OTAN matam duas crianças afegãs	Greve da OTAN mata 11 crianças afegãs
Presidente iraniano pede novas negociações nucleares	O ministro iraniano culpa o oeste por conversas fracassadas
Inundações matam duas, forças 75.000 de casas de Calgary	Forças de inundação 75.000 de casas do Canadá
4 tropas da OTAN mortas no Afeganistão	Oito tropas da OTAN mortas no Afeganistão
Typhoon FaTow chega à terra no leste da China	Typhoon Fatow bate no sudeste da China
Mandela para passar o Natal no hospital	filme de Mandela para abrir este mês na África do Sul
Pesquisas de saída sugerem que Putin Ally ganha o voto de Moscou	As pesquisas de saída mostram que Putin Ally ganha voto em Moscou, Navalny grita falta
O juiz entra sem culpa por James Holmes	Não culpado por James Holmes - mas a opção de insanidade ainda na mesa
Pelo menos 45 mortos no acidente de trem da Espanha	Pelo menos 13 mortos em carros -bomba triplos em Diyala do Iraque
Dhawan esmaga a Índia para uma grande vitória sobre a África do Sul	Dhawan Ton estabelece uma vitória no troféu da Índia sobre a África do Sul
Chris Froome Rides para Tour de France Endgame	Concertos de Chris Brown cancelados novos
Apple App direciona os motoristas para a pista do aeroporto do Alasca	Apple App envia motoristas para o aeroporto
Suspeito que o drone dos EUA mata 3 militantes no Paquistão	nós. drone mata 4 militantes no Paquistão
Hospital: 61 morto na prisão de Venezuela Riot	Dezenas relatadas mortas no tumulto da prisão da Venezuela
confrontos em erupção quando os islâmicos se afastam no Egito	Sacerdote Copta Silir tirado no Ataque do Egito
N Coréia adia reuniões familiares	A Coréia do Norte adia sindicatos da família devastados pela guerra
Francis começa papado com oração	O papa Francisco sai do Vaticano por orações
O Senado dos EUA para se encontrar como caminho fora do impasse fiscal ainda ilusório	O Senado dos EUA tem raros dias de sessão de domingo em meio a impasse fiscal
A Irmandade do Egito tão sitiada quanto seu líder	Irmandade muçulmana do Egito para março em massa
Queen presta homenagem a Nelson Mandela	Os presidentes dos EUA prestam homenagem a Mandela
A nova fragata furtiva da China encomendada	Bielorrússia, Letônia para estabelecer a Comissão de Fronteira
A violência do Iraque mata 11	A violência do Iraque mata sete
Os protestos continuam em tenso capital da Ucrânia	Os protestos continuam no Brasil
Síria nos rejeita, reivindicações de armas químicas do Reino Unido	EUA suspeitam que a Síria usasse armas químicas
Os britânicos lançados após sequestrar no Sinai -Sinai -Sinai -Sinai -	Liberação beduína Dois britânicos apreendidos no Sinai do Egito
A Síria recebe o acordo nuclear do Irã	Irã, seis potências mundiais conquistam o negócio nuclear de avanço
Israel enfrenta uma reação européia sobre o plano de liquidação	Israel chamado para prestar contas sobre os últimos planos de liquidação por países europeus
O Irã diz que captura o drone; nós. nega perder um	O Irã diz que apreendeu os EUA drone; nós. diz que não é verdade
O Egito prende o guia supremo da Irmandade Muçulmana	O Egito proíbe o grupo de Irmandade Muçulmana
Obama brinca sobre si mesmo no jantar dos repórteres	Obama zomba da diversão nos críticos durante o jantar da imprensa
Allen responde às reivindicações de abuso de Farrow em carta	Allen se defende contra as reivindicações de abuso de Farrow
pistoleiros matam nove pessoas no noroeste do Paquistão	pistoleiros matam 3 policiais no Iraque
Mais de 1.000 presos escapam da prisão de Al-Kweifiya da Líbia	1000 prisioneiros escapam da prisão da Líbia
Qual é a opção nuclear?	Fotos mostram n. Coréia, prontidão nuclear
forex & amp; ouro 6 de março de 2013	Forex & Gold 12 de março de 2013
Islamitas matam 21 em ataques suicidas no Níger	bombas de carro matam 20 na cidade turca perto da fronteira síria
nós. determinou que a Síria usou armas químicas	Votos da ONU para eliminar as armas químicas da Síria
O pai de Snowden chega em Moscou	Pai de Edward Snowden em Moscou
Sem vazamento de radiação na usina nuclear do Irã	O Congresso dos EUA pode lançar uma chave no negócio nuclear do Irã
Pakistani Taliban nomes novo líder após greve de drones	Chefe do Taleban Pakistani morto no greve dos drones dos EUA
Bonranceiros gêmeos no Paquistão matam pelo menos 40	Agora, os militantes batalham na polícia paquistanesa
O defensor da Irmandade Muçulmana morre no confronto do Cairo	Os apoiadores da Irmandade Muçulmana morrem no Egito confrontos
Os ganhos do Facebook saltam 63 % à medida que os anúncios móveis aceleram	Os lucros do Facebook saltam à medida que a base de usuários se expande
Enviado da Síria pede governo de unidade nacional	Enviado da Síria pede mudanças políticas para acabar com o conflito
Resumo de notícias para 11 de março	Resumo de notícias para 14 de janeiro
Trinta e sete mortos na Itália Bus de ônibus	Trinta mortos em um mergulho italiano de ônibus
Rogers, VideoTron estende o alcance com negócios de compartilhamento de rede	Rogers, VideoTron Reach de compartilhamento de rede, acordo de espectro
As ações da China terminam na quinta -feira mais baixa	As ações da China se aproximam da quinta -feira
Mulheres de topless protestam contra Berlusconi enquanto ele vota na eleição	O presidente da Bulgária apóia os manifestantes, se opõe às eleições instantâneas
Indonésia: crianças em idade escolar entre 14 mortos pela erupção do vulcão da Indonésia	Indonésia: Seis mortos na erupção vulcânica indonésia
Execução islâmica de Bangladesh	Bangladesh executa o líder da oposição
O líder do Irã Rouhani diz que o acordo nuclear com os EUA possível em três meses ¿	O presidente do Irã, Hassan Rouhani, quer um acordo nuclear em meses
acordo alcançado no novo governo italiano	Itália para jurar em um novo governo de coalizão
Obama lamenta a morte do ícone Nelson Mandela	Os sul -africanos lamentam, celebrar Mandela
Havaí passa uma conta de casamento gay	O Senado dos EUA aprova a conta dos trabalhadores gays
Goa Primeiro passo em Modis March para Delhi	Pela primeira vez na história, a Technion para ensinar engenharia na Rússia
Os estoques de Cingapura fecham 0,4 % mais altos	Estoques indianos abrem mais alto
Maldivas realiza novas eleições para presidente	Maldivas realiza novas eleições presidenciais
O Egito anuncia a prisão de 1.004 apoiadores da Irmandade Muçulmana	Ordens do Egito prisão do chefe da irmandade Badie
O New World Trade Center declarou edifício mais alto nos EUA.	Um centro comercial de um mundo nomeado mais alto edifício dos EUA
O que dizem os papéis, março. 12, 2013	O que dizem os jornais, 25 de junho de 2013
Israel Lights Greens 1500 Casas de colonos	Israel revela 1.800 mais casas de colonos
Piers Morgan questionou pela polícia	Piers Morgan entrevistado pela polícia em estojo de hackers
A oposição síria pede que a UE envie armas para rebeldes	A oposição síria se reúne para escolher PM intermediário
As ações de Cingapura terminam 0,11 pct	Estoques de Cingapura fecham 0,54 pct mais alto
Case de gangrena fotojornalista de Mumbai rachada, cinco acusados ​​presos	Caso de estupro de gangues jornalistas de Mumbai: todos os cinco acusados ​​presos
'israelense' preso no Iêmen Mossad Spy	Forças israelenses detêm 2 em Hebron Raid
Garotas paquistanesas aprendem uma lição difícil	Garota paquistanosa filmada por Taliban aparece em vídeo
O presidente interino do Egito nomeia 2 consultores	O presidente interino do Egito juram em novo gabinete
Funeral da namorada de Oscar Pistorius, Reeva Steenkamp	Oscar Pistorius 'tiro Steenkamp no banheiro'
A China lança o primeiro míssil ar-ar do helicóptero	O tribunal da China sentencia Bo Xilai à prisão perpétua por corrupção
Reino Unido confirma temores sobre as armas químicas da Síria	fim 'próximo' para as armas químicas da Síria
A repressão do Egito atrai condenação	Egito: o Egito Recutupso Sparras Global Indign
Dois bombeiros mortos em Nova York emboscada	Dois bombeiros de Nova York em condição vigiada após emboscada mortal
Egito jura em novo líder interino	Exército do Egito reprimir a irmandade
carros -bombardeios mata 17 no Paquistão	Bomber suicida mata 10 no Paquistão
Dez resgatou em Waterford, costas de Dublin	Seis resgatados após o barco limite em Dublin Bay
2 Membros de Pussy Riot se reuniram em Krasnoyarsk	Pussia libertada par de tumultos agitados contra protestos anti-putin
Comandante do Taliban Paquistão Sênior capturado no Afeganistão	O Paquistão Shi 'exige proteção contra militantes
Driver no acidente de trem espanhol enfrenta perguntas do juiz	motorista de trem na Espanha Crash questionada pelo juiz
as ações fecham 0,39 % mais altas	As ações de Cingapura fecham 0,31 pct mais baixo
US libera relatório inicial sobre impactos de fracking na água	Homens na China detidos depois de levar meninas para o hotel
Rússia 'sozinha' em culpar os rebeldes sírios por ataque químico: EUA	A Rússia pede à ONU que considere sua investigação sobre o uso de armas químicas da Síria
Filipinas, rebeldes atingem o negócio de compartilhamento de riqueza	Filipinas e rebeldes alcançam 'acordo de riqueza'
Toll de mortal da violência do oeste da China sobe para 35	Urgente: Toll de mortal de NE China Fire sobe para 112
Israel lança o Airstrike em Gaza	Israel lança ataques aéreos perto de Damasco
Inundações deixam seis mortos nas Filipinas	Chontes fortes deixam 18 mortos nas Filipinas
Mars Rover coleta a primeira amostra de rocha	Wawrinka chega à primeira final do Grand Slam
Imran para disputar quatro assentos de NA	Imran Khan para contestar as eleições de quatro assentos de NA
Trailblazing Israeli Electric Car Company Melhor lugar para dobrar	TRABALHA ISRIRII EMPRESSÃO ISRIALII ELECTRIC para dobrar
O treinador principal do Houston Texans, Gary Kubiak, hospitalizado após o colapso no jogo	Treinador dos texanos Gary Kubiak em estado estável após o colapso
O senhor da guerra do talibã pró-Pak morto no greve dos drones dos EUA	Comandante do Taliban matou no greve dos drones dos EUA
Ankeet Chavan concedeu fiança condicional para casamento	Ankeet Chavan concedeu fiança para se casar
carro bomba mata 20 no noroeste da Síria	carro bomba no norte da Síria mata 20
Soldados sul -coreanos matam o homem tentando atravessar a fronteira para o norte	A Coréia do Norte fecha a última linha direta restante para o sul
Até 50 mortos no acidente de trem espanhol	Mais de 70 mortos no acidente de trem em alta velocidade espanhol
Cinco estrangeiros condenados à morte por contrabando de drogas no Egito	Egito sentenças paquistanesas em meio a 5 até a morte por contrabando de drogas
O trem francês descarrila ao sul de Paris	Os passageiros do trem francês falam de provação de acidente
ex -porta -voz dos EUA Presidente Ronald Reagan morre	O ex -porta -voz de Reagan Larry fala morre aos 74
Egito vota na nova Constituição	Os egípcios votam na constituição divisória
Obama conhece a família Mandela como ícone permanece no hospital	Obamas para se encontrar com a família Mandela não visitam o Hospital
O Irã moderado vence a presidência por uma grande margem	O Irã ameaça desencadear guerra ao preço do petróleo
Lucros fracos nos arrastam ações mais baixas no comércio inicial	Os ganhos fracos arrastam estoques mais baixos em Wall Street
O homem que lutou contra Fukushima morre de câncer	Ex -chefe de plantas que lutaram contra Fukushima que morre de câncer
três temidos mortos após o helicóptero colidir com pub	três temidos mortos após o helicóptero pub acidente
O legislador da Nigéria acusado de suposto suborno	deputado nigeriano acusado de aceitar suborno de US $ 3 milhões
Rupee Down 8 Paise vs Dollar no comércio inicial	Rupee Up 22 Paise contra Dollar no comércio inicial
O Irã diz que negociações nucleares para retomar no próximo mês	O Irã diz capaz de tocar os sistemas de comunicação dos inimigos
Peres de Israel pede que retorne às negociações de paz	Peres de Israel exige que o retorno às negociações de paz
Obama começou a falar sobre a Síria da Casa Branca às 13h 15h. EDT	Obama para entregar a declaração sobre a Síria na Casa Branca às 13h 15h
Estoques indianos abrem mais baixo	Estoques indianos fecham mais baixo
Nós preparam a possível ação solo contra a Síria	EUA defendem a ação contra a Síria
breves confrontos com a polícia em Belfast	Enloures confundem com a polícia na Tunísia
New World Trade Center, edifício mais alto de nós	Um centro comercial de um mundo nomeado mais alto edifício dos EUA
As autoridades dos EUA cobram o homem na sonda Ricin	A polícia sul -africana prende 50 em protesto agrícola
Quake da China: o número de mortos aumenta	China Fried Death Toll sobe para seis
Quatro presos quando o pedágio de Bangladesh aumenta para 352	Proprietário preso como Bangladesh Building Toll atinge 372
25 corpos encontrados em planta de gás argelino invadido	25 mais corpos encontrados na planta de gás argelino
RI condena o uso de armas químicas na Síria	Perguntas surgem sobre reivindicações de armas químicas na Síria
Novos acertos fortes do terremoto quebraram a região de Pak	poderosos novos acertos de terremoto quebraram a região do Paquistão
Tropas indianas matam soldados paquistaneses ao longo da linha de controle Caxemira	Tropas indianas RAID POST MILITAL PAKISTANI
O Papa Benedict XVI diz adeus aos cardeais	O Papa Bento XVI parte do Vaticano pela última vez
Designer de moda Lilly Pulitzer Dies	Designer, Socialite Lilly Pulitzer morre aos 81
china ’ s new carrier extends military modernization drive	Vice-Premier chinês conhece o governador-geral australiano
O líder brasileiro realiza palestras de crise nos protestos de rua	O líder do Brasil promete o voto de reforma
Tempestade tropical Andrea pegando a costa leste	Tempestade tropical Andrea para deslizar pela costa leste
New Japan Govt sugere ingressar no Pacific Trade Pact: Relatório	Japão, EUA realizam palestras ligadas ao pacto de comércio regional
Quatro mortos no acidente de trem da Indonésia	cinco mortos enquanto o trem da Indonésia colide com o caminhão de combustível
Israel Advances planeja construir 900 casas de liquidação	Israel revela os planos para novas casas de colonos
Miss New York vence Miss America Crown	Miss New York é coroada Miss America
Sites combatem comentários desagradáveis, anonimato	Os sites combatem comentários desagradáveis ​​ao tirar o anonimato
Austríaca encontrou acumulação 56 crânios roubados no Museu Home	O homem austríaco acusado depois que 56 crânios humanos são encontrados em sua casa
EUA preparados para a inauguração de Obama	Us House apoia novas sanções antes da inauguração do Irã
Suspeito militante saudita morre com custódia libanesa	Suspeito que o drone dos EUA mate 6 militantes no Iêmen
O homem se pega fogo no National Mall	Man incendeia -se no National Mall de Washington.
7 mortos em ataques no Iraque	27 mortos em ataques no Iraque
Milhares protestam contra o casamento gay	Milhares protestam contra o casamento gay na França
Índia tinta: Imagem do dia: 27 de janeiro	Índia tinta: Imagem do dia: 20 de março
US CAPITOL HILL ON LOCKDOWN depois que os tiros dispararam	Assista ao vivo: US Capitol no bloqueio após relatos de tiros disparados
A 1ª zona de livre comércio piloto da China é aberta	Zona de livre comércio de Xangai começa a operação
12 mortos, 25 feridos em explosão de bombas no Paquistão NW	6 mortos, 12 feridos em explosão em nw pakista
Selecione imagens do colapso do prédio de Bangladesh	Pelo menos 200 mortos no colapso do prédio de Bangladesh
O Tribunal Chinês defende as penalidades de morte por assassinos mekong	O tribunal defende sentenças de morte para assassinos de mekong
Os manifestantes do Egito 'a serem dispersos'	Professor de abdução a ser sentenciado
A explosão do cilindro a gás no ônibus escolar do Paquistão mata 17	A explosão mortal de cilindro a gás atinge o ônibus escolar do Paquistão
A carga norte -coreana revela o comércio de reparos de mísseis com Cuba	N Navio coreano carregando mísseis Cuba apreendidos
As forças israelenses detêm 5 palestinos na Cisjordânia	As forças israelenses prendem cinco palestinos em toda a margem ocidental
protestos varrem o Brasil, apesar da concessão	protestos planejados em todo o Brasil, apesar das concessões
Angela Merkel vence o terceiro mandato nas eleições alemãs	Merkel ganha grande na eleição da Alemanha
Missa policial turca perto da área de protesto de Istambul Park	A polícia britânica nega proteger o agressor sexual Savile
Trabalhadores sul -coreanos começam a deixar a zona conjunta de fábrica	Trabalhadores sul -coreanos estabelecidos para deixar a zona conjunta de fábrica
Senado para votar em avançar em Hagel Nod	Benedict chega em casa para a nova casa e um novo papa
15 mortos e pontuações feridas em bombardeio suicida na estação de trem russa	Bomber suicídio mata 14 na estação de trem russa
Guatemala prende o guru do software John McAfee	Realizado na Guatemala, o guru de software McAfee luta contra a deportação
O líder da oposição cambojana Sam Rainsy retorna para agitar a eleição	Cabeça da oposição do Camboja se volta para o Parlamento na oferta de pesquisa
West é voto na oposição da Síria para ingressar em negociações de paz	oposição síria ao nome da delegação para negociações
Obama viaja para Oklahoma devastado pelo tornado	Obama visita o tornado atingido Oklahoma
Nenhum acordo com penhasco fiscal enquanto Obama sai de férias	John Boehner: De origem humilde, Fiscal Cliff pode ser sua ruína
Biden exige confiança nas relações EUA-China	Biden exige confiança na construção de "novo relacionamento" com a China
A Síria Bomba mata pelo menos 12 na cidade controlada por rebeldes	O carro -bomba do Sinai mata pelo menos 10 soldados egípcios
Kerry: Plano econômico palestino de US $ 4 bilhões poderia funcionar	Kerry: Nenhum acordo ainda em negociações nucleares com o Irã
Bangladesh Building Collapse Death Toll Hits 359	Edifício indiano colapsa o número de mortos aumenta para 72
Dezenas mortas na República da África Central lutando	98 mortos na República da África Central após confrontos
Líbia ameaça a ação do exército contra manifestantes de petróleo	Evacuação das forças de ameaças de bomba em Princeton
2 sindicatos turcos pedem greve na segunda -feira em protesto pela violência policial	agitação da peru: os sindicatos pedem greve sobre a repressão policial
[ticker] Fitch atualiza a classificação de crédito grego	Atualizações de Moody Classificação de crédito grego
Ambasmenos de pistolas de barco policial na região petrolífera da Nigéria	Polícia Sudanesa Block Protest na Comissão de Direitos Humanos
Russos deixando a Síria cruzar para o Líbano	A Rússia oferece ajuda humanitária a refugiados sírios no Líbano
dois EUA Soldados mortos no ataque "Insider" no Afeganistão	8 soldados mortos em ataque de bomba no Paquistão NW
Ícone da África do Sul Nelson Mandela hospitalizada	Nelson Mandela, da África do Sul, hospitalizada
Ferrer Cruzes para as quartas de final da Australian Open	Ferrer vence Nishikori para avançar para as quartas de final do Aberto da Austrália
UBS resolve o processo de hipoteca dos EUA	O UBS resolve o processo de hipoteca dos EUA e recebe cobrança de £ 600m
O Papa Francisco condena a indiferença global ao sofrimento	O papa Francisco comemora migrantes mortos em Lampedusa
O principal juiz Mansour jurou como presidente interino do Egito	Justiça Adly Mansour jurou como presidente interino do Egito
Norte, Coréia do Sul concorda em negociações	Norte, Coréia do Sul, realiza conversas raras
Blast mata 10 meninas jovens no leste do Afeganistão	Blast mata nove no sul do Afeganistão: funcionários
Polícia queniana prenda a chave al-Shabaab Recruither, financiador	Quênia: par preso pela polícia anti-terror
Obama para anunciar planos de controle de armas na quarta -feira	Obama para estabelecer planos de controle de armas
bombas matam duas pessoas, feridas em dezenas na maratona de Boston	Apenas duas bombas encontradas no ataque da maratona de Boston
As armas químicas da Síria podem acabar no mar	nós para destruir o estoque de armas químicas da Síria no mar
Presidente da conclusão antecipada da parceria ecológica com o Sri Lanka	PM do Paquistão para laços econômicos mais profundos com o Sri Lanka
Três liberados na sonda de abuso central	Cabras de construção de três andares em meta ebuto
A bomba explode no shopping grego, duas pessoas feridas	A bomba explode no shopping de Atenas, 2 feridos
Seis australianos mortos no acidente de avião do Laos	Dezenas mortas no acidente de avião do Laos
três mortos, incluindo atirador, no tiroteio de Maryland Mall	3 mortos no tiroteio no shopping de Maryland
ONU confirma Sarin usado no ataque da Síria	'Crime de guerra': ONU. descobre Sarin usado no ataque de armas químicas da Síria
7 mortos no acidente de caminhão monstro	6 mortos no México 'Monster Truck' Crash
4 mortos após o barco limpam a costa da Flórida	8 mortos após fortes chuvas na ilha de São Vicente
Cannes Thief 'rouba US $ 53 milhões de jóias' em assalto armado no hotel	Ladrão rouba US $ 53 milhões em jóias em Cannes, diz a polícia
Merkel conquista 3º mandato no cargo nas eleições da Alemanha	Merkel ganha grande na eleição da Alemanha
homens armados matam políticos femininos no Paquistão	pistoleiros matam 5 professores no Paquistão
O governador ex-Virginia, Bob McDonnell, acusado de corrupção	Ex-Gov da Virgínia. Bob McDonnell, esposa acusada de corrupção
Os velocistas Tyson Gay e Asafa Powell testam positivo para a substância proibida	Testes gays de velocista dos EUA Tyson positivos para substância proibida
6.3 Quake de magnitude Hits Honshu, Japão: CENC	Magnitude-6.0 Quake Jolts Santa Cruz Islands: CENC
Paquistão para libertar a maioria dos prisioneiros do Taliban Afeganistão	Paquistão para liberar comandante sênior do Taliban no sábado
Divórcio Kardashian pronto para julgamento	Hotéis atingidos prontos para a guerra de preços
Ordens do Tribunal do Egito Liberação de Mubarak	O Tribunal do Egito ordena que Mubarak liberte
Investigadores americanos esperando para questionar Boston Bomber preso	A polícia converge para a rua em busca de suspeito de bomba de Boston
Nelson Mandela passa por uma cirurgia	"Nelson Mandela está se recuperando"
10 mortos, cinco feridos no acidente rodoviário da SW China	1 morto, 39 ferido no acidente de estrada da China
Bollywood reduz os custos em um terço, enquanto as picadas de colapso da rupia	Bollywood reduz os custos como picadas de crise de rupia
Mulheres para enfrentar prêmios mais altos de seguro de carro	Motoristas para enfrentar aumento do prêmio do seguro
Tornados rasgam o meio -oeste, matando 6 e bairros devastadores	Tornados, tempestades prejudiciais atingem os EUA Centro -Oeste, matando 5
A China nos dá acesso aos reguladores a registros de auditoria	A China se opõe às vendas de armas dos EUA a Taiwan
As ações de Cingapura terminam 0,26 %	As ações de Cingapura terminam 0,11 pct
Irã, agência atômica nas primeiras negociações desde a eleição de Rowhani	IAEA, Irã, para manter as primeiras negociações nucleares desde a eleição de Rohani
O novo PM da China nos rejeita reivindicações de hackers nos EUA	O premier da China Li rejeita as acusações de hackear nos 'fundamentais'
Aeronaves militares dos EUA atingidas em s. Sudão, 4 feridos	Aeronaves militares dos EUA dispararam durante a missão de evacuação no Sudão do Sul
Nova Zelândia preparada para legalizar o casamento gay	Votos da Nova Zelândia para legalizar o casamento entre pessoas do mesmo sexo
Dzhokhar Tsarnaev se declara inocente de acusações de bombardeio de Boston	Dzhokhar Tsarnaev atacou o bombardeio de Boston Marathon
Fotos do dia: 7 de agosto de 2013	foto do dia
O filho do general chinês recebe 10 anos de prisão por estupro	Filho de cantores do exército chinês recebe 10 anos de prisão por estupro de gangues
P.G. Polícia buscando motorista em acidente que matou criança	A polícia busca pistoleiros no desfile do dia da mãe de Nova Orleans
Egito para realizar eleições presidenciais antes das pesquisas parlamentares	O presidente interino do Egito juram em novo gabinete
Pentágono ajusta os planos para ataques mais intensos à Síria	Pope agradece a público por se juntar à sua vigília na Síria
Timor -Leste proíbe clubes de artes marciais em meio a assassinatos	Timor -Leste proíbe as escolas de artes marciais em meio a assassinatos
Os legisladores afegãos aprovam uma nova lei eleitoral	Presidente afegão aprova a nova lei de Electon
No Paquistão, exército inflexível em combater o outro Taliban	Pak Exército adamant em combater o outro Taleban
Exército egípcio empurra para atacar seqüestradores	O Morsi do Egito exclui as negociações à medida que o vídeo de refém aparece
Os sul -africanos lamentam quando Mandela enterrou	A África do Sul detém o funeral estadual para Mandela
Testemunhas ouvem 'Booms Altos' na Maratona de Boston	Relatório de duas explosões na linha de chegada da maratona de Boston
palavras cruzadas enigmáticas - sábado, 27 de abril	Palavra cruzada do teste - sábado, 27 de abril
Capitão da Costa Concordia para ser julgado por homicídio culposo	Costa Concordia Sobreviventes Experiência detalhada um ano depois
O ministro israelense bate o aviso de boicote de Kerry	O ministro israelense bate o aviso de boicote de Kerry
A Suprema Corte do Quênia defende o resultado da eleição	O Quênia SC defende o resultado da eleição
A tia de Angelina Jolie morre de câncer de mama	Angelina Jolie e a complexa verdade sobre o câncer de mama
O Suu Kyi de Mianmar pede a unidade do partido em meio a disputas	Suu Kyi pede a unidade do partido em meio a brigas
10 coisas para saber para quarta -feira	10 coisas para saber para hoje
Casa Branca, Empreiteiros de Defesa discutem danos dos cortes de gastos automáticos	Casa Branca, empresas de defesa discutem cortes de gastos automáticos
Hugo Chavez da Venezuela morre de câncer	Presidente venezuelano Hugo Chavez morre de câncer aos 58
Toll de mortal no Colorado inundações sobe para quatro	milhares disseram para evacuar em inundações do Colorado
ex -presidente da Zâmbia preso	O ex-presidente da Zâmbia, Rupiah Banda, preso
O Senado dos EUA confirma Yellen como a próxima cadeira do Fed	O Senado dos EUA confirma Janet Yellen como novo chefe do Banco Central
26 prisioneiros palestinos libertados da prisão israelense	Prisioneiro palestino morre de câncer, agitação nas prisões de Israel
As ações asiáticas se manifestam após a série de dados otimistas	A asiáia comercializa dados fortes nos empregos nos EUA
17 mortos, 133 feridos em ataques de bombas no norte do Iraque	15 mortos, 90 feridos em novos ataques no Iraque
Oficial ferido na Índia anti-estupro protestos morre	O policial indiano ferido em matrizes de protesto de gangue
Reivindicações do regime da Síria de 5.000 perto de Damasco	O Exército da Síria continua operações de limpeza perto de Damasco
Chipre Comentário de alarmes dos mercados de alarmes	Por que o resgate de Chipre nada mais é do que um absurdo de euro habitual
Nomes de facções Bianca Ojukwu Apga líder nacional	Bianca Ojukwu se torna líder nacional da Apga
nós não podemos 'determinar conclusivamente' usar armas químicas no uso da Síria	nós. Não vê evidências conclusivas de uso de armas químicas pela Síria
doze mortos como pistoleiros de ataque	Cinco mortos em explosões na Índia
Egito fecha o jornal da Irmandade Muçulmana	Egito: Vice -Cabeça da Irmandade Muçulmana presa
Forte terremoto no oeste da China mata 47 pessoas	forte terremoto no oeste da China mata pelo menos 75
O autor vencedor do Prêmio Nobel Doris Lessing Dies	Nobel Laureate Doris Lessing morre aos 94
Snowden agradece a Rússia pelo asilo	Snowden agradece à Rússia por conceder asilo
Senado confirma Yellen como cabeça alimentada	O Senado dos EUA confirma Yellen como a próxima cadeira do Fed
As forças francesas tomam a chave do Mali	As forças francesas apreendem a cidade -chave
Nicarágua, Venezuela oferece asilo a Snowden	Morales da Bolívia diz que concederia asilo a Snowden se solicitado
Suspeito de bombardeio de Boston enterrado na Virgínia	Suspeito de bomba de Boston enterrado no cemitério da Virgínia
Tornado 'grande e extremamente perigoso' segue em direção a Oklahoma City	Mamãe e bebê entre cinco mortos como Tornados Rake Oklahoma City Area
O drama de reféns se arrasta após o tiro de ônibus da escola do Alabama	Nevada: 2 Dead, 2 doeu no tiroteio no ensino médio
Presidente palestino atribui acadêmico para formar	Presidente palestino quer que os israelenses falem em paz
5 mortos, 50 feridos na explosão do Paquistão	3 mortos, 138 feridos em Boston Blasts: mídia
Malala do Paquistão deixa o Hospital para aguardar a cirurgia	Malala deixa o Hospital Britânico
Internet, serviço telefônico restaurado na capital síria	Serviço de Internet é retomado na Síria
Dois encontrados mortos na piscina no Essex Hotel	homem e mulher encontrados mortos na piscina de Essex Hotel
PM sírio sobrevive ao ataque de bomba	PM sírio sobrevive ao ataque de bomba em capital
O Paquistão condena a greve dos drones nos EUA na área de Shawal	O Paquistão nos condena o greve de drones nos Miranshah
Os moradores retornam ao site de explosão do Texas	Moradores retornam a Fallujah
África do Sul ora por Nelson Mandela	África do Sul se une em oração e música para Nelson Mandela
Ahmadinejad, do Irã	Ahmadinejad pode enfrentar acusações por aparência eleitoral
Pelo menos 38 apoiadores de Morsi morrem em confrontos	Dezenas de apoiadores de Morsi mortos nos confrontos do Egito
Miliband se compromete a fortalecer o salário mínimo	Portugal-China para fortalecer os laços de pesquisa científica
As ações de Cingapura fecham 0,44 pct mais baixo	Estoques de Cingapura fecham 0,5 pct mais alto
Sniper esperando o resultado do recurso	novas glórias para a China em buscar renovação
Os futuros de ações dos EUA se aproximam do relatório de empregos	Os futuros de ações se aproximam, todos os olhos no Fed
As ações chinesas se aproximam na quarta -feira	As ações da China se aproximam da sexta -feira
Os compartilhamentos da Apple atingiram muito a decepção do iPhone	As ações da Apple mergulham 11 % após a decepção dos ganhos
A UE renova sanções contra o Zimbábue	UE levanta sanções de diamante contra o Zimbábue
Território palestino ocupado: palestinos rejeitam o plano de palestras dos EUA	Território palestino ocupado: os palestinos enfrentam uma rota para lugar nenhum
Proprietários, outros acusados ​​no incêndio da fábrica de Bangladesh	50 sobreviventes encontrados na fábrica de Bangladesh
Egito definido para atrair investidores do Golfo	O Egito procura atrair investidores ...
Acordo de alcance dos EUA-Rússia na Síria	Acordo de alcance dos EUA-Rússia sobre armas da Síria
Palestinos, Jordânia Coordenam posturas sobre negociações de paz	O sênior do Hamas nega Gaza, PA coordenado em negociações de paz
Votação cancelada em três províncias em tensão eleição tailandesa	A oposição do Camboja rejeita a vitória eleitoral de Hun Sen
Miss New York coroou Miss America 2013	Miss New York é coroada Miss America
Obama cancela Moscou reunião com Putin	Obama cancelou a reunião com Putin
Os futuros da KLCI negociados misturados no meio do dia	KL ações mixadas no meio do dia
suspeito dos EUA Drone Strike mata 5 no Paquistão	A greve de drones nos EUA mata pelo menos dez no Paquistão
O Tribunal do Egito ordena a libertação de Mubarak	O Tribunal do Egito reclama a solicitação de liberação de Mubarak
Hollande 'ameaça a ação legal' após as alegações de caso	François Hollande ameaça a ação legal sobre as reivindicações de caso
Exiles iranianos relatam mortes no campo do Iraque	Pelo menos 47 exilados iranianos mortos no Camp Ashraf do Iraque
'Blade Runner' Pistorius para contestar a acusação de assassinato	Pistorius Cop em sete tentativas de assassinato
Bomba de bomba mata 10 no sudoeste do Paquistão	Principais mata 39 no Paquistão
Forças israelenses detêm 2 em Hebron Raid	Credibilidade israelense on -line sobre o desafio nuclear do Irã
Os egípcios votam na Constituição apoiada por islâmica	'Juiz nas pesquisas direciona os eleitores do Egito da Constituição Vote'
David Cameron coloca o Sri Lanka no aviso de alegações de crimes de guerra	Sri Lanka alertou sobre as alegações de crimes de guerra
México jura em presidente em meio a protestos violentos	ex -governo do Novo México. Richardson Pressioning Bail de teste norte -coreano
Os apoiadores de Morsi se chocam com a polícia de Riot no Cairo	Os manifestantes se chocam com a polícia de Riot em Kiev
Quatro mortos, pontuações feridas em confrontos no Egito	Violência do Egito: estudante morto em confrontos na Universidade Islâmica do Cairo
Helicóptero cai perto da estação ferroviária em Londres	Helicopter Frashes em Londres
A capital indonésia ora para o metrô para facilitar o caos do trânsito	Jacarta ora para o metrô para aliviar o caos de trânsito
Aviões japoneses voaram para a nova zona de defesa da China	Japão, os aviões militares coreanos desafiam a nova zona de defesa da China
Os sobreviventes do tufão invadiram lojas filipinas	O tufão Bopha mata 15 em s. Filipinas
Ferras de carro bomba 15 em fortaleza do Hezbollah no Líbano	Stronghold do Hezbollah Rocks de carro no Líbano
RF FM pede oposição síria a ajudar na liberação imediata de todos os estrangeiros capturados na Síria	S Candidato da oposição da Coréia fecha a lacuna de pesquisa
Cinco mortos, 40 desaparecidos no desastre de trem do Canadá	8 mortos, 11 desaparecidos na China SW China deslizando
O Senado dos EUA confirma Janet Yellen como chefe do Federal Reserve dos EUA	O Senado confirma Janet Yellen como o próximo Federal Reserve Presidente
A polícia afegã mata 5 combatentes do Taliban	5 Taliban, 5 policiais afegãos mortos em emboscadas
Khan disse nomeado como novo líder do Taliban paquistanês depois de Hakimullah Mehsud morto em Drone Strike	Hakimullah Mehsud, chefe do Talebano Paquistão, morto em Drone Strike
Pelo menos 66 mortos em explosões de bombas no Iraque	Pelo menos 47 mortos em explosões de Baquba
A Rússia destrói mais de 75 % de seu estoque de armas químicas	A Grã -Bretanha vê evidências que Assad pode usar armas químicas
Irã Terremoto Toll Toll aumenta	Argélia refém da morte aumenta
Suarez definido para retorno da copa	French Set for Mali Ground Combat
Equipe das Maldivas na Índia para observar uma eleição	Testemunho no julgamento do ex -FM Liberman começa
O número de mortos sobe para 6 como Storm Xaver Batters do norte da Europa	O número de mortos por tempestade aumenta como o vento, a chuva apoia para o norte. Europa
O Paquistão lança o prisioneiro do Taliban Afeganistão	Paquistão lança sete combatentes do Taliban Afeganistão
pistoleiros de pistolas sequestram pilotos de companhias aéreas no Líbano	pistoleiros sequestram 2 pilotos da Turkish Airlines no Líbano
reações mistas ao casamento entre pessoas do mesmo sexo da Nova Zelândia	Nova Zelândia legaliza o casamento entre pessoas do mesmo sexo
TV Weatherman Fred Talbot preso por reivindicações sexuais	Weatherman Fred Talbot mantido sobre 'abuso sexual'
nós. Drone Strike mata 5 no Paquistão	O ataque do drone do Paquistão mata até seis
colapsos de construção na Índia; 25 temidos presos	O colapso do edifício da Índia mata 14; Dezenas presas
A China detém os trabalhadores da cidade depois que o vendedor de frutas morre	Napthine toma as rédeas depois que a liderança de Baillieu desmorona
O Shebab da Somália reivindica a responsabilidade pelo ataque de Nairobi Mall	Os rebeldes sírios assumem a responsabilidade por assassinatos no Líbano
Tropas sírias empurram para a cidade estratégica de Rebelheld	Exército sírio empurra agressão à cidade controlada por rebeldes
Israel concorda em liberar prisioneiros palestinos	Israel lança 26 prisioneiros mais palestinos
Dezenas morrem quando confrontos entram em erupção no Morsi Rally no Cairo	Mais de 70 mortos em confrontos em comícios Morsi no Egito
Os manifestantes da oposição tailandesa começam o desligamento de Bangkok	Os manifestantes tailandeses lançam o 'desligamento' de Bangkok
Driver de acidente de trem espanhol para ser interrogado	Motorista de trem espanhol Garzon para ser interrogado pelo juiz
A França é avançada após o acordo dos EUA na Rússia em armas da Síria	A França recebe o acordo EUA-Rússia na Síria
Soldado Isaf morto no 'ataque insider' afegão	Soldado britânico morto a tiros no 'ataque insider' afegão
Cerca de 60 esmagados até a morte em Stampore Coast Stampede	61 mortos na Costa do Marfim de Stampede
Glasgow Helicopter Crash Search termina	Crash de helicóptero de Glasgow: pelo menos seis mortos
Três mortos na bomba da maratona dos EUA	O Taliban nega o envolvimento no bombardeio de maratona de Boston
Colido de gangue turística suíça na Índia	Colido de gangue turística suíça na Índia
Índia aparece para um ciclone maciço	Índia emite alerta vermelho para ciclone phailin
O senador dos EUA McCain conhece líderes da oposição na Ucrânia	SFG Assembléia Revisões Situação no Mali
Disciplina contra o aluno atirador que pensou ter desencadeado tiro ao Colorado	disciplina contra o aluno considerado a chave para o motivo
Muitos mortos no colapso do túnel rodoviário do Japão	Muitos mortos no ataque aéreo sírio
Sem plano para fechar as bombas a gasolina à noite Moily	O governo da Índia rejeita a proposta de fechar as bombas de gasolina à noite
Clinton para testemunhar este mês no ataque de Benghazi	Clinton retorna ao trabalho, planeja testemunhar o ataque de Benghazi
Dezenas de milhares de ucranianos protestam em Kyiv	Dezenas de milhares se alinham para votar no Butão
Karzai para visitar o Paquistão para as negociações de paz do Taliban	Presidente afegão estende a visita ao Paquistão para negociações do Taliban
Ladrões de ladrões Snatch English Channel Swimmer Cadeia de rodas personalizada	Ladrões roubam a cadeira de rodas do nadador do canal
três morrem após um acidente de carro em Tian 'Anmen	Três mortos em Crash na Praça Tiananmen
As ações de Cingapura abrem mais baixo na sexta -feira	As ações de Cingapura abrem mais alto na quinta -feira
Obama promete reacender a economia	Obama para pressionar o Congresso para agir na economia
Rebeldes curdos para se retirar da Turquia em março: Relatório	rebeldes curdos para se retirar da Turquia
Dois terremotos atingiram o noroeste da China, 11 mortos	Quakes gêmeos matam 89 na China
Bulger 'Whitey', com dois termos de vida consecutivos	Whitey Bulger ganha vida por extorsão, assassinatos
As forças quenianas causaram colapso do shopping	Oficial diz que as forças quenianas causaram colapso do shopping
Japão revisa o crescimento do PIB para 1,1 PCT anual no terceiro trimestre	O crescimento do PIB do Japão rebaixou para 1,1 % anual
Missões Pak nos Emirados Árabes Unidos para as eleições	Partes islâmicas no Egito se unem para as eleições
Bangladesh Building Desastre O número de mortos passa 500	Bangladesh Building Collapse: Death Toll sobe para 580
A crise de reféns da Argélia termina; Toll de morte incerta	A Crise de Refém da Argélia termina em banho de sangue
O Ministério do Egito novamente pede protestos no final dos protestos pró-Morsi	Egito: Criança morta em confrontos do Cairo após protesto pró-Morsi
Mandela da África do Sul levada ao hospital	África do Sul: Mandela permanece no hospital
China Yuan se fortalece para 6.2689 contra USD	China Yuan se fortalece para o novo alto contra o USD
Polícia Questiona Man em Deadly La Boardwalk Crash	Polícia de prisão suspeita de ataque mortal de Los Angeles