um gato em pé nos galhos de árvores.	Um gato preto e branco está no topo dos galhos de árvores.
Dois trens verdes e brancos sentados nos trilhos.	Dois trens verdes e brancos nos trilhos.
Um pequeno gato branco com olhos brilhantes em pé embaixo de uma cadeira.	Um gato branco fica no chão.
Um barco grande na água na marina.	um barco grande no mar.
um ônibus dirigindo em uma rua.	Ônibus de duplo decker vermelho dirigindo pela rua.
O cordeiro está olhando para a câmera.	Um pequeno pássaro em pé em um tronco na borda das águas.
um trem de passageiros esperando em uma estação.	Um trem de passageiros fica na estação.
Uma mulher em uma mesa de jantar escrevendo em seu caderno.	Mulher à mesa ocupada com alguma coisa.
um computador de maçã sentado no chão.	Um computador Macintosh sentado no chão.
Um close da cabeça de um cavalo marrom.	Uma vista lateral da cabeça de um cavalo.
Um grupo de pessoas come em uma mesa lá fora.	Grupo de idosos sentados em torno de uma mesa.
Os meninos curiosos olham no galpão.	Dois meninos pequenos em uma área lenhosa olhando para um galpão.
um jóquei montando um cavalo.	Um jóquei andando de cavalo em uma caneta.
um touro em pé no campo.	Um cavalo marrom fica em um campo verde exuberante.
O homem está montando uma motocicleta na estrada.	Um homem está montando uma motocicleta vermelha na estrada.
Uma mulher montando um cavalo marrom.	Uma jovem garota montando um cavalo marrom.
As vacas preto e branco param em frente ao portão.	Uma vaca preta e uma vaca marrom fica em uma planície em frente a uma árvore arrancada.
Uma criança pulando uma borda com uma bicicleta.	Um gato preto e branco brincando com um cobertor.
um ciclomotor na frente dos degraus das ruínas.	um ciclomotor na frente de ruínas.
Um homem dorme com um bebê no colo.	Um homem dormindo em uma cadeira segurando um bebê.
Um grupo de quatro pessoas em um jantar tendo bolo.	Quatro pessoas comendo sobremesa em torno de uma mesa.
Um cachorro preto em pé em frente a flores amarelas.	um cachorro preto em pé em um campo.
Fechar de uma garrafa de água.	Uma visão de perto de uma garrafa de água.
Um close -up de um gato marrom.	Um close -up de um rosto de avestruz.
ovelhas em pé em campo.	uma ovelha pastando em um campo.
Um grupo de pessoas come em uma mesa lá fora.	Um grupo de idosos posam em torno de uma mesa de jantar.
Um gato de cabelos ansiosos com os olhos de seus olhos fechados.	Um gato de perto com os olhos fechados.
Uma mulher de camisa cinza sorri para a câmera enquanto a mulher atrás dela faz um rosto.	Uma mulher com um olhar surpreso em seu rosto está segurando uma mulher sorridente por trás.
Um trem da Amtrak prateado e azul nos trilhos perto de uma pequena estação de trem.	Um pequeno carro branco estacionado no posto de gasolina.
Uma pessoa de camisa azul reclina perto de uma mesa de café e televisão.	Uma pessoa fica no assento da motocicleta e coloca um rodas.
Dois gatos estão olhando para uma janela.	Um gato branco olhando para fora de uma janela.
Uma foto em preto e branco de uma mulher mostrando um cavalo.	Uma foto em preto e branco de vacas em suas barracas.
Um cavalo marrom escuro em pé em um campo.	Um cavalo marrom fica em um campo verde exuberante.
Uma barraca inclinada com um cavalo ao fundo.	Um cordeiro preto e branco com outros cordeiros ao fundo.
Homem mais velho usando boina com montanhas em segundo plano.	Uma ovelha na névoa da manhã com árvores ao fundo.
As vacas se alimentam na calha.	As vacas marrons e brancas estão comendo na calha.
Um pequeno pássaro vermelho e cinza empoleirado entre os galhos nus de uma árvore.	Um pássaro vermelho e marrom está empoleirado em galhos.
Uma pessoa vestindo um capacete anda de bicicleta perto de uma estrutura branca.	Uma garota usando shorts pretos e botas fica ao lado de uma motocicleta azul.
Um grupo de pessoas sentadas em torno de uma mesa com comida nela.	Um grupo de pessoas sentou -se ao redor de uma mesa com comida e cerveja.
Uma sala de jantar preta e de cor madeira em um pequeno apartamento.	Mesa preta e marrom no ambiente da sala de estar.
Um cavalo marrom fica em um campo verde exuberante.	um cavalo marrom em um campo verde.
uma vaca em preto e branco no feno.	Uma vaca em preto e branco em uma caneta com feno.
Uma mulher idosa fica em uma cozinha com dois gatos aos seus pés.	A velha senhora está de pé na cozinha com dois gatos aos seus pés.
Um ônibus escolar está subindo em uma estrada rural.	Um cuidado de corrida dirigindo ao longo de uma estrada de terra.
Um saco de algodão na frente de um sofá.	O gato de chita sentado sentado no passo em frente a uma porta.
Avião de camuflagem sentado no campo gramado.	Um avião camuflado sentado na grama verde.
Três jovens em uma sala juntos.	Duas mulheres indianas com duas meninas indianas perto da água.
Ônibus vermelho de dois andares dirigindo pelas ruas.	Ônibus de passageiros de dois andares dirigindo com tráfego.
Uma ovelha branca em uma encosta olhando para a câmera.	As vacas magras estão de pé na grama.
um grupo de ovelhas em um campo.	um grupo de cavalos pastando em um campo.
Uma foto de close-up e distorcida de uma garrafa de coca de vidro vazia.	Uma foto em close de uma mesa com um computador e papéis.
Mesa de escritório muito lotada com monitor de computador.	Mesa de computador bagunçada com dois monitores.
Um homem sentado em uma sala desordenada.	Um homem deita em uma cama em um quarto desordenado.
duas vacas brancas em um pasto verde.	O cavalo bronzeado está no pasto.
Um homem com uma bicicleta em uma cafeteria.	Homem andando de bicicleta até o pátio de uma cafeteria.
vaca preta andando sob árvores em pasto.	vaca andando debaixo da árvore em um pasto.
Dois cavalos em pé em um campo com árvores ao fundo.	Um pássaro preto e branco em um corpo de água com grama ao fundo.
Duas pessoas sentadas à mesa em um restaurante.	quatro pessoas sentadas à mesa.
Ônibus vermelho de duplo decker dirigindo por uma rua.	Um ônibus vermelho de dois andares dirigindo pela rua.
Uma mulher sorridente com uma cerveja sentada do lado de fora com outra mulher sorridente.	Duas mulheres sentadas do lado de fora rindo.
Um pássaro segurando um portão de metal.	Um pássaro multicolorido se agarra a uma cerca de arame.
As vacas magras estão de pé na grama.	Os patos brancos estão de pé no chão.
Uma mulher deitada em dois homens sentados em um sofá.	Um homem e duas mulheres sorrindo para a câmera enquanto estavam sentadas em um sofá azul.
Uma mulher com um grande colar.	Uma jovem com uma blusa preta e um colar.
Vaca marrom com chifres em pé em um campo.	Cavalo marrom em pé no meio do campo gramado.
Um revestimento de cruzeiro atracou na costa.	Um navio de cruzeiro atracou na costa.
Gato preto e branco deitado embaixo do arbusto.	O gato preto e branco com olhos amarelos na terra.
Vaca marrom e branca em pé na grama ao lado da estrada.	Uma vaca marrom e branca em pé em uma área gramada com árvores atrás.
Um cachorro pequeno olhando para a câmera enquanto estava na grama.	Um homem e mulheres sorrindo para a câmera enquanto estão em uma cozinha.
Um bezerro bronzeado com uma etiqueta amarela na orelha esquerda olhando para a câmera.	Um homem com óculos e duas garrafas de plástico em primeiro plano.
Foto em preto e branco do sofá com bolsa em uma extremidade.	uma foto em preto e branco de uma vaca debaixo de uma árvore.
O cordeiro está olhando para a câmera.	Um gato olhando para a câmera.
Um ônibus vermelho de duplo perna em uma rua lotada.	Um ônibus de dois andares em uma rua da cidade.
Um jóquei andando de cavalo em uma caneta.	Um jóquei monta um cavalo em um galope.
Dois homens no barco flutuando na água.	Grande barco verde flutuando na água.
Esta é uma vista traseira de um carro esportivo Chevrolet.	A vista traseira de um carro conceito vermelho Chevrolet.
Uma pessoa vestindo um capacete anda de bicicleta perto de uma estrutura branca.	Uma pessoa vestindo um capacete de bicicleta anda de bicicleta em um caminho através das árvores.
Uma foto em preto e branco de uma antiga estação de trem.	Uma foto em preto e branco de uma motocicleta deitada no chão.
Um gato de gato cinza e branco está dormindo em tecido roxo.	Gato preto e branco dormindo em uma lona marrom.
Um gato preto e branco está no topo dos galhos de árvores.	Cordeiro preto e branco com etiqueta na orelha direita.
uma mulher segurando um bebê pequeno.	Uma mulher sorridente segurando um pequeno bebê.
Grupo de cavalos pastando em campo gramado.	um grupo de cavalos pastando em um campo.
Três homens estão sentados em uma mesa que bebe.	Três homens sentados à mesa com cerveja e comida.
Duas pessoas vestidas de branco em pé em um campo de grama.	Uma pessoa está de pé sob um viaduto perto de uma rodovia.
Uma jovem loira vestindo um capacete fica com uma bicicleta vermelha atrás dela.	Uma jovem menina usando um capacete de bicicleta com uma bicicleta ao fundo.
Um gato de gato laranja dormindo no sofá.	Um homem está assistindo TV no pé da cama.
Dois águias empoleiraram -se em um ramo.	Duas águias empoleiradas em um galho.
Um gato listrado deitado em um saco de lixo de gato.	Gato doméstico deitando nas costas da ninhada de gatos.
Couch azul e cama dupla em uma sala de estar.	Couch azul no quarto com sol brilhando.
Um homem e uma criança pequena em uma sala de estar posando para a câmera.	Um homem e uma mulher estão posando para a câmera.
Um escritório em casa com três monitores de computador e outros equipamentos em uma mesa.	quarto com vários monitores de computador.
Cinco pássaros estão na neve.	Vários cardeais estão na neve.
Os úberes de uma vaca leiteira que está de pé em um pasto perto de um grande prédio.	A vaca preta e marrom está de pé na grama verde.
Um veículo preto estacionado com um VIE de montanhas baixas.	Um carro preto estacionado na sujeira no país.
um trem de passageiros na neve.	um trem de passageiros esperando em uma estação.
O pássaro preto está sentado no chão.	um melro sentado no chão.
O touro preto e branco está olhando para a câmera.	Um cachorro preto e branco olhando para a câmera.
Uma mulher posando por um pilar com um sinal de U2.	Uma mulher está de pé por um pilar onde "U2" está escrito.
uma jovem montando um cavalo branco e cinza.	Uma jovem loira em equipamento de pilotagem fica em cima de um cavalo cinza e branco.
Uma ovelha preta e branca está andando ao lado de uma ovelha branca.	Pequena panturrilha em preto e branco com uma etiqueta na orelha.
Uma sala de estar com uma mesa de jantar ao fundo.	Um garoto fazendo um rodas em uma prancha com a praia ao fundo.
A mesa da sala de jantar recebe um sol da tarde.	Sala de jantar com mesa de jantar de madeira com companheiros de brincadeira.
Um ciclomotor vermelho estacionou em uma calçada em frente ao grafite.	A scooter vermelha está sentada na rua em frente ao prédio.
A gaivota está flutuando na água.	Um passarinho flutuando na água.
O rebanho de ovelhas está espalhado no campo.	Um gato branco fica no chão.
Dois cães e um gato sentados no sofá.	Dois cães e um gato descansando em um sofá.
Um cachorro preto fica ao lado de materiais em um canteiro de obras.	Uma garota asiática de criança senta -se ao lado de um pote de flores em um poste de mármore.
Uma mulher posando em frente a um prédio de apartamentos na neve.	Uma mulher fica em frente a um prédio na neve.
Uma mulher asiática e uma ocasião em óculos sorrindo com os polegares para cima.	Duas mulheres estão posando para a câmera e dando os polegares para cima.
Um trem preto desce os trilhos.	um trem principalmente preto em uma pista.
Cinco vacas estão pastando ao lado da estrada.	Várias ovelhas pastando no campo.
Duas cabras da montanha pastando em frente a um lago alpino.	Dois animais pastando ao lado de uma montanha e um corpo de água.
Vacas pretas e brancas atrás de uma cerca.	Duas vacas em preto e branco atrás de um portão de metal contra um céu azul parcialmente nublado.
um trem de passageiros esperando em uma estação.	Um trem de passageiros esperando na estação de trem da cidade.
Um animal branco que atravessa madeiras cobertas de neve.	Um cachorro branco passa por uma madeira coberta de neve.
Uma bicicleta está estacionada por uma loja.	Uma bicicleta está estacionada do lado de fora de uma livraria.
Um homem sentado na grama olhando para o céu.	O trem está andando nos trilhos da neve.
Uma televisão preta de tela plana colocada no chão.	Uma TV de tela plana no chão.
Uma bicicleta prateada está estacionada em uma sala de estar.	Uma bicicleta em uma sala de jantar.
Um gato laranja e branco deitado em um cobertor em uma cadeira de couro preto.	Um gengibre e um gato branco enrolados e dormindo em uma cadeira de couro.
O cachorro marrom está descansando a cabeça em um travesseiro branco.	Um cachorro bronzeado está deitado em um sofá e tem a cabeça em um travesseiro branco.
Trem preto em trilhos de trem.	Um trem nos trilhos do trem.
Trem preto em trilhos de trem.	Um trem nos trilhos do trem.
Jovem casal sentado em um sofá preto.	Jovem casal sentado no sofá.
Um grupo de negros em frente a um prédio com um ciclomotor.	Um grupo de pessoas está fora de um prédio decrépito.
Um gato de gato laranja dormindo no sofá.	Homem vestindo um babador sentado em um sofá verde.
Mulher idosa sentada no sofá estampado vermelho com o braço em torno da mulher mais nova.	Duas mulheres sentadas no sofá posando para a câmera.
A águia careca está empoleirada em uma corda.	Duas águias empoleiradas em um galho.
Um casal posando para uma foto em um sofá.	Jovem casal sentado no sofá.
Os homens estão tocando um violão e tomando uma bebida.	Há um garoto com uma jaqueta vermelha e azul na alimentação de uma ovelha.
Dois gatos sentados juntos no sofá, olhando pela janela.	Dois gatos estão olhando para uma janela.
Ônibus vermelho de duplo deck.	Ônibus vermelho de dois andares com capuz para cima.
Um close de um animal com um rosto comprido em pé na grama perto de uma árvore.	Um close de uma mulher com botas pretas ao lado de uma motocicleta azul.
Um cachorro marrom e branco senta-se em uma cadeira com padrão floral.	Um pequeno cachorro laranja e branco com uma gola e um sino relaxa em um travesseiro de estampa de flor.
A vaca preta e marrom está olhando para a câmera.	O touro preto e branco está olhando para a câmera.
Um homem andando nas costas de um SUV laranja.	Um homem africano pendurado nas costas de uma van amarela muito cheia.
Um grupo de pessoas sentadas em uma mesa de restaurante.	Um grupo de pessoas sentadas em torno de uma mesa com comida nela.
Duas ovelhas de um penhasco olhando para a câmera.	Duas ovelhas estão de pé, olhando para a câmera, rosto oposto.
Uma foto em preto e branco de uma estação de trem vazia.	Uma foto em preto e branco de um gato deitado.
Uma fileira de locomotivas de um lado em um campo.	Um cavalo marrom escuro em pé em um campo.
Um computador de maçã branco fica no carpete bege de um quarto.	um computador de maçã sentado no chão.
Um cachorro cochilando sob uma pequena mesa.	um cachorro dormindo debaixo de uma mesa.
ônibus vermelho e branco dirigindo pela estrada.	Um ônibus atravessa uma estrada movimentada.
Um barco com quatro velas está navegando na água.	Sail Boat navegando na água.
Red Sports Car Racing Down Track.	Um carro esportivo vermelho dirigindo rapidamente em uma pista.
Uma mulher sorridente segurando um pequeno bebê.	Duas mulheres sorridentes segurando um bebê.
Pássaro preto sentado em uma laje de concreto.	cachorro pequeno sentado ao lado da parede branca.
Um ônibus de revestimento de vitória é branco com listras vermelhas e douradas.	Um ônibus de turismo branco com listras vermelhas, laranja e amarelas.
Ônibus vermelho de duplo decker no lado da rua.	Um ônibus vermelho de duplo perna em uma rua da cidade.
Um grupo de barcaças do rio com árvores ao fundo.	Uma jovem menina usando um capacete de bicicleta com uma bicicleta ao fundo.
A gaivota está flutuando na água.	Grande navio de cruzeiro flutuando na água.
Uma motocicleta estacionou ao lado de um carro.	Uma motocicleta BMW estacionou entre dois carros.
Um gato deitado em uma almofada vermelha olhando para a câmera.	Um cachorro bronzeado deitado em uma cama de Moggie olhando para a câmera.
Gato cinza olhando pela janela.	um gato olhando para fora de uma janela.
uma foto em preto e branco de uma vaca debaixo de uma árvore.	Uma foto em preto e branco de uma vaca andando debaixo de uma árvore em um campo.
uma planta em vasos sob a luz do sol de uma janela.	uma planta em vasos com apenas alguns brotos.
Dois trens verdes e brancos sentados nos trilhos.	Dois trens verdes e brancos estão sentados na pista de trem.
Quatro pessoas estão remar um barco perto da costa.	Quatro pessoas estão em um barco em água verde.
Uma garota de camisa vermelha está montando um cavalo marrom.	Um cachorro bronzeado e branco deitado na cama com uma tampa amarela.
Dois aviões no céu.	um avião no céu.
Um trem de carvão viajando pelos trilhos.	Um trem antigo fica ocioso nos trilhos.
Há uma pequena mesa e cadeira em frente à lavanderia.	Uma sala com paredes marrom e uma lavadora e secadora.
um trem de passageiros da Amtrak esperando em uma estação.	um trem de passageiros esperando em uma estação.
Um grande jato no chão no aeroporto.	Um jato de passageiro voa pelo ar.
Um gato olhando para a câmera.	Um gato cinza, preto e branco olhando para a câmera.
As manchetes do World News exibidas em uma tela grande.	Um homem vestido para uma raça relaxa.
duas mulheres posando com um bebê.	Duas mulheres sorridentes segurando um bebê.
Uma jovem menina vestindo um capacete andando de pônei.	Uma garota vestindo uma blusa vermelha andando de cavalo marrom.
Um gato cinza deitado em uma mesa de madeira.	Um gato cinza deitado em uma mesa de jantar.
pessoas sentadas na varanda.	pessoas sentadas em Acouch.
Dois cavalos em pé em uma caneta.	um grupo de cavalos pastando em um campo.
Um homem sentado em um quintal tocando violão.	Um homem andando nas costas de um SUV laranja.
O trem vermelho e o trem amarelo nos trilhos.	Dois trens estão viajando na pista.
Duas pessoas sentadas à mesa em um restaurante.	Um grupo de pessoas sentadas ao redor de uma mesa em uma varanda.
Um cordeiro fica perto de dois pequenos animais.	uma ovelha em pé perto de seus filhos.
Um pai cochilando em uma cadeira com um bebê no colo.	Homem com camisa rosa dormindo na cadeira com bebê.
Uma cabeça de perto de um avestruz.	Um close -up de um rosto de avestruz.
uma pessoa andando de bicicleta de terra ao ar livre.	uma pessoa pulando uma moto no ar.
Vaca marrom com etiquetas de ouvido em um campo gramado.	Muitas ovelhas em uma colina verde.
Pássaro verde e branco empoleirado no galho de árvore.	Pássaro com uma cabeça verde e peito branco empoleirado em um galho de árvore.
Sail Boat navegando na água.	Barco de vela flutuando na água azul.
Um avião vermelho e branco voando em um dia ensolarado.	Plano vermelho e branco voando pelo ar.
Um homem em uma cartola monta um cavalo branco.	Um homem com uma cartola andando de cavalo branco.
Uma foto em preto e branco de uma antiga estação de trem.	Uma foto em preto e branco de um gato sentado em um sofá.
Uma bicicleta na frente de algumas ruínas.	Uma bicicleta rosa está em frente a um edifício.
Uma mulher com um chapéu viking.	Mulher sorridente sentada usando um chapéu viking.
Ônibus de duplo perno estacionado.	Um ônibus vermelho e branco de dois andares está estacionado.
Ônibus vermelho de duplo decker no lado da rua.	Um ônibus vermelho de duplo perna em uma rua lotada.
Uma mulher montando um cavalo marrom.	Uma mulher tirando sua própria foto de cima.
Um campo de ovelhas de rosto preto.	uma ovelha negra.
Dois pássaros estão empoleirados em uma faixa de metal.	Dois pequenos pássaros empoleirados em uma barra de metal.
Um ônibus atravessa uma estrada movimentada.	Um ônibus verde atravessa uma estrada.
Mesa com toalha de mesa azul na cozinha.	armários de madeira na cozinha.
Um casal asiático idoso posa com um bebê bocejando em uma mesa de jantar.	Um casal asiático mais velho posa com um bebê recém -nascido na mesa de jantar.
Patos marrons e brancos andando na grama verde.	Um avião vermelho e branco voando em um dia ensolarado.
Uma jovem com uma pulseira está usando uma blusa de biquíni e jeans.	Uma mulher vestindo um top de biquíni e jeans.
Um cavalo marrom pastando em um campo de grama verde.	Cavalo marrom em pé no meio do campo gramado.
Uma panela de líquido está no centro de uma placa coberta de papel alumínio.	Um pote de comida é colocado no centro de uma toalha de mesa vermelha.
Uma vaca em preto e branco em pé em um campo gramado.	Um Jay Blue em pé em um campo gramado.
Um avião amarelo e azul está voando no céu.	O avião branco está voando no céu azul.
Dois homens em pé de grama olhando para um carro.	Uma mulher em um top rosa posando com cerveja.
Uma mulher sentada em uma cadeira no Natal segurando a maquiagem.	Um trem sentado nos trilhos em um pátio de trem.
Quatro jovens asiáticos sentados em uma sala ou sala de estar.	uma garota sentada em uma cadeira viva.
Trem descendo os trilhos.	treinar deslizando em trilhos.
Uma jovem mulher vestida de preto.	Duas crianças pequenas vestidas sentadas em cadeiras.
Duas mulheres indianas com duas meninas indianas perto da água.	Duas mulheres indianas ficam com duas meninas indianas em uma praia.
Grupo de pessoas sentadas à mesa com bebidas.	quatro pessoas sentadas à mesa.
Uma mesa é ajustada com vinho e pratos para duas pessoas.	Uma mesa de madeira é ajustada com velas, vinho e uma tigela de plástico roxa.
um avião voando à distância.	uma mulher com um cavalo branco.
Um grupo de barcaças do rio com árvores ao fundo.	Um grupo de vacas em um campo com etiquetas amarelas nos ouvidos.
Uma sala de estar com uma mesa de jantar ao fundo.	Uma sala de estar com sofás grandes e uma mesa de jantar ao fundo.
Gato listrado amarelo descansando no sofá azul.	Um gato de gato laranja dormindo no sofá.
um trem de passageiros entrando em uma estação.	Um pássaro grande está voando pelo ar.
Duas pessoas remando em uma canoa vermelha com árvores ao fundo.	Duas pessoas estalando em uma canoa amarela por um rio com árvores ao fundo.
um ciclomotor na frente de ruínas.	ônibus branco estacionado em grama em frente ao prédio.
As pessoas montam ciclomotores em um ambiente urbano.	Pessoas montando cavalos em uma área cercada.
Um trem preto desce os trilhos.	Trem preto ocioso nos trilhos.
Um jipe ​​branco estacionado em frente a uma loja.	Um jipe ​​branco estacionado em uma rua.
Duas mulheres em pé em frente ao ônibus de turismo.	Dois homens conversando na frente de um avião.
uma pessoa dirigindo um carrinho puxado por uma bicicleta.	Um homem vestindo uma máscara de poeira montando uma bicicleta de três rodas.
Motor locomotivo de prata grande em um galpão.	O trem de prata está estacionado em uma estação.
Um homem monta uma grande moto preto.	Uma criança fica sentada em uma grande cadeira de couro preto.
Uma bicicleta está estacionada do lado de fora de uma livraria.	As pessoas estão do lado de fora de uma livraria.
avião em vôo médio ao pôr do sol.	Um avião voando perto do pôr do sol.
Duas pessoas sentadas em uma moto grande.	duas águias sentadas em um longo galho.
Dois ônibus vermelhos estacionados com jardins na frente deles.	Os ônibus vermelhos estão estacionados por um grande edifício branco ao lado de um jardim formal.
Um papagaio amarelo se apega ao lado da gaiola.	Um pássaro amarelo e laranja segura o lado de uma gaiola.
Um cachorro cheirando o fundo de uma porta.	Um cachorro preto e branco cheirando a uma porta fechada.
casal navegando em um pequeno veleiro.	Dois homens navegando em um pequeno veleiro.
Uma motocicleta prateada e azul sentada ao lado de um carro.	Uma motocicleta estacionou ao lado de um carro.
Ônibus vermelho de duplo deck.	um ônibus vermelho de dois andares.
Pés em pé em um lindo dia com um grande prédio em segundo plano.	Dois policiais em pé atrás de uma van com um ônibus ao fundo.
Um pequeno cachorro branco mastiga um galho enquanto deitado em um convés de madeira.	O cachorro branco está deitado no piso de madeira embaixo da mesa.
Homem em pé em frente ao trem de prata.	Homem em pé em frente a um vagão prateado.
Um close de uma ovelha com a língua saindo.	Feche a imagem de uma ovelha com a língua de sua língua pendurada.
Uma vaca com chifres preto e branco em pé em um campo.	uma vaca em preto e branco em pé no campo.
Um pequeno pássaro sentado em um galho no inverno.	Um pequeno pássaro empoleirado em um galho gelado.
Um pássaro amarelo está comendo frutas em uma grade de arame.	Um pássaro amarelo comendo frutas em um alimentador de pássaros.
Um homem montando um cavalo branco em uma arena.	um homem montando um cavalo branco.
Um pato marrom e um pato branco ficam na grama.	Patos marrons e brancos andando na grama verde.
Um gato e um cachorro em preto e branco em um sofá listrado.	Um gato preto e branco em pé na frente de uma janela.
Um trem sentado nos trilhos perto de um campo.	um trem viajando pelos trilhos.
Uma mulher e uma criança pequena sentada em uma mesa de jantar sorrindo para a câmera.	Um pequeno gato deitado em uma viga de madeira olhando para a câmera.
Uma estátua de Buda fica em uma mesa com um corredor de mesa de madeira.	Um pássaro em pé em cima de uma cerca de madeira.
Um homem vestindo roupas formais pretas e uma cartola preta está montando um cavalo branco.	Um homem com uma cartola andando de cavalo branco.
Dois ônibus vermelhos dirigindo em frente a um jardim.	Trem puxando para uma estação.
Vacas pastando em um campo coberto de neve.	Cinco vacas pastando em um campo coberto de neve.
um homem montando um cavalo branco.	Uma mulher montando um cavalo marrom.
Um pequeno pássaro marrom está comendo de um alimentador de pássaros pendurado em uma árvore.	Um pequeno pássaro se encaixa no alimentador de pássaros pendurado na árvore.
Esta é uma foto do campo com uma cidade grande ao fundo.	Há um pouco de gado preto em uma planície gramada com uma grande árvore ao fundo.
Homem com camisa azul em pé em frente a uma fonte.	Um homem de camisa azul e calça bronzeada está em frente a uma estátua de um homem, que fica em uma praça pavimentada de pedras.
Uma garota de equipamento de pilotagem fica no topo de um cavalo marrom.	Uma garota de camisa vermelha está montando um cavalo marrom.
Uma mulher com pouca roupa está parada ao lado de um carro.	Um pássaro amarelo e laranja segura o lado de uma gaiola.
Várias televisões estão no chão e empilhadas umas sobre as outras.	Três televisões, no chão, os outros dois em uma caixa.
As ovelhas estão pastando em um campo gramado perto de uma bancada de árvores.	Ovelhas estão pastando no campo em frente a uma linha de árvores.
Uma cadeira de plástico transparente em frente a uma estante.	Uma cadeira de plástico transparente em frente a prateleiras de livros.
Um cachorro está vestindo uma jaqueta cinza.	Um cachorro deitado em uma jaqueta de estimação.
Uma ovelha fica em uma encosta.	uma grande ovelha em pé em uma colina.
Uma vaca em preto e branco em pé em um campo gramado.	uma vaca em preto e branco em pé no campo.
Plano azul e vermelho no vôo do ar.	um avião azul e vermelho enquanto estava em vôo.
Uma mulher de biquíni preta e jeans.	Uma mulher de chapéu preta está de pé junto ao metrô.
Uma garota montando um cavalo marrom.	O jóquei está usando roxo e montando um cavalo marrom.
Homem em pé em frente ao Corvette amarelo.	Um homem está ao lado de um carro esportivo amarelo.
Três homens posando em uma barraca.	Três homens comendo em uma cozinha.
Um homem sentado na grama olhando para o céu.	O homem está de pé na calçada em frente ao cavalo.
Um homem posa na frente de uma grande fonte com uma estátua no topo.	Homem com camisa azul em pé em frente a uma fonte.
O cão pequeno protege seu dono.	A parte de trás do sinal de parada é adornada com adesivos.
crianças olhando uma ovelha.	crianças ordenhando uma vaca lá fora.
Um gato branco em pé em um tapete.	uma ovelha em uma floresta.
Uma TV de tela plana no chão.	Uma TV de tela plana fica no chão.
Um close de um gato cinza com olhos verdes.	Um close de um gato em um sofá de creme.
Dois cavalos marrons em pé em campo gramado.	Dois homens navegando em um pequeno veleiro.
Duas ovelhas estão em uma porta.	Dois carneiros ficam em chão nevado.
Um trem fica em uma estação de trem.	O trem fica na estação de trem.
quarto com vários monitores de computador.	Uma sala com quatro monitores de computador seguidos.
Uma linha fora de uma livraria em uma rua.	A motocicleta amarela está estacionada na rua.
O trem segue os trilhos e ao longo da cerca.	Um cachorro no chão de um pátio olha para um gato em cima do muro.
Um jato de passageiro está sentado em uma pista.	Um grande jato de passageiro voando perto do chão.
Uma garotinha está rindo da câmera.	Uma vaca branca com orelhas grandes olhando para a câmera.
Velha garrafa verde sentada em uma mesa.	Três homens de terno sentados à mesa.
Três jovens em uma sala juntos.	Três jovens de cabelos escuros em suéteres brancos, vermelhos e pretos.
Uma foto em preto e branco de um sofá.	Uma foto em preto e branco de uma antiga estação de trem.
A parte de trás de um sinal de parada com muitos adesivos nele.	a parte de trás de uma placa com adesivos ligados.
Dois cavalos brancos olhando sobre uma cerca.	Dois cavalos em pé em uma caneta.
sala de estar ou covil com televisão de tela grande.	Sala de estar com móveis bronzeados e televisão de tela plana.
As vacas preto e branco param em frente ao portão.	O avião branco está voando no céu.
Uma vaca em preto e branco em pé em um campo gramado.	Uma vaca com chifres preto e branco em pé em um campo.
Duas mulheres sentadas em cadeiras de gramado.	Duas mulheres estão sentadas em um café.
Um ônibus vermelho duplamente de decker dirigindo pela estrada.	Um ônibus vermelho de duplo decker, dirigindo por uma rua.
Uma foto em preto e branco de um gato deitado.	Uma imagem em preto e branco de um gato deitado em um tapete.
Um homem e uma mulher ficam, sorrindo para a câmera.	Um homem e uma mulher estão posando para a câmera.
Um gato laranja e branco dormindo em uma cadeira de couro.	Um gato de gengibre sentado em uma cadeira de escritório.
Um gato branco em pé em um tapete.	Um gato listrado bem branco com a cabeça pendurada na mesa.
Gatinho doméstico cinza e branco deitado em uma mesa.	Um homem e sua bicicleta deitados na grama verde.
Um pássaro branco com longas pernas laranja em pé ao lado de um lago.	Pássaro branco grande com bico laranja longo em pé na costa.
Uma mulher posando em frente a um prédio de apartamentos na neve.	ônibus branco estacionado em grama em frente ao prédio.
Uma jovem com uma pulseira está usando uma blusa de biquíni e jeans.	Uma mulher vestindo jeans, um top de biquíni escuro e uma pulseira.
Um trem vermelho dirigindo por uma cidade coberta de neve.	O trem está andando nos trilhos da neve.
Uma mesa e cadeiras estão em uma sala com uma foto na parede e um ventilador de teto.	Um ônibus escolar dirigindo por uma estrada com árvores verdes e grama ao fundo.
O pássaro preto está sentado no chão.	a parte de trás de um porco debaixo de uma árvore com uma vaca ao fundo.
Um homem senta -se com pernas cruzadas em uma cama assistindo a uma pequena TV.	Um homem fica sentado em uma cama muito perto de uma pequena televisão.
Um avião de carga de ar do DAS fica na pista.	Um avião de passageiros estacionou em uma pista.
Os faróis em um carro azul.	Feche os faróis em um carro azul.
Um gato dorme em lençol roxo.	Um gato preto e branco dorme em um cobertor roxo.
um trem de passageiros entrando em uma estação.	Um trem de passageiros fica na estação.
Um close de um gato em um sofá de creme.	um close de um cavalo.
Três ciclistas atravessando uma ponte em uma cidade.	Os ciclistas estão atravessando uma ponte na chuva.
Um ônibus vermelho e branco atravessa uma rua da Inglaterra.	Um ônibus vermelho e branco da Inglaterra dirige pela rua.
Um avião voltado para a câmera.	Uma vaca solitária fica no frio do quintal.
Uma mulher montando um cavalo marrom.	uma pessoa vestida de branco em um cavalo marrom.
um jóquei montando um cavalo.	Um jóquei andando de cavalo em uma caneta.
Os dois cães se misturam com os animais.	Dois cães sentam -se em um sofá com muitos bichos de pelúcia.
Uma cozinha com armários de madeira e mesa de jantar.	uma cozinha com armários de madeira e móveis.
Um trem está correndo nos trilhos.	Um trem está correndo pela pista em uma área rural.
A Motorcycles está estacionada perto de uma parede coberta com uma cena de graffiti de uma paisagem urbana.	Uma motocicleta está estacionada por um mural de uma cidade à noite.
Alguém de pé em uma montanha de neve, assistindo a um avião.	Um homem fica em uma montanha, assistindo a um avião.
Os pássaros estão nadando na água.	Os pássaros voam baixa sobre a água.
Um pássaro está batendo suas asas na água.	Um grande pássaro preto está sentado na água.
Um cachorro preto olhando para a câmera.	O touro preto e branco está olhando para a câmera.
Um revestimento de cruzeiro ancorado em um porto.	Um navio de cruzeiro atracou em uma costa.
Um ônibus vermelho de duplo perna em uma rua lotada.	Um ônibus branco parcialmente na neve em uma rua pública.
Uma mulher anima um cachorro em uma área cercada.	Uma mulher anima um cachorro em um quintal fechado.
Um gato preto e branco brincando com um cobertor.	Um gato preto e branco entra em uma cesta de fios.
Um homem em uma bicicleta de montanha descendo uma inclinação.	Este é um homem andando de bicicleta de montanha sobre pedras em um dia claro.
Um gato reclina em uma cadeira de escritório.	Um gato de gengibre sentado em uma cadeira de escritório.
um grupo de cavalos pastando em um campo.	Um cavalo marrom pastando em um campo de grama verde.
um grupo de pessoas tomando uma bebida.	Uma fileira de locomotivas de um lado em um campo.
Dois cães em um canil cercado olham para a frente.	Duas mulheres posam em uma sala de jantar com um bebê.
Três ovelhas em uma estrada de terra vista de um veículo de passageiros.	Três ovelhas no meio da estrada de cascalho.
Um avião amarelo e azul está voando no céu.	Nove aeronaves vermelhas e brancas que voam em formação, atrás da fumaça.
O trem fica na estação de trem.	O trem azul está na estação.
Um trem sentado nos trilhos perto de um campo.	Um bebê está sentado na grama.
Red Bus Double Decker que assumiu passageiros.	Um ônibus vermelho de duplo perno está pegando mais passageiros em uma cidade.
Dois caras se sentam em um sofá segurando cervejas com uma garota deitada deitada.	Duas mulheres assistindo a rua com suas bicicletas para ver quando podem atravessar.
Duas mulheres na cozinha olhando para um objeto.	Duas mulheres na cozinha com uma tirando uma foto.
Um cavalo de corrida galopando sem um piloto.	Um cavalo galopando enquanto usava o número 4.
Um motor a vapor e trem movendo -se em direção à câmera.	Um grande pássaro de presa voando em direção à câmera.
um grupo de cavalos pastando em um campo.	Grupo de cavalos pastando em campo gramado.
Uma foto em preto e branco de uma garrafa de vidro de Coca Cola.	Esta é uma imagem em preto e branco de uma garrafa curta da Coca-Cola.
Um pequeno pássaro empoleirado em um galho gelado.	Um pássaro amarelo empoleirado em um galho.
Várias pessoas em motocicletas em uma praça de mercado.	Pessoas em motos em uma rua da cidade.
Três ovelhas em uma estrada de terra vista de um veículo de passageiros.	Três ovelhas em uma estrada de terra disparada de um carro.
Menino com óculos digitando em um computador.	um garoto olhando para uma tela de computador.
Grupo de pessoas posando com dois homens vestidos como Elvis.	Um grupo de pessoas em pé com duas outras pessoas vestidas como Elvis.
Um caminhão vermelho gira os pneus enquanto um preto sai da moldura.	Caminhão vermelho girando pneus e emitindo fumaça por trás.
Uma sala de estar com mesa, cadeira e sofá ao lado de uma palma grande.	Uma sala de estar com sofá azul, cama de acampamento, banco de madeira e cômoda.
Uma mulher sorridente segurando um pequeno bebê.	Uma mulher sentada em um sofá segurando um bebê.
Um posto de gasolina Eso com árvores ao fundo.	Dois policiais em pé atrás de uma van com um ônibus ao fundo.
Quatro aviões azuis e amarelos voando sobre quatro barcos.	Quatro aviões azuis e amarelos em vôo.
Um cavalo parado perto de um portão com outro cavalo ao fundo.	Um grupo de barcaças do rio com árvores ao fundo.
Três garrafas estão em uma mesa.	Velha garrafa verde sentada em uma mesa.
Dois meninos se sentam de frente para o outro em uma mesa e um aponta para o outro.	Duas pessoas se sentam de frente para a outra em uma mesa como um aponta para o outro.
Um motor a vapor desce um trem perto de árvores.	Um trem fica em uma estação de trem.
Um trem fica em uma estação de trem.	Um trem estacionado em uma estação de trem.
Dois cães brancos estão nadando na água.	Os pássaros estão nadando na água.
Parrot empurrando um pequeno carrinho de compras.	Um pássaro branco está dirigindo um carrinho de compras.
Uma mulher sentada em um sofá segurando um bebê.	pássaro sentado em um tronco em um lago.
Homem em canoa amarela remando através da água.	Homem remando uma canoa amarela em direção à costa.
Dois pássaros voando em direção ao alimentador de água.	Dois pássaros voando perto de alimentadores de pássaros.
duas vacas em pé em um grande campo.	cavalo em pé em um campo.
Garrafas de cerveja (-lrb- harp lager) -rrb- alinhadas no chão.	Uma fileira de garrafas de cerveja no chão.
Duas mulheres sentadas do lado de fora rindo.	duas mulheres do lado de fora de um ônibus.
um grupo de ovelhas pastando em uma colina.	Um grupo de ovelhas está em uma colina.
Um homem fica na frente de um trem.	Um homem está em pé na frente de uma estátua elevada ,.
Um motor a vapor e trem movendo -se em direção à câmera.	Uma ovelha branca em uma encosta olhando para a câmera.
Duas mulheres estão posando para a câmera e dando os polegares para cima.	Duas jovens sorridentes dando os polegares para cima.
Uma mulher segura um bebê pequeno enquanto está sentado em um sofá.	Uma mulher sentada em um sofá segurando um bebê.
Um ônibus United Red Double Decker em uma rua da cidade.	Um ônibus vermelho duplamente de decker dirigindo pela estrada.
Duas mulheres sentadas no sofá marrom.	duas mulheres do lado de fora de um ônibus.
Um gato cinza com olhos verdes olhando para a câmera.	Um gato cinza, preto e branco olhando para a câmera.
O pássaro está sentado no galho.	A ovelha está de pé sob as árvores.
Grupo de pessoas sentadas à mesa do restaurante.	Duas pessoas sentadas à mesa em um restaurante.
Uma vaca em preto e branco fica na grama contra um céu azul parcialmente nublado.	Duas vacas em preto e branco atrás de um portão de metal contra um céu azul parcialmente nublado.
uma vaca marrom e branca em um campo olhando para a câmera.	O gato preto e branco está olhando para a câmera.
Um cara em um cavalo branco.	Um homem montando um cavalo branco em uma arena.
Duas vacas leiteiras bebendo de uma lagoa.	Duas vacas estão bebendo de um lago.
Existem várias ovelhas cortadas em uma caneta.	Três ovelhas brancas em um recinto.
vaca preta e branca em pé perto da pilha de neve.	uma vaca em preto e branco em pé no campo.
O cachorro preto está deitado na grama.	Um cachorro preto deita na grama.
Home Office Space com paredes verdes brilhantes e obras de arte.	um escritório com várias mesas e paredes verdes.
Grande navio de cruzeiro branco flutuando na água.	Grande navio de cruzeiro flutuando na água.
Dois jovens estão sentados à mesa ao lado de uma porta de vidro deslizante, com uma pessoa apontando para a outra.	Duas pessoas se sentam de frente para a outra em uma mesa como um aponta para o outro.
Uma foto em preto e branco de um homem dirigindo um carro e alguém com uma motocicleta.	Uma foto em preto e branco de um homem em um carro clássico e um homem com uma motocicleta clássica.
Um homem e uma mulher de mãos dadas andando pela praia.	Um homem com barba e uma panela de caveira e um garoto caminha pela costa do oceano.
Dez ovelhas olhando para a câmera.	Um gato nas costas olhando para a câmera.
Um cachorro preto e branco olhando para a câmera.	Uma pequena cabra em preto e branco em uma caneta olhando para a câmera.
Uma mesa preta com cadeira difusa branca.	Uma mulher com seu filho.
Red Bus Double Decker que assumiu passageiros.	Um ônibus vermelho de duplo decker, dirigindo por uma rua.
Sail Boat navegando na água.	Sailboat navegando em um dia nublado.
Um pássaro azul se encaixa na mão enluvada de uma pessoa.	Um pássaro está empoleirado na mão enluvada de uma pessoa.
Três pessoas estão à beira da água com canoas amarelas.	Três pessoas se preparando para a canoa.
Uma garota andando em um cavalo marrom e branco.	Uma garota montando um cavalo marrom.
um trem principalmente preto em uma pista.	Um carro estacionado em frente a trilhos de trem.
Um garoto colorindo com um giz de cera vermelho e azul.	Uma jovem loira em equipamento de pilotagem fica em cima de um cavalo cinza e branco.
Duas águias empoleiradas em um galho.	Duas águias estão empoleiradas em um ramo.
uma mochila parada ao lado de um trem.	Uma reunião social de pessoas em um restaurante.
um grupo de pessoas em uma sala de estar.	Um grupo de quatro pessoas passando por um cogumelo gigante.
um pato e um pato branco manso na grama perto da água.	Uma criança pequena em um vestido rosa fica em uma mesa.
O gato está sentado entre duas bicicletas na frente de uma porta.	do que cavalo em pé em um campo em frente a uma cerca.
Uma garota com uma bolsa vermelha parada na rua.	Um cachorro preto está olhando para uma ovelha.
Uma garota de cavalgada em um cavalo.	Uma garota montando um cavalo bronzeado.
Um cavaleiro está montando um cavalo branco.	uma mulher liderando um cavalo branco.
Um homem vestido com um lenço pálido com um graveto.	Um corredor está descansando na sombra com uma garrafa de refrigerante.
O pássaro está sentado no galho.	Um pássaro vermelho e marrom está empoleirado em galhos.
Um trem longo está em trilhos de trem.	Um trem nos trilhos do trem.
Um cachorro preto e marrom olha para uma ovelha negra.	Um cachorro preto olhando para uma ovelha marrom em uma caneta.
Uma sala com vários computadores e fotos na parede.	Um escritório em casa com três monitores de computador e outros equipamentos em uma mesa.
Uma sala de estar muito retrô com uma televisão.	Um gato cinza deitado em uma mesa de madeira.
Uma foto em preto e branco de uma vaca andando debaixo de uma árvore em um campo.	Um cachorro preto e branco olhando para a câmera.
Um revestimento de jato areomexico de prata sentado no asfalto.	Um avião prateado aeromexico está em uma pista.
Um homem em uma bicicleta suja pulando muito alto.	Um homem em uma moto pulando com o céu atrás dele.
Uma garota de cavalgada em um cavalo.	Uma garota montando um cavalo marrom.
Duas pessoas navegando em um pequeno barco de vela branca.	casal navegando em um pequeno veleiro.
Um avião branco está estacionado no cimento.	Uma motocicleta azul está estacionada na calçada.
um grupo de povos posando em chapéus de pele.	Um grupo de ciclistas em verde e branco com espectadores olhando.
Três vacas pastando em um campo.	Várias ovelhas pastando no campo.
Um carro está saindo do lado da estrada para a rua.	Um carro prateado estacionado na beira da estrada em frente às colinas.
O homem está sentado em uma mesa bagunçada e usando um laptop.	Um homem fica olhando para um laptop em uma mesa bagunçada.
Gato doméstico preto deitado na mesa marrom.	Um gato cinza deitado em uma mesa de jantar.
Uma mesa de jantar com velas, vinho e um bule.	Uma mesa de madeira é ajustada com velas, vinho e uma tigela de plástico roxa.
Quatro crianças olhando para animais de celeiro.	crianças olhando uma ovelha.
Um gato preto e branco brincando com uma cesta de lã.	Um gato preto e branco deitado em um cobertor.
Duas pessoas que remaram uma canoa vermelha são refletidas na água parada.	Duas pessoas em uma canoa vermelha em um lago claro.
Uma mulher com pouca roupa está parada ao lado de um carro.	Uma mulher com pouca roupa parada ao lado de um pequeno veículo vermelho.
Red Bus Double Decker que assumiu passageiros.	Ônibus vermelho de dois andares com capuz para cima.
O homem está sentado com pernas cruzadas usando uma capa e segurando um graveto.	Homem sentado com as pernas cruzadas enquanto usava um pano marrom e segurando um palito de madeira.
Uma estátua de Buda segurando uma vela está sentada em uma mesa.	Um homem pescando em um pequeno barco enquanto estava em um lago.
Dois cães pretos e brancos no fundo da escada.	Um cachorro está deitado no fundo de uma escada ao lado de outro cachorro em pé.
Três pessoas sentadas na mesa de jantar sorrindo na câmera.	Duas mulheres idosas sentam -se em uma mesa de jantar com um homem.
Um trem multicolorido em uma pista.	um trem principalmente preto em uma pista.
um ônibus branco e vermelho viajando na rua.	O ônibus vermelho fica na rua.
Um avião vermelho e azul voando com suas marchas de pouso.	Um avião de combate da Segunda Guerra Mundial com seu trem de pouso abaixo.
Pequeno barco descendo um riacho.	um barco que se move em um rio.
Quatro mulheres e dois homens sentam -se em uma mesa longa em um restaurante.	Um grupo de pessoas sentou -se à mesa em um restaurante italiano.
Um navio de vela de madeira à moda antiga no oceano.	Um navio à vela de madeira antiquado está estacionado no píer.
duas cabras em pé em um campo por uma árvore.	Um barco grande puxando um pequeno barco branco.
Um homem sentado com pernas cruzadas na grama, com uma árvore ao fundo.	Caminhão de oceano perto da costa com casas ao fundo.
Uma foto em preto e branco de uma sala de estar com uma grande janela, sofá e cadeira.	Uma cena em preto e branco de uma sala bem mobiliada, com uma vista superando uma floresta.
Close up de um cavalo marrom com um cabreinho azul.	Um cavalo de perto usando um cabreinho azul.
Um grande pássaro preto está sentado na água.	Os pássaros estão nadando na água.
Um close de um gato em um sofá de creme.	Um gato siamês descansando em um sofá branco.
Uma pessoa está pulando uma bicicleta e realizando um truque.	uma pessoa andando de bicicleta de terra ao ar livre.
Um ônibus escolar amarelo está estacionado em uma área rural.	Um ônibus escolar amarelo estacionado em um campo.
Um cão pug sagaz em uma cadeira amarela ao lado de uma lixeira verde.	Um bulldog sentado em uma cadeira amarela ao lado de um grande receptáculo de resíduos.
A mulher está sentada na motocicleta vermelha.	A ovelha branca está de pé na colina verde.
uma ovelha em pé em uma mesa em leilão.	Ovelhas de lã na casa de leilões.
Um close de um motor de trem preto.	Fechar de uma ovelha branca com a cabeça preta.
Um gato laranja e branco dormindo em uma cadeira de couro.	Um gato laranja e branco deitado em um cobertor em uma cadeira de couro preto.
Um trem cavalga em seus trilhos.	O trem desce a pista, entre duas fileiras de árvores.
Dois homens no barco flutuando na água.	um iate de madeira no oceano.
vaca preta e branca em pé em campo gramado.	Uma vaca com chifres preto e branco em pé em um campo.
Um ônibus United Red Double Decker em uma rua da cidade.	Um ônibus de dois andares dirige em uma rua da cidade.
Dois gatos sentados em um sofá olhando pela janela.	um gato olhando para fora de uma janela.
A televisão e a mesa do quarto de hotel com iluminação de lâmpadas.	Uma televisão e um laptop estão ligados em um quarto de hotel.
um homem andando de uma pequena bicicleta.	Um homem está fazendo um rodas em uma bicicleta.
Três cabras estão sendo arredondadas por um cachorro.	Três cabras são perseguidas por um cachorro.
Uma mulher vestindo um vestido marinho está cortando um bolo em uma mesa branca.	Uma pessoa vestindo um capacete fica em uma bicicleta em um dia ensolarado.
Um homem fazendo um rodas em uma bicicleta de montanha.	Uma mulher posando por um pilar com um sinal de U2.
Um filhote bronzeado em um piso acarpetado.	Filhote de bronzeado deitado sobre carpetes brancos.
Um trem preto desce os trilhos.	um trem viajando pelos trilhos.
Uma imagem em close de uma motocicleta branca e roxa.	Uma foto em close de uma mesa com um computador e papéis.
Uma jovem garota montando um cavalo marrom.	Uma mulher em andar de cavalo marrom.
Um cachorro preto em pé em uma área gramada.	Um cachorro de cabelos compridos fica em uma área arborizada gramada.
Duas mulheres na cozinha olhando para um objeto.	Três homens de terno sentados à mesa.
duas mulheres posando com um bebê.	Uma mulher posa com um bebê.
um grupo de pessoas sentadas em torno de uma mesa contendo comida.	Quatro pessoas estão sentadas em torno de uma sala de estar.
Treine em uma estação.	um trem em uma estação.
Uma motocicleta azul está estacionada na calçada.	Um ciclomotor azul estacionado na calçada.
um pássaro azul em pé em um gramado.	Pássaro azul em pé na grama verde.
Um ônibus vermelho de duplo perna em uma rua da cidade.	Um ônibus vermelho de duplo decker, dirigindo por uma rua.
Dois trens dentro de uma estação de trem.	O trem fica na estação de trem.
Uma mulher equestre montando um cavalo.	A mulher está montando no cavalo marrom.
um cubículo vazio de escritório.	uma cadeira de escritório vazia em um cubículo.
um homem montando um cavalo branco.	uma mulher com um cavalo branco.
Trem descendo os trilhos.	Um trem a vapor preto viajando nos trilhos da ferrovia.
Um homem e duas mulheres sorrindo para a câmera enquanto estavam sentadas em um sofá azul.	Um homem e mulheres sorrindo para a câmera enquanto estão em uma cozinha.
Um homem e uma mulher sentam -se em uma mesa em um restaurante.	Quatro mulheres e dois homens sentam -se em uma mesa longa em um restaurante.
Um jovem vestindo uma camisa listrada está segurando duas bicicletas.	Jovem homem ruivo segurando duas bicicletas perto da praia.
Um grande navio de cruzeiro no porto com árvores para trás.	Um navio de cruzeiro atracou em uma costa.
um avião branco na pista.	Um avião suíço branco se aproxima da pista.
Duas vacas atravessam um cruzamento da estrada.	Duas vacas atravessam uma rua pavimentada.
Várias vacas pastando na mediana pela estrada.	Cinco vacas pastando em um pedaço de grama entre duas estradas.
Uma televisão, cadeira estofada e café estável em uma sala brilhante.	Um sofá de couro e uma mesa de madeira em uma sala de estar.
Os patos brancos estão de pé no chão.	Uma mulher de chapéu preta está de pé junto ao metrô.
Uma vaca preta e uma vaca marrom fica em uma planície em frente a uma árvore arrancada.	Uma vaca preta e uma vaca marrom em pé na frente de um pequeno bosque de árvores em um campo.
Ônibus de duplo decker vermelho dirigindo pela rua.	Um ônibus de dois andares em uma rua da cidade.
Um grupo de pessoas come em uma mesa lá fora.	Um grupo de pessoas sentadas em uma mesa de restaurante.
Vaca marrom com etiquetas de ouvido em um campo gramado.	pessoa em campo gramado tendendo a ovelhas.
Um close -up da extremidade frontal de um ciclo de motor roxo e branco.	Fechar da parte traseira de um carro esportivo vermelho.
Duas mulheres comprando em uma loja de roupas.	duas mulheres em uma loja de roupas.
Um grupo de pessoas sentadas em uma mesa de restaurante.	Grupo de pessoas sentadas à mesa do restaurante.
Um close da cabeça de um cavalo marrom.	Um close de um ônibus escolar amarelo.
Uma pessoa em um boné vermelho parado ao lado de um feixe de suporte de tijolos.	Um cavalo marrom está de pé na grama e esfrega.
Um potro de baía está andando ao lado de sua mãe em um campo gramado.	Close de cavalos jovens andando ao lado de um cavalo maior.
Uma mulher parada ao lado de uma vaca marrom.	Uma mulher de óculos fica ao lado de uma vaca em um campo.
Dois gatos sentados em um sofá olhando pela janela.	Dois gatos estão olhando para uma janela.
Um cachorro atinge a parte de trás de um caminhão.	Um cachorro está espreitando da parte de trás de uma van.
Mulher em vestido de turno azul cortando comida.	Uma mulher de vestido azul corta um bolo.
O gato preto e branco está olhando para a câmera.	Um gato cinza, preto e branco olhando para a câmera.
Duas meninas morenas sentam -se no topo de uma motocicleta amarela com um carro lateral.	Um casal posando em uma motocicleta vermelha e amarela.
Um pequeno gato branco em pé em uma pia.	Gato cinza e branco sentado na pia do banheiro.
Um homem no banco de trás de uma bicicleta vermelha em tandem.	Um homem está sozinho na parte de trás de uma bicicleta em tandem.
O cachorro pequeno está usando um suéter e olhando para a câmera.	Um pequeno cachorro branco usando uma jaqueta olha para a câmera.
Dois homens em pé de grama olhando para um carro.	Duas mulheres sentadas em cadeiras em uma loja.
um computador em uma mesa.	um computador operando em uma mesa.
Uma criança pequena sorrindo para a câmera.	Uma criança pequena senta -se em uma parede de cimento perto da flor branca.
Um passarinho flutuando na água.	um pato flutuando na água.
Uma mulher fica em frente a um prédio na neve.	Duas mulheres e um bebê posam em frente a uma sala de jantar.
Um ônibus branco com a palavra Julia fica perto da água e de um grande navio.	Um ônibus branco com água e uma barcaça ao fundo.
Home Office Space com paredes verdes brilhantes e obras de arte.	Pequeno escritório com paredes verdes brilhantes.
Trem azul e branco velho nos trilhos.	um trem azul em uma área montanhosa.
jovem menina sentada na mesa.	Uma mulher com um bebê sorridente sentado na mesa.
Um carro verde estacionado em um salão.	Um carro verde estacionado do lado de fora do salão.
barco amarelo em uma praia.	um barco amarelo na praia.
Grupo de pessoas sentadas em torno de uma mesa de jantar de restaurante.	Um grupo de pessoas sentadas em uma mesa de restaurante.
Um cozinha com papéis deitados na mesa de jantar vestida azul.	Uma pequena cozinha e uma mesa desordenada com uma mesa de mesa azul.
Treine em uma estação.	treina dentro de uma estação interna.
Um gato cinza está sentado na borda da janela, olhando para a câmera.	O gato está de pé no peitoril da janela olhando para a câmera.
Dois patos estão de pé junto à água.	Os pássaros estão nadando na água.
Uma vaca em preto e branco em uma caneta com feno.	Vacas pretas e brancas atrás de uma cerca.
Homem tocando violão enquanto está sentado.	ônibus vermelho e branco dirigindo pela estrada.
Um homem e uma mulher estão posando para a câmera.	Um gato sentado na areia olhando para a câmera.
Ônibus vermelho de duplo decker dirigindo por uma rua.	Um ônibus de dois andares em uma rua da cidade.
Um avião de carga verde e branco tirando de um aeroporto.	Avião comercial branco e verde decolando da pista.
Três vacas estão pastando em um campo gramado.	Três vacas pastando em um campo.
O trem marrom está sentado nos trilhos da ferrovia.	O trem branco está sentado nos trilhos.
Uma vaca com chifres preto e branco em pé em um campo.	Uma foto em preto e branco de um gato sentado em um sofá.
Dois gatos estão juntos por dentro e no recinto peludo em preto e branco.	Dois gatinhos bebês estão sentados dentro de uma cúpula coberta de vaca e coberta de peles.
Uma pequena criança loira em um vestido azul fica em uma mesa perto de sua mãe.	Uma jovem loira vestindo um capacete fica com uma bicicleta vermelha atrás dela.
Um grupo de pessoas sentadas em uma mesa de restaurante.	Um grupo de pessoas sentadas ao redor de uma mesa em uma varanda.
Uma vaca em preto e branco em uma caneta com feno.	Um gato preto e branco deita na terra.
um ônibus vermelho de dois andares.	Lado dianteiro e esquerdo de um ônibus vermelho de dois andares.
Um ônibus escolar amarelo estacionado em um campo.	um cavalo marrom em um campo verde.
Uma visão em close da cabeça de um cavalo.	Uma vista lateral da cabeça de um cavalo.
Um homem idoso trabalha em seu laptop em casa.	Cavalheiro mais velho sentado no sofá com laptop.
Um navio de vela de madeira à moda antiga no oceano.	um iate de madeira no oceano.
uma ovelha em pé em uma área montanhosa.	uma grande ovelha em pé em uma colina.
Um grupo de pessoas sentadas em um pequeno sofá ao lado de uma cozinha.	Um grupo de pessoas em pé perto de uma criança pequena sentada em um cavalo.
um avião branco na pista.	Um avião branco está em uma pista.
um filhote de cachorro bronzeado sendo acariciado.	Um filhote de cachorro bronzeado sendo mantido e acariciado.
O gato está sentado em um saco de comida de gato.	duas águias sentadas em um longo galho.
Sala de jantar elegante com móveis de madeira.	Uma elegante sala de jantar rosa com móveis de madeira.
Uma mulher deitada em dois homens sentados em um sofá.	Dois homens de short estão sentados em um sofá.
Duas motos em uma pista de terra.	Dois motociclistas de terra andando sobre Dirt Hill.
Um homem pulando sua bicicleta de terra.	Um homem em uma bicicleta pulando pelo ar.
O gato preto e branco está olhando para a câmera.	Um cachorro preto e branco olhando para a câmera.
Uma grande pilha de itens de madeira empilhados.	uma grande pilha de madeira de sucata.
Um gato cinza com olhos verdes olha para a câmera.	Um gato cinza com olhos verdes olhando para a câmera.
Dois cordeiros estão em uma colina gramada.	Dois motociclistas de terra andando sobre Dirt Hill.
Uma foto em preto e branco de uma garrafa sentada no topo de uma rocha esculpida em frente a uma linha de arbustos.	Uma garrafa de água sentada em uma pedra com outras pedras e uma parede ao fundo.
Uma mulher montando um cavalo marrom.	Uma garota montando um cavalo marrom.
Foto em preto e branco de uma garota em um sofá.	uma foto em preto e branco de uma vaca debaixo de uma árvore.
Um gato preto e branco está sentado em uma cadeira marrom olhando para cima.	Gato preto e branco sentado na cadeira de madeira olhando para cima.
Uma vaca com chifres preto e branco em pé em um campo.	uma grande vaca em preto e branco em um campo.
Um homem de branco com uma garrafa de vinho e uma mulher em uma gola alta vermelha com um colete branco.	Um homem e uma mulher posando em um campo com uma garrafa de vinho.
Uma vaca solitária fica no frio do quintal.	uma vaca em preto e branco em pé no campo.
Um ônibus de dois andares dirige em uma rua da cidade.	Um ônibus vermelho de duplo decker, dirigindo por uma rua.
Grande gato preto e branco apoiado em uma janela.	Um pequeno gato branco sentado em uma pia.
menino alimentando uma ovelha.	um menino alimentando um feno de ovelha.
Um cachorro preto fica ao lado de materiais em um canteiro de obras.	Um cachorro preto fica no meio de um canteiro de obras.
Uma garota de uma área de trabalho preta segura uma caixa aberta de flocos de milho e uma caixa de leite.	Uma garota usando shorts pretos e botas fica ao lado de uma motocicleta azul.
Um close de um pequeno cacto em uma panela.	Um close de uma mulher segurando um filhote branco.
A ovelha branca está de pé na colina verde.	Uma ovelha fica em uma encosta.
Um homem de cabelos compridos com um chapéu entre duas garrafas grandes e meio vazias.	Um homem com boné e jaqueta andando entre duas garrafas grandes.
Um pássaro preto e branco em um corpo de água com grama ao fundo.	Um ônibus fica em uma estrada com uma roda gigante ao fundo.
Uma bicicleta de madeira com toldo.	Um grupo de idosos sentados em torno de uma mesa de jantar.
Uma foto em preto e branco de uma cerca de madeira em ruínas.	Uma foto em preto e branco de uma cerca velha de madeira perto de uma rua suja.
Duas mulheres sentadas em cadeiras em uma loja.	Duas mulheres estão sentadas em um café.
Dois cavalos marrons em pé em um prado verde.	Um cavalo marrom fica em grama alta.
Dois homens usando capacetes de bicicleta.	Dois homens ficam com suas bicicletas do lado de fora de uma loja.
Um jato aeromexico que tributa ao longo de uma pista.	Um revestimento de jato areomexico de prata sentado no asfalto.
Um pássaro vermelho e quatro outros pássaros sentados na neve.	Cinco pássaros estão na neve.
Uma mulher pintando uma cadeira com uma sala de jantar ao fundo.	Um homem e um garoto andando pela praia com o mar ao fundo.
Um homem jogando um videogame em uma loja.	Homem jogando jogo em uma loja.
Um grupo de pessoas sentadas ao redor de uma mesa em uma varanda.	Um grupo de pessoas sentadas em torno de uma mesa com comida nela.
Um casal asiático mais velho posa com um bebê recém -nascido na mesa de jantar.	Um grupo de idosos posam em torno de uma mesa de jantar.
Uma jovem menina usando um capacete de bicicleta com uma bicicleta ao fundo.	Uma mulher segura um cachorro pequeno em uma trela com cadeiras ao fundo.
A parte de trás de um sinal de parada com muitos adesivos nele.	A parte de trás do sinal de parada é adornada com adesivos.
Uma bicicleta está estacionada do lado de fora de uma livraria.	Uma bicicleta verde estacionou do lado de fora de uma livraria.
Um ônibus de turismo marrom de dois andares em uma rua com uma roda gigante atrás dela.	Um ônibus de dois andares dirigindo em frente a uma roda de gigante.
Uma cadeira em preto e branco sentado em frente a uma parede de tijolos e uma janela com uma planta de bambu em um vaso.	Uma ovelha preta coberta de lã branca espessa fica em um pasto com outras ovelhas.
Cato doméstico olhando para a janela.	Um gato branco olhando para fora de uma janela.
Duas vacas pastam em um campo.	um cavalo marrom em um campo verde.
Um homem de uniforme preto em um cavalo branco.	Um homem de smoking em um cavalo branco.
Um gato dormindo no treinador com um travesseiro atrás dele.	O gato está deitado em um cobertor com estampa de animal.
Duas mulheres ficam em uma sala de estar com um cachorro preto.	Duas mulheres em pé em uma sala de estar com um cachorro preto olhando para a câmera.
Duas motos correndo em um curso de terra.	Duas motos em uma pista de terra.
Duas pessoas que remaram uma canoa vermelha são refletidas na água parada.	Duas pessoas remando em uma canoa vermelha com árvores ao fundo.
Uma vista em close dos faróis de um carro antiquado azul.	Feche os faróis em um carro azul.
Uma pessoa está de pé sob um viaduto perto de uma rodovia.	Uma pessoa anda a um cachorro ao longo da beira da água.
Carros dirigindo perto de um edifício modelo.	veículos que dirigem um bebê de um edifício ornamentado.
Uma mulher e uma criança empurram os carrinhos da calçada.	Mulheres e uma jovem que andam pushchairs ao longo da calçada.
Um avião azul e laranja voando com seu trem de pouso.	Um avião vermelho e azul voando com suas marchas de pouso.
Uma jovem está montando uma mangueira de baía em um anel de terra.	Um homem está olhando para um cavalo com uma juba branca.
Um pássaro branco voando para uma árvore.	Um gato branco deitado em uma folha.
Um gato preto e branco deitado em um cobertor.	Um gato preto e branco dorme em um cobertor roxo.
Um prédio com uma placa temporária sobre a entrada do seu estacionamento.	estrada com a imagem traseira das luzes traseiras de um ônibus.
um grupo de pessoas sentadas em torno de uma mesa contendo comida.	Um grupo de pessoas sentadas ao redor de uma mesa em uma varanda.
Um homem e mulheres sentados em um sofá segurando um pequeno bebê.	Uma mulher sentada em um sofá segurando um bebê.
Um gato preto e branco deitado em um cobertor.	Um gato preto e branco dormindo de lado em um cobertor roxo.
Uma foto em preto e branco de um assento de amor.	Uma foto em preto e branco de uma bicicleta.
Uma sala de estar com uma mesa de jantar ao fundo.	Vista de uma sala de estar com uma sala de jantar ao fundo.
Uma mulher na mesa de jantar com vinho, cerveja e limões.	Quatro mulheres e dois homens sentam -se em uma mesa longa em um restaurante.
Um trem vermelho e cinza está passando por um túnel.	Um trem vermelho e cinza viaja por um túnel entre as árvores.
Ônibus vermelho de dois decks com capuz aberto.	Um velho ônibus vermelho de London Double Decker com o capô levantado.
um laptop e um monitor de computador.	um laptop e um PC em uma estação de trabalho.
um homem montando um cavalo branco.	uma mulher liderando um cavalo branco.
Vista de uma sala de estar com uma sala de jantar ao fundo.	Uma sala de estar com sofás grandes e uma mesa de jantar ao fundo.
Um gatinho laranja estava em um sofá de couro.	Jovem casal sentado em um sofá preto.
Um gato branco deitado em uma cadeira de escritório.	Um gato branco deitado em uma folha.
Um pequeno barco amarelo sentado em uma praia tropical.	Uma menina pequena senta -se em uma borda de pedra perto de uma planta branca.
Duas mulheres estão aterrando uma ovelha branca dentro de um prédio de madeira.	Duas mulheres cortando uma ovelha branca em uma barraca de madeira.
Uma pessoa usando um capacete de bicicleta fala em um telefone celular.	Uma pessoa vestindo um capacete anda de bicicleta perto de uma estrutura branca.
Um trem de metrô entrando na estação.	Um trem branco entrando em uma estação.
Uma bicicleta está estacionada por uma loja.	Uma bicicleta verde estacionou do lado de fora de uma livraria.
dois homens em pé na praia.	Duas mulheres em pé em frente ao ônibus de turismo.
Um homem com óculos e duas garrafas de plástico em primeiro plano.	Um homem conversando com duas garrafas de água sentadas na frente dele.
Cão preto de cabelos compridos em pé em campo gramado.	Um Jay Blue em pé em um campo gramado.
Uma pequena mesa com cadeira perto de um armário de lavanderia.	Uma sala com paredes marrom e uma lavadora e secadora.
Ônibus vermelho de dois andares dirigindo pelas ruas.	Ônibus vermelho de duplo decker dirigindo por uma rua.
Um ganso batendo suas asas em um corpo de água.	Um cisne preto batendo suas asas na água.
Um gato cinza deitado em uma mesa marrom.	Um gato cinza deitado em uma mesa de madeira.
Motocicleta estacionada ao lado de um carro do lado de fora.	Uma motocicleta estacionou ao lado de um carro.
Um close de um cavalo marrom.	um close de um cavalo.
menino deitado no sofá com cachorro.	O garoto está deitado em um sofá com um filhote.
Uma imagem em preto e branco de um gato deitado em um tapete.	Imagem em preto e branco de um gato deitado em um tapete.
Um grande jato no chão no aeroporto.	Um grande avião estacionado no aeroporto à noite.
Uma pilha de materiais de construção de madeira usados ​​com uma cadeira por cima.	pilha de detritos de madeira com cadeira no topo.
Duas mulheres estão sentadas em um café.	Dois homens pegando um peixe em um pântano.
Oito garrafas de cerveja harpa alinhadas no chão.	Oito garrafas de cerveja harpa alinhadas em um piso de madeira.
um escritório com várias mesas e paredes verdes.	Pequeno escritório com paredes verdes brilhantes.
uma mulher liderando um cavalo branco.	Um homem de smoking em um cavalo branco.
Uma criança pequena sorrindo para a câmera.	Um gato olhando para a câmera.
Uma mulher montando um cavalo marrom.	Pessoa vestida de cavalo marrom azul.
Foto de uma tela de televisão mostrando um filme.	A TV de tela plana montada na parede está mostrando um filme.
Um pássaro empoleirou -se em um painel de flores.	O pássaro empoleirou -se em um painel de flores ao lado de uma parede de estuque.
Gato branco sentado dentro de uma pia.	Gato cinza e branco sentado na pia do banheiro.
Mulher jovem de montaria no topo do cavalo.	Menina de montaria em um cavalo.
Duas pessoas estão navegando em um pequeno barco.	duas mulheres em um veleiro.
um pequeno pássaro em um pequeno galho.	Um pequeno pássaro empoleirado em um galho gelado.
Dois animais sentados em uma pedra.	duas águias sentadas em um longo galho.
Dois gatos sentam -se na parte de trás de um sofá olhando pela janela.	Dois gatos estão sentados na parte de trás de um sofá e olhando pela janela em uma foto do mar.
Um homem em uma motocicleta realizando um rodas.	motociclista executando um rodas próximas a um carro.
Um trem de passageiros esperando na estação de trem da cidade.	um trem de passageiros com um motor amarelo.
Duas jovens correm uma ovelha.	Duas mulheres que ela está em uma ovelha.
Lado esquerdo de um motor de trem prateado.	Um close de um motor de trem preto.
O jovem piloto dá um passeio no cavalo marrom.	Uma jovem cavaleiro em um cavalo marrom.
Seis pessoas estão sentadas em uma mesa de restaurante e olhando para a câmera.	Um grupo de pessoas sentadas em uma mesa de restaurante.
pequeno cordeiro branco com nariz a madeira.	Um cordeiro branco com o nariz contra uma caixa de madeira.
Um trem preto desce os trilhos.	Um trem longo está em trilhos de trem.
Uma TV de tela plana da Philips é mostrada com seus dois controles remotos.	Uma TV de tela plana Phillips com dois controles remotos.
Um navio de cruzeiro está em frente a uma área de ancoragem.	O gato de chita sentado sentado no passo em frente a uma porta.
uma jovem montando um cavalo branco e cinza.	Uma garotinha está montando um cavalo branco e cinza.
Um cachorro preto fica ao lado de materiais em um canteiro de obras.	Um cachorro preto em pé em uma sala sendo construída.
Couch azul e cama dupla em uma sala de estar.	Um sofá de couro e uma mesa de madeira em uma sala de estar.
Um pássaro está batendo suas asas na água.	Um cisne preto batendo suas asas na água.
Uma vaca preta e branca em pé de feno olha para a câmera.	Há uma ovelha em preto e branco na grama.
Um gato preto e branco deitado em um cobertor.	Um gato preto e branco deitado em uma cama de gato.
Mulher jovem de montaria no topo do cavalo.	A mulher está montando no cavalo marrom.
um avião sendo preparado para decolagem.	Um pequeno plano de turbopropino sendo carregado no asfalto.
Um sofá de couro branco com uma bolsa e jogue cobertor nele.	Uma televisão com um programa em.
Quatro pessoas remaram por um rio.	Quatro pessoas remarem uma canoa na água.
Um cavalo marrom escuro em pé em um campo.	um cavalo marrom em um campo verde.
uma cozinha com armários de madeira e móveis.	Cozinha com mesa de madeira e armários.
Uma bicicleta branca fica no chão.	bicicleta de estilo antigo estacionado no chão.
um pássaro comendo de um alimentador de pássaros.	Um pássaro amarelo comendo frutas em um alimentador de pássaros.
Pássaro preto sentado em uma laje de concreto.	Pássaro negro em pé no concreto.
Dois homens conversando na frente de um avião.	Dois homens conversando na frente de um pequeno avião.
Cão de cor escura em pé em campo gramado.	Um cachorro cinza em pé em um campo gramado.
Uma jovem loira vestindo um sorriso e um capacete de bicicleta.	Uma jovem menina usando um capacete de bicicleta com uma bicicleta ao fundo.
Dois gatos, um marrom e um branco deitado em uma cama com um cobertor azul.	Dois gatos, um gengibre, o outro branco deitado em uma cama.
O gato está atacando uma vassoura de casca de milho.	Gato cinza e branco sentado na pia do banheiro.
O trem fica na estação de trem.	Um trem estacionado em uma estação de trem.
Um casal segura um bebê.	casal com bebê recém -nascido.
um pequeno pássaro comendo do alimentador.	Comer de pássaros de um alimentador de pássaros.
Fechar de uma ovelha branca com a cabeça preta.	Um close de uma ovelha com uma cabeça negra.
Dois cavalos marrons em pé em campo gramado.	Cavalo marrom em pé no meio do campo gramado.
Um garoto deitado em um sofá com um cachorro.	Um menino pequeno deitado em um sofá com um cachorro.
Um pássaro vermelho está empoleirado em uma árvore.	Um pequeno pássaro vermelho e cinza empoleirado em uma árvore.
Dois ônibus estacionados em uma rua.	Scooter amarelo estacionado em uma maneira beco.
Um cachorro preto e branco olhando para a câmera.	Um gato cinza, preto e branco olhando para a câmera.
Dois animais sentados em uma pedra.	O trem marrom está sentado nos trilhos da ferrovia.
Um trem está nos trilhos da ferrovia.	Um trem nos trilhos do trem.
Menino deitado no sofá com cachorro branco pequeno.	Um menino pequeno deitado em um sofá com um cachorro.
Motor locomotivo de prata grande em um galpão.	Um close de um motor de trem prateado com uma faixa vermelha.
Uma mulher sentada à mesa bebendo com uma foto de basquete ao fundo.	Uma mulher em um sari bebe algo enquanto está sentado à mesa.
Um motor a vapor verde viajando nos trilhos da ferrovia.	Um trem a vapor preto viajando nos trilhos da ferrovia.
Um pequeno carro vermelho em cima de um caminhão semi.	Carro de esportes vermelhos no topo do caminhão semi branco.
O homem posa para uma foto em frente ao trem.	Um homem fica em uma plataforma em frente a um trem de prata.
um ciclista de preto em uma bicicleta de corrida preta e vermelha.	Um ciclista em lira preto e branco, passando por espectadores.
Uma pia da cozinha e bancada com tigelas nas prateleiras.	Uma pequena cozinha com itens empilhados nas prateleiras e no balcão.
Uma mulher está deitada no chão e segurando um bebê acima dela.	Um homem está deitado no chão segurando um bebê acima dele.
uma vaca em preto e branco olhando através da cerca.	Um cachorro preto e branco olhando para a câmera.
Uma televisão em uma sala bagunçada com várias estantes.	Um quarto com televisão, estéreo e estante de livros.
Um gato preto e branco dormindo de lado em um cobertor roxo.	Um gato preto e branco deitado no chão ao sol.
Uma mulher andando de bicicleta em uma grande área de concreto.	Uma mulher montando uma bicicleta de montanha em uma grande área de concreto.
duas vacas em pé em um grande campo.	A vaca está pastando em um campo.
Um homem careca toca o nariz de um cavalo preto do outro lado de uma cerca.	Um homem careca com a barba grita o nariz de um cavalo preto e branco na cerca.
Um homem está ao lado de um carro esportivo amarelo.	Um homem fica ao lado de um Corvette amarelo.
Uma casa cinza com uma porta vermelha.	casa com uma porta vermelha.
duas mulheres em uma loja de roupas.	duas mulheres em um veleiro.
uma mulher com um cavalo branco.	uma mulher liderando um cavalo branco.
Uma foto em preto e branco de vacas em suas barracas.	Uma foto em preto e branco de gado em uma calha.
Cavalheiro mais velho olhando para a motocicleta vermelha.	Um homem olhando para uma motocicleta vermelha.
Mulher deprimida sentada no sofá.	Mulher mais velha segurando o bebê recém -nascido.
Ônibus de dois andares com a roda gigante de Londres em segundo plano.	Um ônibus de turismo marrom de dois andares em uma rua com uma roda gigante atrás dela.
Um pássaro amarelo e preto come de um alimentador de pássaros.	Um bando de pássaros voando sobre um corpo de água.
Vacas pretas e brancas pastando em uma caneta.	Duas vacas em preto e branco bebendo de uma lagoa.
Um pequeno avião camuflado estacionado na grama.	Um cachorro pequeno vestindo uma camisa rosa amarrada a uma grade.
Um homem fica na frente de um trem.	Um homem fica em uma plataforma em frente a um trem de prata.
Um pequeno avião estacionado em um campo de pouso com um céu nublado no alto.	Um pequeno avião branco estacionado em um aeroporto em um dia nublado.
Um barco está na água perto de um pequeno avião.	Um barco está na água e um pequeno avião está na doca.
Um homem montando um cavalo branco em uma arena.	Um animal doméstico fica em uma caneta.
Um computador Macintosh sentado no chão.	um computador no chão.
Uma mulher idosa pega uma carona nas costas da bicicleta.	Os barcos estão na água localizada em frente à montanha.
Um gato preto e branco está sentado em uma cadeira marrom olhando para cima.	Um cachorro sentado em uma cadeira amarela ao lado de uma lixeira verde.
ovelhas em pé em campo.	Um cachorro grande fica ao lado de uma ovelha em um campo.
Grupo de idosos sentados em torno de uma mesa.	Um grupo de idosos posam em torno de uma mesa de jantar.
Uma foto em preto e branco de um assento de amor.	Foto em preto e branco do sofá com bolsa em uma extremidade.
Três mulheres com cabelos castanhos estão sorrindo.	Três mulheres em vestidos indianos em uma sala lotada sorrindo.
Uma foto em preto e branco de uma estação de trem vazia.	Uma foto em preto e branco de um gato sentado em um sofá.
As vacas marrons e brancas estão comendo na calha.	Vacas marrons e brancas estão comendo de uma calha.
Dois cães em um canil cercado olham para a frente.	Duas garotas em um cara posando no arco um barco.
Pássaro negro em pé no concreto.	Pássaro azul em pé na grama verde.
uma vaca em preto e branco olhando através da cerca.	Um gato preto e branco deitado no chão ao sol.
Várias pessoas em motocicletas em uma praça de mercado.	As pessoas montam ciclomotores em um ambiente urbano.
Um close de uma ovelha na grama.	Um close de um cordeiro com sua orelha marcada, de pé na grama.
Gato doméstico deitando nas costas da ninhada de gatos.	Cato doméstico bronzeado sob lona preta.
multidão de pessoas passando por um cogumelo gigante.	Um grupo de quatro pessoas passando por um cogumelo gigante.
Dois pássaros verdes voam em direção a um poste telefônico de madeira.	Dois pássaros verdes voando acima dos fios telefônicos.
Uma pessoa sentada em uma motocicleta enquanto um homem fica por aqui.	Um homem fica ao lado de um homem capacete em uma motocicleta em um estacionamento vazio.
Três vacas pastando em um campo.	Duas vacas pastam em um campo.
Uma jovem de braços estendidos fica em frente a um ônibus de "lugares para lugares".	A garota está em pé em frente à porta aberta do ônibus.
uma ovelha ao lado de uma estrada e um lago.	Uma ovelha fica à beira de uma estrada com um lago e uma montanha ao fundo.
vaca preta e branca em pé em campo gramado.	Uma foto em preto e branco de um homem ao lado de um ônibus.
Um pássaro azul empoleirado em uma mão enluvada.	Um pássaro está empoleirado na mão enluvada de uma pessoa.
um grupo de pessoas fazendo uma refeição lá fora.	Um grupo de pessoas come em uma mesa lá fora.
Um bebê segura um pacote de ketchup.	Um bebê em uma cadeira alta segura um pacote de ketchup.
Uma visão em close da cabeça de um cavalo.	Um close da cabeça de um cavalo marrom.
Dois gatos sentados juntos no sofá, olhando pela janela.	Dois gatos sentam -se na parte de trás de um sofá olhando pela janela.
Um trem fica em uma estação de trem.	um trem em uma estação.
Um cavalo marrom escuro em pé em um campo.	cavalo em pé em um campo.
Um homem sentado em um banco olhando para um cachorro em uma trela sentada na calçada.	Uma mulher segura um bebê pequeno enquanto está sentado em um sofá.
Um pequeno gato deitado em uma viga de madeira olhando para a câmera.	O cachorro pequeno está usando um suéter e olhando para a câmera.
O pássaro preto está sentado no chão.	O pássaro está sentado no galho.
Um grupo de pessoas sentou -se à mesa em um restaurante italiano.	Um grupo de seis pessoas sentadas à mesa com salada servida.
As vacas bronzeadas olham atentamente para a câmera.	Um gato branco e cinza em uma pia de banheiro olhando para a câmera.
Uma scooter azul estacionou em uma calçada.	Um ciclomotor azul estacionado na calçada.
Mulher mais velha segurando o bebê recém -nascido.	Uma mulher sentada em um sofá segurando um bebê.
Um pequeno pássaro marrom está comendo de um alimentador de pássaros pendurado em uma árvore.	Um pequeno pássaro vermelho e cinza empoleirado em uma árvore.