O problema provavelmente significará mudanças corretivas antes que a frota de ônibus começar a voar novamente.	Ele disse que o problema precisa ser corrigido antes que a frota espacial seja liberada para voar novamente.
O índice de composto Nasdaq com tecnologia.	O índice Broad Standard & Poor's 500 .spx aumentou 3 pontos, ou 0,32 %, para 970.
"É um enorme olho roxo", disse o editor Arthur Ochs Sulzberger Jr. , cuja família controla o artigo desde 1896.	"É um enorme olho roxo", disse Arthur Sulzberger, editor do jornal, sobre o escândalo.
O presidente da SEC, William Donaldson, disse que há uma "confiança do edifício por aí que o policial está no ritmo".	"Acho que há uma confiança de edifício de que o policial está no ritmo".
As ações da Vivendi fecharam 1,9 % a 15,80 euros em Paris, depois de cair 3,6 % na segunda -feira.	Em Nova York, as ações da Vivendi caíram de 1,4 % em US $ 18,29.
O líder pró-democracia de Mianmar, Aung San Suu Kyi, voltará para casa na sexta-feira, mas permanecerá em detenção após se recuperar de uma cirurgia em um hospital de Yangon, disse seu médico pessoal.	A líder pró-democracia de Mianmar, Aung San Suu Kyi, será mantida em prisão domiciliar após sua libertação de um hospital onde ela foi submetida a uma cirurgia, disse seu médico pessoal na sexta-feira.
Darren Dopp, porta -voz do Spitzer, se recusou a comentar na quinta -feira.	John Heine, porta -voz da Comissão em Washington, se recusou a comentar sobre o Sr. As críticas de Spitzer.
Bremer disse que uma iniciativa é lançar um programa nacional de US $ 70 milhões nas próximas duas semanas para limpar os bairros e criar projetos comunitários.	Bremer disse que lançaria um programa de US $ 70 milhões nas próximas duas semanas para limpar os bairros no Iraque e construir projetos comunitários, mas não deu detalhes.
Na negociação da tarde na Europa, o CAC-40 da França avançou e o FTSE 100 da Grã-Bretanha ganhou 0,7 %, enquanto o índice DAX da Alemanha aumentou 0,6 %.	Na Europa, o CAC-40 da França subiu 1,3 %, o FTSE 100 da Grã-Bretanha diminuiu 0,2 % e o índice DAX da Alemanha ganhou 0,6 %.
Mais tarde, ele soube que o incidente foi causado pelo Sonic Boom do Concorde.	Mais tarde, ele descobriu que o alarmante incidente foi causado pelo poderoso boom sônico de Concorde.
Sens. John Kerry e Bob Graham recusaram convites para falar.	Os não shows eram Sens. John Kerry, de Massachusetts, e Bob Graham, da Flórida.
Page disse que também é possível que os genes no cromossomo Y possam influenciar as diferenças específicas de gênero na suscetibilidade à doença.	Ele acrescentou que os genes no Y podem desempenhar um papel na influência de diferenças específicas de gênero na suscetibilidade à doença.
Uma das facetas mais estudadas de temperamento é como as pessoas respondem à novidade.	Uma das características definidoras e bem estudadas do temperamento é como as pessoas reagem à novidade.
Mas as borboletas expostas a um ciclo de luz anterior, das 13h às 13h, se orientavam para o sudeste.	Mas as borboletas alojadas sob um ciclo de luz anterior, das 13h às 13h. , voou em direção ao sudeste.
O analista da RT Jones, Juli Niemann, disse que Grant era "o que todos estávamos puxando.	Ele tem uma reputação muito boa ", disse o analista da RT Jones, Juli Niemann, sobre Grant.
Uma questão -chave era se a França, que enfureceu Washington ao liderar a acusação contra a ONU. Autorização para a guerra, votaria "sim" ou se abstenha.	França, que enfureceu Washington ao liderar a acusação contra a ONU. A aprovação para a guerra também procurou mudanças.
O épico bíblico de Mel Gibson "A Paixão de Cristo" será inaugurado nos Estados Unidos em fevereiro. 25 - Quarta -feira de cinzas no calendário católico romano.	Mel Gibson está negociando com os filmes de Newmarket para distribuir seu épico bíblico em apuros "A Paixão de Cristo" nos Estados Unidos.
Dunlap venceu a competição de maiô e a parte de talento da competição, cantando "se eu pudesse".	Ela venceu a parte de talento cantando "se eu pudesse" e também venceu no desgaste noturno.
O governador Gray Davis estimou ontem que os incêndios poderiam custar quase US $ 2 bilhões.	As autoridades estaduais estimaram o custo em quase US $ 2 bilhões.
The American Express Corp. prometeu pelo menos US $ 3 milhões de mais de US $ 5 milhões necessários.	A cidade solicitou fundos federais, mas retirou esse pedido quando a American Express prometeu pelo menos US $ 3 milhões.
O sul da Ásia segue, com 1,1 milhões de jovens infectados - 62 % deles.	Dos 1,1 milhão infectados no sul da Ásia, 62 % são do sexo feminino.
Uma hora depois, um helicóptero israelense disparou mísseis em um carro em Gaza City, matando dois oficiais do Hamas e pelo menos cinco outras pessoas.	Uma hora depois, helicópteros de ataque israelense choveram mísseis em um carro na cidade de Gaza, matando sete pessoas, disseram fontes palestinas.
Os recrutadores executivos dizem que encontrar um diretor experiente de merchandising talvez seja o mais complicado de todas as contratações, porque há uma escassez de boas.	Os recrutadores executivos dizem que encontrar um chefe de merchandising experiente talvez seja o mais complicado de todos os contratações.
O porta -voz da AAA, Jerry Cheske, disse que os preços podem ter afetado alguns planos, mas acordos baratos de hotéis atenuaram o efeito.	O porta -voz da AAA, Jerry Cheske, disse que os preços podem ter afetado alguns planos, mas acordos baratos de hotéis compensados.
O conflito de décadas matou mais de 10.000 pessoas na província rica em recursos, a maioria delas civis.	Mais de 10.000 pessoas, a maioria delas civis, foram mortas em três décadas de insurgência.
Claudette, o primeiro furacão da temporada de tempestades do Atlântico, chegou à costa de meados da Texas em 15 de julho com um vento de 85 mph.	Claudette, o primeiro furacão da temporada de tempestades do Atlântico, chegou à costa da costa de meados da Texas, em 15 de julho, classificada como um furacão de categoria 1 com ventos máximos sustentados de 85 mph.
Ela contou com US $ 125 milhões, dizendo que Gruner & Jahr quebrou seu contrato com ela cortando -a das principais decisões editoriais.	Ela contou com US $ 125 milhões, dizendo que G + J quebrou seu contrato com ela cortando -a das principais decisões editoriais e manipulou os números financeiros da revista.
A edição padrão custa US $ 15.000 por processador ou US $ 300 por usuário nomeado.	O Standard Edition One é uma versão única do processador do banco de dados do Oracle Standard Edition.
Resultados de não. 2 EUA fabricante de refrigerantes PepsiCo Inc. (NYSE: PEP - NEWS - PESSOAS) É provável que esteja no centro das atenções.	Wall Street também estava esperando a fabricante de alumínio Alcoa Inc. (NYSE: PEP - NEWS - PESSOAS) Para relatar ganhos após o fechamento.
A Microsoft adquiriu o Virtual PC quando comprou os ativos do Connectix no início deste ano.	A Microsoft adquiriu o Virtual PC de seu desenvolvedor, Connectix, no início deste ano.
Os assessores de Taylor alertam uma partida abrupta pode desencadear mais caos, uma visão compartilhada por muitos na Libéria e, em particular, mesmo pelos mediadores.	Seus assessores alertam que uma partida abrupta pode desencadear mais derramamento de sangue, uma visão compartilhada por muitos na Libéria.
Mas Odette é o primeiro a se formar sobre o mar do Caribe em dezembro, informou o centro.	É a primeira tempestade nomeada a se desenvolver no Caribe em dezembro.
O corpo de Leon Williams foi encontrado dentro de seu apartamento no terceiro andar em 196 Bay St. , em Tompkinsville.	O homem morto, Leon Williams, foi encontrado em seu apartamento no terceiro andar.
É o primeiro exercício desde os ataques terroristas de 11 de setembro a Nova York e Washington.	É o primeiro exercício de contraterrorismo em larga escala da nação desde setembro. 11 ataques terroristas.
O AFL-CIO está esperando até outubro para decidir se vai endossar um candidato.	A AFL-CIO anunciou quarta-feira que decidirá em outubro endossar um candidato perante as primárias.
Ursel Reisen confirmou que operava o treinador, mas não deu detalhes além de dizer que os passageiros tinham idades mistas.	Ursel Reisen confirmou que estava operando o treinador, mas se recusou a fornecer detalhes dos passageiros, além de dizer que eram de idades mistas.
Um total de 17 casos foram confirmados na cidade de Basra, no sul, informou a organização.	Um total de 17 casos confirmados de cólera foram relatados ontem pela Organização Mundial da Saúde na cidade de Basra, no sul do Iraque.
Ele também deveria visitar o Iêmen e o Bahrein durante sua turnê pela região.	Khatami, que chegou a Beirute na segunda -feira, também visitava a Síria, o Iêmen e o Bahrein.
O general Myers disse aos repórteres que "à primeira vista, não parece que qualquer regras tenha sido quebrada".	"À primeira vista, não parece que qualquer regras tenha sido quebrada", disse Gen. Richard Myers, presidente dos Chefes de Estado -Maior Conjuntos.
Provando que o sacrifício do filho de Millville não seria desconhecido, o prefeito James Quinn ordenou que todas as bandeiras da cidade voassem no meio mastro pelos próximos 30 dias.	Em Millville ontem, o prefeito James Quinn ordenou que todas as bandeiras da cidade voassem na meia equipe pelos próximos 30 dias.
Tom Kasmer, um garoto de 14 anos de Belmont, N.C. , recebeu uma palavra que parecia "Zistee" durante a competição de ontem.	O finalista nacional de ortografia de 14 anos que frequenta a escola em Belmont, N.C. , recebeu uma palavra que parecia "Zistee" durante a competição na quarta -feira.
Tom Kraynak, gerente de operações e recursos do Conselho de Confiabilidade da Área Central de Canton, em Ohio, disse que o cenário é um dos muitos que os investigadores estão considerando.	Tom Kraynak, gerente de operações e recursos do Conselho de Confiabilidade da Área Central de Canton, em Ohio, disse que os investigadores estão considerando o cenário.
Eles encontraram moléculas que só podem ser produzidas quando o ozônio quebra o colesterol.	e todas as amostras continham moléculas que só podem ser produzidas quando o colesterol interage com o ozônio.
Foi desenvolvido com consulta de mais de 300 líderes na academia, indústria, governo e público.	O plano, chamado Roteiro do NIH, foi desenvolvido em 14 meses com a ajuda de mais de 300 consultores na indústria e na academia.
Ele pode armazenar mais de um gigabyte de informação equivalente a cerca de 12 horas de música em um centímetro cúbico.	E pode armazenar mais de um gigabyte de informação - equivalente a 1.000 imagens de alta qualidade ou cerca de 12 horas de música - em apenas um centímetro cúbico.
No início deste mês, Rim disse que esperava relatar ganhos no segundo trimestre entre 7 centavos e 11 centavos por ação.	Excluindo honorários legais e outras acusações, esperava uma perda entre 1 e 4 centavos por ação.
A análise do orçamento ocorre quando as negociações entre o Conselho da Cidade e o governo Bloomberg esquentam.	As negociações orçamentárias entre o prefeito e o Conselho da Cidade estão entrando em alta velocidade.
Também em risco aumentado estão aqueles cujos sistemas imunológicos suprimidos por medicamentos ou por doenças como câncer, diabetes e AIDS.	Também em risco aumentado estão aqueles com sistemas imunológicos suprimidos devido a doenças ou medicamentos.
As autoridades policiais locais estão tratando a explosão como uma questão criminal e nada foi descartado.	O chefe de polícia de New Haven, Francisco Ortiz, disse que a polícia estava tratando a explosão como uma questão criminal.
"Para mim, o Lewinsky Imbroglio parecia apenas mais um escândalo cruel fabricado por oponentes políticos", de acordo com extratos divulgados ontem.	"Para mim, o Lewinsky Imbroglio parecia apenas mais um escândalo cruel fabricado por oponentes políticos", escreve Clinton.
Em 2001 e 2002, as transferências de arame de 4 das 40 contas da empresa totalizaram mais de US $ 3,2 bilhões, disseram os promotores.	As transferências de arame de quatro das 40 contas abertas em Beacon Hill totalizaram mais de US $ 3,2 bilhões de 2001 a 2002, disse Morgenthau.
A Stony Brook University lançou o estudo em 1996, depois que estudos anteriores indicaram uma possível conexão entre campos eletromagnéticos e câncer.	A Universidade Estadual de Stony Brook lançou o estudo em 1996, depois que estudos anteriores indicaram uma possível conexão.
Anteriormente, eles desafiaram uma ordem policial e choraram "Allahu Akbar" (Deus é maior) quando Bashir caminhava até o seu assento no tribunal bem guardado.	Antes, os apoiadores de Bashir haviam desafiado uma ordem policial e chorou "Allahu Akbar (Deus é maior)" enquanto caminhava até o seu assento.
O porta -voz da Ambulância Metropolitana, James Howe, disse que cinco pessoas foram levadas para o hospital e três foram tratadas no local após o incidente de ontem.	O porta -voz James Howe disse que cinco crianças com idades entre 4 e 17 anos foram levadas para o hospital com lesões no pescoço e no peito, enquanto três outros foram tratados no local.
Quíron já tem quase 20 % de aceitações dos acionistas do Powderject.	Quíron tem aceitações de titulares de quase 20 % das ações em pó.
Mas está claro que o Comitê de Inteligência Conjunto não estava envolvido.	Este relatório foi liberado pelo Comitê Conjunto de Inteligência.
Cerca de 22 % dos vinte e poucos anos são obesos, o que é de aproximadamente 30 libras sobre um peso saudável.	Cerca de 31 % dos americanos agora são obesos - aproximadamente 30 ou mais libras sobre um peso saudável.
O acoplamento, uma versão americana de uma comédia britânica, receberá o valioso quinta -feira das 21h30. intervalo de tempo.	O acoplamento, uma versão americana de uma comédia britânica, se unirá a amigos às quintas -feiras.
As ações da Coca -Cola fecharam a negociação de bolsas de valores de Nova York na quinta -feira a US $ 44,01.	No comércio matinal na Bolsa de Nova York, as ações da Coca-Cola caíram 34 centavos em US $ 43,67.
Seu corpo foi encontrado várias semanas depois no rio Green.	AUG. 15, 1982: Restos de Chapman, Hinds e Mills são encontrados no rio Green.
"Sinto que as pessoas que estão enviando essas mensagens estão violando meus direitos e os direitos de todos os outros de usar seus computadores", disse McKechnie.	As pessoas que estão enviando essas mensagens estão violando meus direitos e todos os outros direitos de usar seu computador ", disse McKechnie.
"A luta continuou até a meia -noite", disse o comandante da Rebel Western Ousmane Coulibaly à Reuters por telefone via satélite no domingo.	"Eles saquearam e queimaram completamente as duas aldeias", disse o comandante rebelde Ousmane Coulibaly à Reuters por telefone via satélite do mato.
A leitura de agosto e julho é a melhor vista desde que a pesquisa começou em agosto de 1997.	É a leitura mais alta desde que o índice foi criado em agosto de 1997.
"Geralmente indesejados - e muitas vezes pornográficos ou com intenção fraudulenta - o spam é um incômodo e uma distração", escreve Gates, nos aquecendo para a piada.	Geralmente indesejado - e geralmente pornográfico ou com intenção fraudulenta - spam é um incômodo e uma distração ", escreve Gates.
As tropas das Forças Especiais dos EUA estão treinando soldados colombianos em bases militares na região para proteger o oleoduto, que transporta petróleo do segundo maior campo de petróleo da Colômbia.	nós. As tropas das forças especiais estão treinando soldados colombianos em bases militares na região para proteger o oleoduto.
O varejista disse que tomou a decisão depois de ouvir as opiniões de clientes e associados.	A decisão ocorreu após "ouvir nossos clientes e associados", disse Melissa Berryhill, porta-voz do Wal-Mart.
Lord Falconer saudou as mudanças como "um novo começo no que diz respeito aos tribunais, ao serviço de acusação da Coroa e à polícia".	"É um novo começo no que diz respeito aos tribunais, ao serviço de acusação da coroa e à polícia, deixando o sistema de justiça criminal funcionar melhor".
Precisamos de um salário certificável à medida que você vá orçamento em meados de julho ou as escolas não abrirão em setembro, disse Strayhorn.	Os legisladores do Texas devem fechar uma lacuna orçamentária de US $ 185,9 milhões em meados de julho ou as escolas não abrirão em setembro, disse a contratragem Carole Keeton Strayhorn na quinta -feira.
As ações da Hartford subiram US $ 2,88 para US $ 46,50 na negociação composta da Bolsa de Nova York.	As ações da Hartford subiram US $ 2,28, ou 5,2 %, para US $ 45,90 em negociações do meio -dia.
O DVD-CCA então apelou à Suprema Corte do estado.	O DVD CCA recorreu dessa decisão para os EUA Suprema Corte .
"Acreditamos que estamos totalmente preparados para lançar as máquinas [tela de toque] para as primárias presidenciais de 2004", disse Gilles W. Burger, Presidente do Conselho Estadual de Eleições.	"Acreditamos que estamos totalmente preparados para lançar as máquinas Diebold revisadas", disse Gilles W. Burger, presidente do Conselho de Eleições do Estado de Maryland.
A estação de música country KKCS suspendeu dois disc jockeys por tocar músicas dos Dixie Chicks, violando uma proibição imposta depois que um membro do grupo criticou o presidente George Bush.	Uma estação de rádio suspendeu dois disc jockeys por se trancar no estúdio e tocar continuamente músicas de Dixie Chicks, violando a proibição de dois meses da estação de dois meses na música do grupo.
O índice de composto NASDAQ com tecnologia <.ixic> saltou 26 pontos, ou 1,78 %, para 1.516.	O índice Broad Standard & Poor's 500 .spx subiu 8,79 pontos, ou 0,96 %, em 929,06.
A edição on -line da Business Week informou na sexta -feira que a Worldcom e a SEC poderiam anunciar um acordo na segunda -feira.	A BusinessWeek Online descobriu que o acordo poderia chegar já na segunda -feira, 19 de maio.
As ações da Sovereign perderam 74 centavos, ou 4,5 %, para US $ 15,68.	As ações soberanas fecharam na Bolsa de Nova York em US $ 15,68, queda de 74 centavos, ou 4,5 %.
As ações da Aspen Technology caíram 74 centavos, ou 23 %, para fechar em US $ 2,48 no NASDAQ.	Nas negociações da tarde, as ações da Aspen estavam fora de 89 centavos ou mais de 27 % a US $ 2,33 por ação.
A nova lei exige que bibliotecas e escolas usem filtros ou percam financiamento federal.	A decisão de 6-3 restabelece uma lei que disse às bibliotecas para instalar filtros ou render dinheiro federal.
Além disso, ofereceu aos Estados Unidos e a Israel uma maneira de contornar o MR. Arafat.	Quando a posição do primeiro -ministro foi estabelecida na primavera, ofereceu aos Estados Unidos e a Israel uma maneira de trabalhar em torno de Arafat.
E sim, Marilyn Monroe é definitivamente parte da história, intitulada "Arthur Miller, Elia Kazan e a lista negra: Nenhum sem pecado".	Observe a subposição desta terrível parábola na série "American Masters", "Arthur Miller, Elia Kazan e a Lista Negra: Nenhum sem pecado".
A polícia de Gilroy e os agentes do FBI descreveram Gehring como cooperativa, mas disse no sábado que não havia revelado nada sobre o que havia acontecido com as crianças.	Sábado, funcionários da Califórnia descreveram Gehring como cooperativa - mas disseram que não revelou nada sobre o que aconteceu com as crianças.
O corpo de Scribner foi encontrado flutuando na baía de Portage da cidade, onde morava com sua esposa em uma casa de barco.	Um caiaque encontrou dr. O corpo de Scribner flutuando perto da casa de barco do médico em Portage Bay, onde estava almoçando quando sua esposa, Ethel, partiu para uma consulta.
Depois que os manifestantes correram o palco e reduziram duas vezes a energia do microfone, Hedges levou o discurso até o início.	Depois que os manifestantes correram o palco e reduziram duas vezes a energia do microfone, Hedges interrompeu seu discurso.
Um transeunte encontrou Ben escondido ao longo de uma estrada de terra em espanhol Fork Canyon por volta das 19h. , com as mãos ainda gravadas juntas, mas seus pés livres.	Um transeunte encontrou o garoto escondido ao longo de uma estrada de terra em espanhol Fork Canyon por volta das 19h. Quinta -feira, com os pés livres, mas suas mãos ainda gravadas.
Analistas esperavam ganhos de 27 centavos por ação na receita de US $ 17,7 bilhões, afirma Thomson.	A Hewlett-Packard está adquirindo um lucro no segundo trimestre de US $ 659 milhões, ou 29 centavos por ação, em receita de US $ 18 bilhões.
Os médicos dizem que um ou os dois meninos podem morrer e que algum dano cerebral é possível se sobreviver.	Os médicos disseram que um ou ambos os meninos podem morrer e que, se sobreviverem, é possível algum dano cerebral.
Outro estava em estado grave no Northwest Medical Center, em Springdale.	No Northwest Medical Center, no Condado de Washington, em Springdale, uma criança está em estado grave.
"Comecei a chorar e gritar com ele: 'O que você quer dizer, o que você está dizendo, por que você mentiu para mim?'"	Engajando pelo ar, comecei a chorar e gritar com ele: 'O que você quer dizer?
Sean Harrigan, presidente do sistema de aposentadoria dos funcionários públicos da Califórnia, também sugeriu reduzir o conselho de 27 membros da NYSE, mudando sua composição e tornando-o mais responsável.	Sean Harrigan, presidente do sistema de aposentadoria dos funcionários públicos da Califórnia, também sugeriu a redução do conselho de 27 membros da NYSE e atribuindo mais assentos para investidores fora do setor de valores mobiliários.
Também está faltando Al Larsen, 31, de Fort Worth, Texas, que estava em outro veículo varreu a rodovia.	A outra vítima recuperada na manhã de terça -feira foi Al Larsen, 31, de Fort Worth, Texas.
A GlaxoSmithkline Plc, com sede britânico, disse no início deste ano que cortaria os suprimentos para farmácias canadenses que são enviadas para os Estados Unidos.	A GlaxoSmithKline, a farmacêutica do Reino Unido, disse que cortaria os suprimentos para as lojas canadenses que enviam medicamentos para os EUA.
O festival começou ontem um dia depois que a Comissão da Competição entregou seu veredicto final ao governo na proposta de fusão de £ 4,1 bilhões.	A Comissão da Concorrência entregou seu veredicto ontem sobre a proposta de fusão dos dois grandes jogadores da ITV, Carlton e Granada.
O banco central sueco também se reuniu na quarta -feira e espera -se que anuncie um corte na quinta -feira.	O banco central sueco, também se reunindo na quarta -feira, deve anunciar um corte na quinta -feira de até meio ponto percentual.
Foi a terceira vez em quatro anos que os incêndios forçaram o parque a fechar.	Pela terceira vez em quatro anos, os incêndios fechados fecharam o Parque Nacional Mesa Verde, o único parque do país dedicado às ruínas antigas.
A GM, a maior montadora do mundo, possui 115.000 trabalhadores ativos da UAW e outros 340.000 aposentados e cônjuges.	Eles cobrem mais de 300.000 trabalhadores da UAW e 500.000 aposentados e cônjuges.
Seu Chevrolet Tahoe de 1996 foi encontrado abandonado em uma praia de Virginia, VA. , estacionamento 25 de junho.	Seu veículo utilitário esportivo foi encontrado em 25 de junho, abandonado sem suas placas em Virginia Beach, VA.
Ela disse que ele persistiu e que finalmente permitiu que ele consertasse sua bicicleta enquanto estava sentado no banco da frente do carro dele.	Ela disse que finalmente permitiu que ele consertasse a bicicleta enquanto estava sentado no carro dele, e eles conversaram.
Heatley ficou em sexto na liga nos gols na última temporada, com 41 e nono em pontos com 89.	Heatley liderou Atlanta na última temporada com 41 gols e 48 assistências.
Daniels disse que não sabe o que Bush terá a dizer sobre ele no arrecadador de fundos presidencial de US $ 2.000 por pessoa.	Daniels disse que não sabe o que Bush dirá na recepção de US $ 2.000 por pessoa para arrecadar fundos para sua oferta de reeleição presidencial.
Um painel de três juízes do 11º EUA O Tribunal de Apelações do Circuito decidiu na sexta -feira que o tamanho pequeno, o uso limitado e o objetivo secular tornam a imagem legítima.	Um painel de três juízes do 8º EUA Tribunal de Apelações do Circuito em ST. Louis anulou uma decisão emitida no ano passado que apoiou a ordenança.
"Tony não está se sentindo bem", disse o técnico do Spurs, Gregg Popovich.	Ficamos emocionados por subir por 3-2 '', disse o técnico Gregg Popovich na quarta-feira.
Electronic Data Systems Corp. Quinta -feira disse que a Securities and Exchange Commission pediu à empresa documentos relacionados ao seu grande contrato com os EUA Marinha.	Em um registro regulatório, a EDS disse que a SEC havia solicitado informações relacionadas ao seu controlado contrato de terceirização de TI com a Marinha dos EUA.
A empresa afirma que é a maior venda de Apple Var XServe até o momento.	A empresa alegou que é a maior venda de XServes por um varejista da Apple.
Apenas 29 famílias de sapos são conhecidas e a maioria foi identificada e descrita em meados do século XIX e a última em 1926.	Apenas 29 famílias de sapos são conhecidas, a maioria das quais foi nomeada em meados do século XIX.
Funcionários da Brandeis disseram que este era um tempo "extremamente emocionante" para o campus.	"Este é um tempo extremamente emocionante para toda a comunidade da Brandeis University.
Os mercados da América do Norte terminaram misturados em negociações sem direção na segunda -feira, quando a temporada de ganhos começa a diminuir e os indicadores econômicos se mudam para os holofotes.	Os mercados norte -americanos obtiveram ganhos antecipados na segunda -feira de manhã, à medida que a temporada de ganhos começa a desacelerar e os indicadores econômicos levam os holofotes.
Além do esquema de golfinhos, o caos permitiu que empresas estrangeiras se envolvessem em operações prejudiciais à extração de extração e pesca sem controles adequados de monitoramento ou exportação.	O caos interno permitiu que empresas estrangeiras estabelecessem operações comerciais de extração de extração e pesca comerciais sem controles adequados de monitoramento ou exportação.
O valor totalizará cerca de US $ 124 milhões, incluindo títulos conversíveis, de acordo com Corel.	Incluindo títulos conversíveis, o valor total estimado do acordo é de US $ 124 milhões, segundo Corel.
O Índice de Ações 500 da Standard & Poor encerrou o trimestre de 120 pontos, um ganho de 14 %, o melhor desempenho para esse amplo referência do mercado desde 1998.	O Índice de 500 estoques da Standard e Poor, uma ampla coleção de ações representando empresas líderes, terminou seu melhor trimestre ontem desde os últimos três meses de 1998.
A próxima sessão do Tribunal será quando o Tribunal de Três Junho anunciar seu veredicto em meados de fevereiro.	O tribunal de três juízes do tribunal deveria dar seu veredicto em fevereiro próximo.
Ele começou no Super Bowl de 1983, que Miami perdeu 27-17 para Washington.	Ele jogou quatro temporadas em Miami, incluindo a derrota dos Dolphins por 27 a 17 para Washington no Super Bowl.
O consenso entre os analistas de Wall Street foi por uma perda de 28 centavos por ação.	Analistas pesquisados ​​pela primeira chamada esperavam vendas de US $ 723 milhões e uma perda de 28 centavos por ação.
"Não conheço pressão", disse o Sr. Feith, o Subsecretário de Defesa da Política.	"Conheço ninguém que pressionou ninguém", disse Douglas Feith, subsecretário de Defesa da Política, em um briefing do Pentágono.
Espera -se que os serviços NTERprise Linux estejam disponíveis antes do final deste ano.	Espera -se que as versões beta dos serviços NTERprise Linux estejam disponíveis em certos servidores HP Proliant em julho.
Excluindo itens únicos, a empresa teve um lucro de 6 centavos por ação.	Excluindo itens únicos, espera lucro de 11 centavos a 15 centavos por ação.
"Mas eu questiono os motivos de um presidente de deskbound que assume a roupa de um guerreiro para os propósitos de um discurso".	Byrd, falando do piso do Senado, disse que questionou "os motivos de um presidente de deskbound que assume a roupa de um guerreiro para fins de um discurso".
O Índice 500 Standard e Poor Standard & Poor .spx caiu 3 pontos, ou 0,30 %, para 995.	O índice de composto NASDAQ com tecnologia <.ixic> adicionou 1,92 pontos, ou 0,12 %, em 1.647,94.
Em vez disso, os ingressos para o Jersey Jam foram vendidos ontem à noite através do Ticketmaster.	Os ingressos, disponíveis no Ticketmaster, foram colocados à venda ontem.
No início da segunda -feira, Grant Thornton Spa repetiu declarações anteriores de que era "uma vítima de ação fraudulenta".	Grant Thornton afirma que também foi a "vítima" de uma fraude.
Peter Lyman e Hal Varian, da Escola de Gerenciamento e Sistemas de Informações de Berkeley, dizem que a produção de informações aumentou 30 % a cada ano entre 1999 e 2002.	Essa tarefa atraiu dois mestres do megabyte, Peter Lyman e Hal Varian, professores da Escola de Gerenciamento e Sistemas da Universidade da Califórnia-Berkeley.
"Meu julgamento é de 95 % dessas informações deve ser desclassificado, não -censurando, para que o povo americano soubesse".	Meu julgamento é de 95 % dessas informações que podem ser desclassificadas, não -censoradas para que o povo americano soubesse ", disse Shelby no encontro da NBC. "
Os pesquisadores encontraram apenas cavidades vazias e tecido cicatricial onde estavam os tumores.	Nenhum tumor foi detectado; Em vez disso, cáries vazias e tecido cicatricial foram encontrados em seu lugar.
Washington, no entanto, disse que mais era necessário para impedir que as queixas fossem apresentadas em primeiro lugar.	Mas os EUA insistiram que queria mais para impedir que as queixas fossem apresentadas em primeiro lugar, de preferência revogando toda a lei.
Após 26 horas de cirurgia e um ano de antecipação, os meninos foram separados no domingo no Centro Médico de Dallas para crianças.	Gêmeos gêmeos egípcios de dois anos, nascidos com a cabeça em conjunto, foram separados após 26 horas de cirurgia no Centro Médico das Crianças em Dallas.
Pines disse que convocaria os órgãos partidários relevantes dentro de 10 dias para discutir se novas eleições seriam realizadas ou se um líder temporário seria nomeado.	Mitzna e o secretário do Partido Ophir Pines concordaram em convocar organizações do partido dentro de 10 dias para discutir se novas primárias seriam realizadas ou um líder temporário nomeado.
"Ela estava chorando e assustada", disse Isa Yasin, proprietário da loja.	"Ela estava chorando e estava realmente assustada", disse Yasin.
O euro subiu para US $ 1,1914 em negociações asiáticas, antes de recuar ligeiramente para US $ 1.1895 quando as negociações foram abertas na Europa.	O euro subiu para US $ 1,1914 nas negociações asiáticas, antes de voltar para US $ 1,1884 no final da negociação européia, acima de US $ 1,1857 na segunda -feira.
Abbas disse à cúpula que terminaria o terrorismo "armado intefadeh" "renunciou" contra os israelenses onde quer que eles sejam "e aludissem ao desarmamento dos militantes.	Na cúpula de quarta -feira, Abbas prometeu acabar com o terrorismo "Armado intefadeh" "renunciou" contra os israelenses onde quer que eles sejam "e aludissem ao desarmamento dos militantes.
A taxa de desemprego civil melhorou marginalmente no mês passado - caindo para 6,1 % - mesmo quando as empresas reduziram as folhas de pagamento em 93.000.	A taxa de desemprego civil melhorou marginalmente no mês passado - reduzindo para 6,1 % _, à medida que as empresas cortaram as folhas de pagamento em 93.000 em meio a sinais mistos contínuos sobre a saúde econômica do país.
Moffitt disse que os resultados precisam ser replicados em outro estudo antes do teste de indivíduos quanto à presença das versões longas ou curtas do gene.	O professor Moffitt disse que os resultados precisam ser replicados antes de realizar testes de indivíduos quanto à presença das versões longas ou curtas do gene.
"Frank Quattrone é inocente", disse Keker em comunicado.	advogado de quattrone John w. Keker disse que seu cliente é inocente.
cmdr. Rod Gibbons, porta -voz da academia, disse: "A academia está chocada e triste.	porta -voz da Academia Naval CMDR. Rod Gibbons disse: `` anúncio de hoje 'foi uma surpresa.
O Comitê de Remuneração proibirá os diretores da indústria de valores mobiliários de sentar -se nele.	A bolsa também disse que seu comitê de remuneração de cinco pessoas consistirá apenas de diretores de fora do setor de valores mobiliários.
As ações da LendingTree subiram US $ 6,21, ou 42 %, para US $ 20,90, depois de atingir US $ 21,36 antes.	As ações da LendingTree subiram 43 %, ou US $ 6,31, para US $ 21, mais do que dobrando nos últimos dois meses.
Na semana passada, seus advogados pediram a Warner que concedesse clemência sob condições que levariam a uma nova audiência de sentença.	Na semana passada, seus advogados perguntaram ao Gov. Mark r. Warner para conceder clemência, mas o governador se recusou a intervir.
P: Posso comprar cobertura para medicamentos prescritos imediatamente?	O Congresso adicionou um novo benefício - uma opção para comprar cobertura de seguro para medicamentos prescritos.
"Acho que deveria ter sido lançado anos atrás", disse Brian Rohrbough, cujo filho, Daniel, foi morto em Columbine.	Brian Rohrbough, cujo filho, Daniel, foi morto em Columbine, disse que a fita levanta questões perturbadoras.
O diretor da CIA, George Tenet, disse que os dois homens foram "definidos por dedicação e coragem".	"Eles foram definidos por dedicação e coragem", disse o diretor da CIA, George Tenet.
As ações da Mandalay fecharam oito centavos para US $ 29,42, antes que os ganhos fossem anunciados.	As ações da Mandalay fecharam 8 centavos em US $ 29,42 na quinta -feira.
Mas as receitas de licença de software, uma medida que os analistas financeiros observam de perto, diminuiu 21 %, para US $ 107,6 milhões.	As vendas de licenças, uma medida importante da demanda, caíram 21 %, para US $ 107,6 milhões.
Dotson, 21 anos, foi preso e acusado em 21 de julho, depois de dizer às autoridades que atirou em Dennehy depois que Dennehy tentou atirar nele.	Dotson foi preso em 21 de julho depois de dizer aos agentes do FBI que atirou em Dennehy quando Dennehy tentou atirar nele, de acordo com a declaração de mandado de prisão.
Os promotores sustentaram que o Sr. Durst planejou o assassinato para assumir o sr. Identidade de Black.	Os promotores sustentaram que Durst assassinou Black para tentar assumir a identidade de Black.
Essa objeção foi citada pelo conselho da PeopleSoft na rejeição da oferta da Oracle.	O conselho da PeopleSoft recomendou que os acionistas rejeitassem a oferta.
Vários líderes democratas negros estavam tentando organizar uma reunião com o presidente do DNC, Terry McAuliffe, para discutir as demissões.	Os líderes democratas negros estavam tentando organizar uma reunião com o presidente do Comitê Nacional Democrata, Terry McAuliffe, para discutir as demissões de 10 funcionários minoritários da sede do partido.
"Estes são dias sombrios para a nossa indústria", disse Giovanni Bisignani, diretor geral da organização de Genebra, em comunicado.	"Estes são dias sombrios para a nossa indústria", disse o diretor-geral da Associação Internacional de Transporte Aéreo de Genebra, Giovanni Bisignani.
As sete outras nações da iniciativa são a Grã -Bretanha, Alemanha, Itália, Holanda, Polônia, Portugal e Espanha.	Outras nações envolvidas no PSI incluem Alemanha, Itália, Holanda, Polônia, Portugal, Espanha e Grã -Bretanha.
O dólar estava em 116,92 ienes contra o iene, apartado na sessão e em 1.2891 contra o franco suíço, também plano.	O dólar estava em 116,78 ienes de jpy =, praticamente plano na sessão e em 1.2871 contra o franc chf =, queda de 0,1 %.
Os alemães representam mais de 40 % dos visitantes estrangeiros que chegam à Itália.	Os alemães representam mais de um quarto de todos os visitantes estrangeiros da Itália e 40 % das reservas de hotéis.
Também em Mosul, os pistoleiros rebeldes assassinaram na sexta -feira um líder tribal muçulmano sunita que apoiou a coalizão.	Perto de uma mesquita na cidade do norte de Mosul, pistoleiros rebeldes também assassinaram um líder tribal muçulmano sunita que apoiou a coalizão.
O americano médio faz quatro viagens por dia, 45 % para fazer compras ou recados.	Quase metade - 45 % - são para fazer compras ou executar recados.
senhor. Bush procurou armazenar seus documentos na biblioteca presidencial de seu pai, onde eles ficariam em segredo por meio século.	No Texas, grupos de vigilância pública se opuseram ao Sr. Os esforços de Bush para abrigar seus documentos na biblioteca presidencial de seu pai, onde eles permaneceriam em segredo por meio século.
Em 1999, os proprietários do edifício, a autoridade portuária de Nova York e Nova Jersey, emitiram diretrizes para atualizar a prova de fogo para uma espessura de 1 {polegadas.	O NIST descobriu que, em 1999, a Autoridade Portuária emitiu diretrizes para atualizar a prova de fogo para uma espessura de 1 /2 polegadas.
É também uma vitória estratégica para o Overture, já que Knight Ridder tinha a opção de assinar os serviços do Google.	É também uma vitória estratégica para o Overture, já que Knight Ridder estava usando os serviços de publicidade do Google.
Nas semanas que antecederam a execução, vários funcionários da Flórida receberam cartas ameaçadoras anônimas.	Vários funcionários da Flórida conectados ao caso receberam cartas ameaçadoras, acompanhadas de balas de rifle.
Isso se integra ao racional PurifyPlus e permite que os desenvolvedores trabalhem em versões suportadas de Java, Visual C # e Visual Basic .NET.	A IBM disse que os produtos racionais também foram integrados ao racional PurifyPlus, que permite que os desenvolvedores trabalhem em Java, Visual C # e VisualBasic .NET.
A audiência civil de Freeman pode estar, na superfície, sobre uma carteira de motorista.	Freeman disse que não ter uma carteira de motorista tem sido um fardo.
Os manifestantes estavam pedindo o fim do estabelecimento de linha dura do país e pela morte do supremo líder Khamenei.	Os manifestantes denunciaram o líder supremo do país, o aiatolá Ali Khamenei.
Hoy confirmou a idade da mulher na terça -feira e disse que saiu de férias com sua família.	Hoy confirmou a idade da mulher na terça -feira e disse que estava de férias com sua família, mas espera -se que volte esta semana.
Boston A arquidiocese católica em Boston ofereceu US $ 55 milhões para liquidar mais de 500 processos de abuso sexual de clero, de acordo com um documento obtido pela Associated Press.	A arquidiocese católica romana americana de Boston ofereceu US $ 55 milhões para liquidar mais de 500 processos de abuso sexual envolvendo padres.
As 3 {Horas de gravações incluem conversas entre policiais, bombeiros e outros trabalhadores de emergência, além de consultas de mídia.	Entre eles estão conversas entre policiais, bombeiros e outros trabalhadores de emergência, bem como consultas da mídia.
O título de 30 anos US30YT = RR saltou 20/32, levando seu rendimento para 4,14 %, ante 4,18 %.	O título de 30 anos US30YT = RR caiu 14/32 para um rendimento de 4,26 %, de 4,23 %.
Mas ele é o único candidato que ganhou endossos nacionais trabalhistas até agora, pegando seu 11º sindicato na terça -feira, quando os United Steelworkers of America o endossaram.	Mas ele é o único candidato que ganhou endossos nacionais do trabalho até agora, pegando seu 11º na terça -feira.
As ações da Oracle caíram 27 centavos, ou 2 %, para US $ 13,09.	As ações da Oracle também aumentaram as notícias, 15 centavos para US $ 13,51 no NASDAQ.
Os futuros da América do Norte apontaram para um começo de sub-par para negociar na terça-feira, com os investidores prontos para experimentar os ganhos trimestrais.	As bolsas de valores da América do Norte começaram lentamente na terça -feira, com os investidores prontos para experimentar os ganhos trimestrais.
Outro milhão de barris, comprado pelo refinador espanhol Cepsa SA, deveria ser carregado em um navio -tanque espanhol, o Sandra Tapias.	Sandra Tapias, um navio -tanque espanhol, deveria ser carregado com outro milhão de barris, comprado pelo refinador espanhol Cepsa SA, à tarde.
Cingapura já é o 12º maior parceiro comercial dos Estados Unidos, com negociação de mão dupla, totalizando mais de US $ 34 bilhões.	Embora seja uma pequena cidade-estado, Cingapura é o 12º maior parceiro comercial dos Estados Unidos, com volume comercial de US $ 33,4 bilhões no ano passado.
O dólar foi o último a US $ 1,1149 para o euro, próximo ao seu nível mais forte desde 30 de abril.	O dólar chegou a US $ 1,1115 para o euro no comércio inicial, estendendo -se de um por cento de terça -feira para atingir seu nível mais forte desde 30 de abril.
Os medidores mais amplos do mercado também registraram grandes ganhos, tendo subido mais alto por quatro semanas consecutivas.	O mercado mais amplo também se retirou, tendo subido mais alto por quatro semanas consecutivas.
Jim Furyk comemorou o dia de seu primeiro pai como pai ao vencer seu primeiro grande campeonato de golfe.	O dia de seu primeiro pai como pai, seu primeiro major como campeão.
Eles passaram pela Parceria Limitada Lemelson Medical, Educational and Research Foundation em 2001 para a Syndia.	Ele disse que as patentes foram "supostamente" designadas para a Syndia em 2001 através da parceria limitada da Lemelson Medical, Educational and Research Foundation.
A SIA diz que o mercado de DRAM deve crescer 2,9 %, para US $ 15,7 bilhões em 2003 e 43 %, para US $ 22,5 bilhões em 2004.	O mercado das Américas cairá 2,1 %, para US $ 30,6 bilhões em 2003, e depois crescerá 15,7 %, para US $ 35,4 bilhões em 2004.
A esposa de Morrill, Ellie, soluçou e abraçou a cunhada de Bondeson durante o culto.	Na viúva de Morrill, Ellie, soluçou e abraçou a cunhada de Bondeson, enquanto as pessoas a consolavam.
Depois de 9/11, Connolly disse, os agentes passaram milhares de horas investigando al-Bayoumi.	Connolly disse que os agentes do FBI em San Diego e no exterior passaram milhares de horas investigando al-Bayoumi.
Calvin Hollins Jr. O advogado, Thomas Royce, disse repetidamente que seu cliente não tinha vínculo com a empresa que possuía e operava a E2.	O advogado de Hollins Jr. , Thomas Royce, disse que seu cliente não tinha link para a empresa que possuía e operava a E2.
A moeda única aumentou até 135,13 ienes, combinando com um sucesso recorde logo após o lançamento do euro em janeiro de 1999.	A moeda única aumentou até 135,26 ienes, seu nível mais alto desde a introdução da moeda única em janeiro de 1999.
Uma nova mulher do condado de Castle se tornou a primeira paciente de Delaware a contrair o vírus do Nilo Ocidental este ano, informou o Departamento de Saúde do estado.	Um homem de 62 anos de idade, West Babylon, contratou o vírus do Nilo Ocidental, o primeiro caso humano no Condado de Suffolk este ano, de acordo com o Departamento de Saúde do Condado.
senhor. Grassley e Sr. Baucus rejeitou qualquer disparidade nos benefícios de drogas.	Grassley e Baucus disseram que rejeitaram essa abordagem em seu plano.
Ele também reafirmou seu desejo de resolver a crise nuclear norte -coreana pacificamente.	Mas a crise nuclear norte -coreana dominou seu tempo no cargo.
No trimestre do ano anterior, a siderúrgica registrou um lucro de US $ 16,2 milhões, ou 15 centavos por ação, em vendas de US $ 1,14 bilhão.	No segundo trimestre do ano passado, a AK Steel registrou um lucro de US $ 16,2 milhões, ou 15 centavos por ação.
PG&E Corp. As ações subiram 39 centavos ou 2,6 % a US $ 15,59 na Bolsa de Nova York na terça -feira.	As ações da PG&E ganharam 24 centavos para US $ 15,44 durante as negociações de terça -feira na Bolsa de Valores de Nova York.
O NASDAQ teve um ganho semanal de 17,27, ou 1,2 %, fechando em 1.520,15 na sexta -feira.	O Nasdaq Composite .ixic, com tecnologia, reuniu 30,46 pontos, ou 2,04 %, para 1.520,15.
"Esta decisão está claramente incorreta", disse o presidente da FTC, Timothy Muris, em comunicado por escrito.	A decisão é "claramente incorreta", disse o presidente da FTC, Tim Muris.
Um rebelde capturado disse que mais de 2.000 insurgentes estavam envolvidos no ataque.	Um rebelde capturado disse que 2.100 combatentes estavam envolvidos na ofensiva.
"Foi intimidação descarada manter as pessoas na reserva", disse um republicano que participou, mas não queria ser identificado.	"Foi uma tentativa descarada de intimidação", disse um legislador republicano que participou da reunião.
Nenhuma acusação foi anunciada, mas o comunicado disse que os procedimentos legais eram esperados na segunda -feira.	Um comunicado do FBI disse que os procedimentos legais eram esperados na segunda -feira no tribunal federal em Baltimore.
A mulher morta também estava usando um anel e um relógio mais caretivo.	"É uma mulher de cabelos loiros vestindo um relógio mais Cartier no pulso", disse a fonte.
O índice composto da Tech-Heavy Nasdaq Mercats Composite adicionou 14,17 pontos ou 0,94 %, para 1.517,05.	Ultimamente, o NASDAQ Composite Index, cheio de ações de tecnologia, subiu em torno de 18 pontos.
Paul Themba Nyathi, porta -voz do MDC, disse que a clínica das avenidas estava sendo alvo porque estava tratando os apoiadores da oposição.	O porta -voz do MDC, Paul Themba Nyathi, disse que a clínica das avenidas foi alvo porque estava lidando com apoiadores da oposição.
Kyi, uma ONU. O enviado diz que, como o Japão aumenta a pressão internacional, dizendo que interrompe sua grande ajuda econômica, a menos que Suu Kyi seja libertado.	O Japão aumentou a crescente pressão internacional sobre a Birmânia ontem, ameaçando interromper sua grande ajuda econômica, a menos que o governo militar divulgasse o líder pró-democracia Aung San Suu Kyi.
Ele afirma que pode parecer irrealista apenas porque pouco esforço foi dedicado ao conceito.	"Esta proposta é modesta em comparação com o programa espacial e pode parecer irrealista apenas porque pouco esforço foi dedicado a ele.
Mas o FBI nunca ficou de olho em al -Bayoumi - apesar de ter recebido informações de que ele era um agente saudita, diz o documento.	Mas o Bureau nunca se manteve no alcance de al-Bayoumi-apesar de receber informações anteriores, ele era um agente saudita secreto, diz o relatório.
"Isso vai acontecer", disse Jim Santangelo, presidente do Conselho Conjunto de Teamsters 42 em El Monte.	"Isso realmente afeta as empresas, o grande momento", disse Jim Santangelo, presidente do Conselho Conjunto de Teamsters 42 em El Monte.
Wal-Mart, Kohl's Corp. , Family Dollar Stores Inc. e Big Lots Inc. estavam entre os comerciantes que a publicação pode ser vendas que caíram abaixo das modestas expectativas de Wall Street.	Wal-Mart, corp de Kohl. , Family Dollar Stores Inc. e Big Lots Inc. Publicado as vendas de maio que caíram abaixo das modestas expectativas de Wall Street.
Ele foi libertado sob fiança de US $ 3 milhões e imediatamente retornou a Las Vegas, onde estava filmando um vídeo.	Depois de pagar uma fiança de US $ 3 milhões, Jackson voou para Las Vegas, onde estava trabalhando em um vídeo.
Os analistas do Gartner disseram que as empresas ainda não estão se sentindo confiantes o suficiente para atualizar os PCs corporativos.	O que é mais, as empresas não estão se sentindo confiantes o suficiente para substituir os PCs mais antigos, disse a empresa de analista.
Eddington alertou ontem que o futuro da companhia aérea estava "nas mãos dos negociadores".	"O futuro da BA está nas mãos dos negociadores", disse Eddington à British Broadcasting Corp. Televisão no domingo.
Na terça-feira, quase 250 trabalhadores de saúde estavam em quarentena.	Além disso, 6.800 pessoas estavam em quarentena e milhares de profissionais de saúde em quarentena de trabalho.
"Ambas as crianças estão em maravilhosas condições físicas no momento", disse ele durante um coletor de imprensa no hospital.	"Ambas as crianças estão em maravilhosas condições físicas no momento", disse Goodrich, também diretor de neurocirurgia pediátrica do Hospital Infantil em Montefiore.
Brian Brabazon disse que seu filho ficaria chateado, mas depois se vira e fez amizade com seus turistas.	O filho dela ficava chateado, disse a mãe, mas depois se virava e fazia amizade com seus turistas.
O índice composto de bolsas de valores da NASDAQ com tecnologia de tecnologia adicionou 1,16 pontos a 1.504,04.	Ultimamente, o NASDAQ Composite Index, cheio de ações de tecnologia, subiu em torno de 18 pontos.
O índice de composto NASDAQ com tecnologia caiu 0,08 de um ponto para 1.646.	O índice de composto NASDAQ com tecnologia <.ixic> adicionou 1,92 pontos, ou 0,12 %, em 1.647,94.
Sim entrou com uma ação ontem na Suprema Corte do Condado de Nova York, em Manhattan.	O processo foi arquivado na Suprema Corte do Condado de Nova York.
Ele disse ao Júri Stubbs um "assassino frio e calculista".	O promotor Dave Lupas lembrou aos jurados que Stubbs é "um assassino frio e calculador".
Da mesma forma, o título de 30 anos <US30YT = RR> deslizou 1-11 / 32 para um rendimento de 4,38 %, acima dos 4,30 %.	O título de 30 anos US30YT = RR saltou 20/32, levando seu rendimento para 4,14 %, ante 4,18 %.
Uma sétima vítima, uma mulher, morreu na noite de terça -feira na unidade de queima no Centro Médico do Hospital Childrens, em Akron.	Uma sétima pessoa, uma mulher de 21 anos, estava em estado crítico na unidade de queima do Hospital das Crianças Akron.
Os homens foram imediatamente levados para o Botsuana nas proximidades em um voo fretado no Air Malawi, disseram autoridades de inteligência do Malawi sob condição de anonimato.	Os homens foram levados para o Botsuana nas proximidades em um voo Air Malawi, disseram as autoridades.
Ele receberá US $ 395.000 por ano, acima do salário atual de Atkinson de US $ 361.400.	A Dynes receberá US $ 395.000 por ano; O salário de Atkinson é de US $ 361.400.
Na superfície da célula, os componentes estrangeiros são reconhecidos por outras células que percebem que está infectada e a matam.	Os bits estrangeiros são reconhecidos por outras células que percebem que são infectadas e matam.
Em troca, a Coréia do Norte seria obrigada a encerrar seu programa de armas nucleares.	"Em troca, esperamos que a Coréia do Norte desista de armas nucleares".
"Condenamos e denunciamos o Conselho de Administração, que é chefiado pelos Estados Unidos", disse Moqtada al-Sadr.	"Condenamos o Conselho de Administração liderado pelos Estados Unidos", disse Sadr em um sermão ardente na Mesquita Koufa, perto de Najaf.
Sendmail disse que o sistema pode até ser configurado para permitir o uso apenas de negócios.	O produto pode ser instruído a permitir o uso apenas para negócios, de acordo com o Sendmail.
Sua filha, Nina Axelrod, disse à Associated Press que ele morreu durante o sono, aparentemente de insuficiência cardíaca.	Axelrod morreu em seu sono de insuficiência cardíaca, disse sua filha, Nina Axelrod.
Essa exploração funciona em máquinas Windows 2000 não capacitadas com o Service Pack 3 e 4.	Tanto o contrapane quanto o IDEFense afirmam que a exploração funciona efetivamente contra o Windows 2000 Systems, executando o serviço de serviço 3 e 4.
Além da curva, a nota de referência de 10 anos US10YT = RR derramou 25/32 de preço, aumentando o rendimento para 3,26 %, ante 3,17 %.	No início da quarta-feira, a referência de 10 anos de 10 anos = RR perdeu 16/32 de preço, aumentando seu rendimento para 3,33 %, ante 3,26 % na terça-feira.
Os estoques de tecnologia foram prejudicados por uma previsão azeda da Sun Microsystems, que foi vista como um mau presságio para a próxima temporada de ganhos trimestrais.	Uma previsão azeda da Sun Microsystems Inc. Sunw.O colocou mais pressão em Wall Street antes da temporada de ganhos trimestrais.
As negociações em Loral foram interrompidas ontem; As ações fecharam na segunda -feira a US $ 3,01.	A Bolsa de Nova York suspendeu as negociações ontem em Loral, que fechou em US $ 3,01 na sexta -feira.
As ações da Coca -Cola subiram 6 centavos em US $ 44,42 nas negociações da tarde na quarta -feira na Bolsa de Nova York.	As ações da Coca -Cola caíram 26 centavos para fechar em US $ 44,10 na Bolsa de Valores de Nova York.
Ernst & Young negou qualquer irregularidade e planeja combater as alegações.	Ernst & Young negou as reivindicações da SEC e chamou suas recomendações de "irresponsável".
Nem a ação militar nem o suborno em larga escala podem resolver o problema norte-coreano, disse Wolfowitz.	De fato, Wolfowitz admitiu no sábado que nem a ação militar nem o "suborno em larga escala" resolveriam a questão.
O motorista, Eugene Rogers, ajudou a remover as crianças do ônibus, disse Wood.	Na cena do acidente, o motorista estava "coberto de sangue", mas ajudou a remover crianças, disse Wood.
O índice mais amplo do Standard & Poor's 500 <.spx> subiu 9,69 pontos, ou 0,98 %, em 994,53.	O índice de composto NASDAQ com tecnologia <.ixic> ganhou 18,35 pontos, ou 1,13 %, para 1.646,02.
O Departamento de Saúde do Condado de Knox está seguindo os Centros Nacionais de Controle de Doenças e Protocolo de Prevenção para conter infecções.	O porta -voz do Departamento de Saúde acrescentou que o departamento está seguindo os Centros de Protocolo de Controle de Doenças.
As ações da Guidant despejaram as negociações dentro e fora da Bolsa de Valores de Nova York antes que uma interrupção fosse imposta após o meio -dia.	As ações da Guidant caíram 5,3 % em US $ 40,92 nas negociações da tarde na Bolsa de Nova York.
"Três semanas em outubro" estará à venda na segunda-feira, quase um ano após o início dos tiroteios de atiradores de atiradores da área de Washington, DC.	O livro de Moose está à venda na segunda -feira, quase um ano após o início dos tiroteios na área de Washington.
As mortes em acidentes de capotagem representaram 82 % do número de mortes no trânsito em 2002, diz a agência.	As mortes nos acidentes de rolagem representaram 82 % do aumento em 2002, disse a NHTSA.
Com base em uma pesquisa separada das famílias, a taxa de desemprego caiu em agosto para 6,1 %, de 6,2 %.	Os analistas do Departamento do Trabalho descontaram uma ligeira melhora na taxa de desemprego nacional, que caiu em agosto para 6,1 % para 6,2 %.
A libra também fez progressos em relação ao dólar, atingiu novas notas de três anos em US $ 1,6789.	A libra britânica flexionou seu músculo em relação ao dólar, durar 1 % a US $ 1,6672.
O chanceler das escolas Joel Klein disse que o esforço para padrões e responsabilidade mais altos "está mostrando resultados".	O chanceler das escolas Joel Klein disse que ficou satisfeito com os resultados.
A taxa de câncer de pele triplicou desde a década de 1950 na Noruega e na Suécia, de acordo com o estudo.	O estudo também descobriu que o câncer de pele quase triplicou na Noruega e na Suécia desde a década de 1950.
Uma testemunha disse à Anatólia que viu o avião pegando fogo enquanto ainda estava no ar.	Uma testemunha disse à agência de notícias da Anatólia que viu o avião em chamas no ar.
O juiz também se recusou a adiar a data do julgamento de setembro. 29.	Obus também negou uma moção de defesa para adiar o setembro. 29 Data do julgamento.
Embora os partidos da oposição tenham recebido a decisão do gabinete sobre tratamento anti-retroviral, alguns disseram que o ministro da Saúde Manto Tshabalala-Msimang não estava apto a presidir um plano de lançamento.	O ministro da Saúde Manto-Tshabalala Msimang não é adequado para presidir um plano de lançamento de tratamento anti-retroviral, de acordo com alguns partidos da oposição.
A Associação da Indústria de Gravação da América diz que planeja processar os comerciantes de músicas no próximo mês.	Ou seja, se a Associação da Indústria de Gravação da América tiver algo a dizer sobre isso.
Os principais oficiais de merchandising supervisionam a compra e o desenvolvimento de mercadorias, decidindo a direção do merchandising da empresa, ou basicamente o que deve representar.	Ele ou ela decide a direção de merchandising da empresa, ou basicamente o que ela deve representar.
o REV. Christopher j. Coyne, porta -voz da arquidiocese, não comentaria na sexta -feira.	o REV. Christopher Coyne, porta -voz da arquidiocese, não retornou imediatamente várias ligações em busca de comentários.
O Índice 500 do Standard e Poor Standard & Poor <.spx> facilitou 7,57 pontos, ou 0,76 %, em 990,94.	O índice de composto NASDAQ com tecnologia caiu 25,36 pontos, ou 1,53 %, em 1.628,26.
Vários parentes de vítimas australianas do ataque estavam no tribunal para testemunhar o processo, mas poucos balineses compareceram ao julgamento.	Vários parentes de vítimas australianas do ataque ficaram na primeira fila do tribunal, mas poucos balineses compareceram ao julgamento.
Em 10 de julho, uma equipe de 32 policiais de Cingapura foi enviada para Bagdá.	Em 32, os policiais de Cingapura foram enviados a Bagdá para ajudar a treinar forças policiais iraquianas e voltar para casa no mês passado.
O euro <eur => subiu 0,67 % em relação ao dólar a US $ 1,1784, depois de subir para uma alta de três meses na sessão acima de US $ 1,18.	No início dos EUA Negociação, o euro <eur => caiu 0,6 %, para US $ 1,1741, depois de subir para uma alta de quatro meses de US $ 1,1860.
Anteriormente, ele havia relatado um lucro de US $ 12 milhões, ou 0 centavos por ação, para esse período.	Anteriormente, ele havia relatado um pequeno lucro de US $ 12 milhões, ou o ponto de equilíbrio por ação, para o período.
Na quinta -feira, PeopleSoft rejeitou formalmente a oferta não solicitada da Oracle.	Na quinta -feira de manhã, o conselho da PeopleSoft rejeitou a oferta de aquisição da Oracle.
Uma coalizão de grupos de campanha, incluindo o órgão militante dos estudantes nacionais, está apoiando os protestos, que a NLC chamou em desafio a uma ordem judicial que os proibiu.	Uma coalizão de grupos de campanha, incluindo o órgão militante dos estudantes nacionais, está apoiando a ação e está se mobilizando para protestos.
A empresa está destacando a adição do suporte .NET e J2EE ao seu ambiente de aplicativos corporativos (EAE) com o novo mainframe.	A empresa também está adicionando suporte .NET e J2EE ao seu conjunto de ferramentas de desenvolvimento de ambiente de aplicativos corporativos, disse Sapp.
Ele propôs um sistema sob o qual levaria cada vez menos votos para superar um filibuster.	Frist propôs um processo no qual seria necessário gradualmente menos votos para superar os filibusters, impedindo os votos finais sobre confirmações judiciais.
Desde que foi convocado para o serviço em 1971, ele acumulou 45 acidentes, com 393 mortes.	Possui um registro de segurança quadriculado, incluindo 47 acidentes que resultaram em 668 mortes.
Ryan Harvey, um defensor da Dunedin High School, na Flórida, foi selecionado com a sexta escolha pelo Chicago Cubs.	Ryan Harvey, um defensor do ensino médio da Flórida, foi escolhido em sexto pelos Cubs.
Glover falou em uma entrevista coletiva que incluiu cerca de 20 parentes das vítimas.	Cerca de 20 membros da família das vítimas foram convidados para a entrevista coletiva.
Quatro outros homens que também foram acusados ​​em junho já se declararam culpados.	Quatro dos réus se declararam culpados de acusações de armas e outras acusações.
Ambos os artigos estão sendo publicados hoje no New England Journal of Medicine.	O estudo aparece hoje no New England Journal of Medicine.
Os governos federais e locais permaneceram em grande parte fechado após o furacão Isabel, assim como as escolas, e grande parte da rede de transporte da região foi desacelerada.	Após o furacão Isabel, os governos federais e locais permaneceram fechados, assim como as escolas e muitas empresas.
A terapia de reposição hormonal que combina estrogênio e progestina dobra o risco de câncer de mama de uma mulher, encontrou um estudo britânico de mais de um milhão de mulheres.	Um grande estudo britânico acrescentou às evidências de que a terapia de reposição hormonal aumenta o risco de câncer de mama, especialmente quando as mulheres recebem uma combinação de estrogênio e progestina.
Ele fez um discurso surpreendentemente apaixonado aos United Steelworkers of America, que anunciaram seu apoio ontem.	Na terça -feira, ele pegou o endosso dos United Steelworkers of America.
Cerca de 50 milhões de números de telefone estão registrados na lista, que entraria em vigor em outubro. 1.	A FTC assinou 50 milhões de números de telefone para a lista, que deveria entrar em vigor em 1º de outubro.
"E cerca de oito a 10 segundos, eu bati.	"Eu estava na água por cerca de oito segundos.
Mas Adora Obi Nweze, presidente do Estado da NAACP, disse que o estado só tentou provar sua conclusão de suicídio, em vez de considerar a possibilidade de assassinato.	Adora Obi Nweze, presidente do Estado da NAACP, disse que o estado se recusou a considerar a possibilidade de assassinato.
Os especialistas da OMS não disseram quantos casos em Hebei estavam em áreas rurais.	Hebei relatou 191 casos e oito mortes, embora os especialistas da OMS não tenham dito quantos estavam nas áreas rurais.
Ativistas dizem que temem que a reunião seja uma tentativa da agricultura corporativa de empurrar as culturas bio-engenhadas para os países famintos.	Em vez disso, eles temem que a conferência seja uma tentativa da agricultura corporativa e dos interesses de biotecnologia de entrar em novos mercados.
Seu contrato expirará às 12: 01 da manhã de quarta -feira, em vez das 12: 01:00 no domingo, disse Rian Wathen, diretor organizador da United Food and Commercial Workers Local 700.	"Isso ultrapassou os membros", disse Rian Wathen, diretor organizador da United Food and Commercial Workers Local 700.
O índice de composto Nasdaq, com tecnologia, subiu 39,39 pontos, ou 2,2 %, para 1.826,33, depois de perder mais de 2 % na terça-feira.	O blue-chip Dow Jones Industrial Average .dji saltou 194,14 pontos, ou 2,09 %, para 9.469,20 depois de afundar mais de 1 % no dia anterior.
Cerca de 14.000 clientes estavam sem energia na área, disseram Oklahoma Gas e Electric.	Cerca de 38.000 OGE Energy Corp. Os clientes não têm energia, disse a empresa em seu site.
Agora, o marido americano de Blanca, Roger Lawrence Strunk, de 63 anos, enfrenta uma acusação de assassinato emitida em fevereiro pelo governo das Filipinas, que diz que é o principal suspeito.	Agora, o marido de Blanca, Roger Lawrence Strunk, de 63 anos, enfrenta uma acusação de assassinato emitida pelo governo das Filipinas em fevereiro.
Os comentários de Barbatini vieram terça -feira, o segundo dia da Conferência Ministerial e da Exposição sobre Ciência e Tecnologia Agrícola.	nós. O secretário da Agricultura, Ann Veneman, inicia a conferência ministerial de três dias e a exposição sobre ciência e tecnologia agrícola na segunda-feira.
Ontem, as ações fecharam 29 centavos, ou 0,54 %, a US $ 54,32.	As ações da Amazon fecharam ontem a US $ 54,32 no mercado de ações da NASDAQ, um aumento de 29 centavos.
Prince está substituindo Sanford "Sandy" Weill, que continuará sendo o presidente do Citigroup.	Prince, que lidera o Banco Corporativo e de Investimentos Global do Citigroup, está substituindo Sanford Weill como CEO.
As receitas operacionais foram de US $ 1,45 bilhão, um aumento em relação ao resultado do ano passado de US $ 1,38 bilhão.	As receitas operacionais subiram para US $ 1,45 bilhão de US $ 1,38 bilhão no ano passado.
O Gold Spot foi citado em US $ 367,90 / 368,60 a uma onça a 1000 GMT, tendo marchar até US $ 369,50 - um nível não visto desde 10 de fevereiro.	O Gold Spot foi citado em US $ 358,65 / 359,15 a uma onça a 0500 GMT, tendo disparado até US $ 359,25 - um nível não visto desde 25 de fevereiro.
No Canadá, o dólar em expansão estará em foco novamente, enquanto tenta permanecer acima da marca de 75 centavos (EUA).	No Canadá, o dólar crescente estava em foco novamente, pois lutou e não ficou acima da marca de 75 centavos (EUA).
Mas os juízes decidiram que o supervisor da polícia que questionou repetidamente Martinez não violou seus direitos da Quinta Emenda ao fazê -lo.	Mas os juízes decidiram que o supervisor da polícia que questionou repetidamente Martinez enquanto gritava de dor não violava seus direitos da Quinta Emenda.
Lawtey não é o primeiro programa baseado na fé no sistema prisional da Flórida.	Mas Lawtey é a primeira prisão inteira a seguir esse caminho.
"Eu não desejo estar presente durante esta testemunha", disse ele ao juiz Al Girolami do Tribunal Superior do Condado de Stanislaus.	"Sim, eu não desejo estar presente durante esta testemunha", Peterson, 31, disse calmamente ao juiz quando ele foi devolvido à sua cela.
A média industrial do blue-chip Jones diminuiu 44 pontos, ou 0,47 %, para 9.543, depois de marcar cinco sessões consecutivas.	A média industrial da Dow Jones .dji subiu 18,25 pontos, ou 0,19 %, para 9.586,71.
O presidente do centro, Joseph Torsella, foi atingido na cabeça, mas foi capaz de caminhar até uma ambulância.	O presidente do Centro Nacional de Constituição, Joseph Torsella, foi atingido na cabeça e bateu de joelhos.
O relatório classificou 45 grandes empresas com base em emprego, marketing, compras, reinvestimento da comunidade e doações de caridade.	Desses três, apenas Dillard respondeu à pesquisa que classificou 45 grandes empresas em emprego, marketing, compras, reinvestimento da comunidade e doações de caridade.
"Eu não sei se a pessoa com quem estou conversando agora pode acabar sendo outra pessoa em outro momento que pode não seguir as regras", disse Parrish.	"Eu não sei se a pessoa com quem estou falando agora pode acabar sendo outra pessoa", disse Parrish.
Ruffner, 45 anos, ainda não tem um advogado na acusação de assassinato, disseram as autoridades.	Ruffner, 45 anos, não tem um advogado sobre a acusação de assassinato, disseram as autoridades.
Eles estão sendo mantidos por violações da imigração à medida que o incidente é investigado.	Ambos os homens estão sendo mantidos para investigação de violações administrativas de imigração.
Passado em 1999, mas nunca colocou em vigor, a lei teria tornado ilegal que os clientes de bar e restaurante se iluminassem.	Passado em 1999, mas nunca foi efetivado, a lei de fumantes teria impedido que os clientes de bar e restaurante se iluminassem, mas isentaram clubes particulares do regulamento.
A transação concederá aos acionistas da Handspring 0,09 de uma ação da Palm-e nenhuma ação da Palmsource-para cada ação ordinária da Handspring.	Sob os termos propostos da transação e, após o spinoff do PalmSource, a Palm trocará 0,09 ações por cada parcela da Handspring.
O relatório mostra que os medicamentos vendidos nas farmácias canadenses são fabricados em instalações aprovadas pela Health Canada - a contraparte da FDA no Canadá.	O relatório mostra que os medicamentos vendidos nas farmácias canadenses são fabricados em instalações aprovadas pela Health Canada, que desempenha um papel semelhante ao da FDA para o governo canadense.
O primeiro julgamento de um suspeito nos atentados de boates de Bali, no ano passado, que matou mais de 200 pessoas abertas na Indonésia hoje, informou a Sky News.	Um dos principais suspeitos nos atentados de boates de outubro que matou mais de 200 pessoas em Bali foi julgado na segunda -feira em meio a uma segurança rígida.
Os aposentados franceses aumentarão de um quinto para um terço da população até 2040.	Até 2040, os aposentados serão responsáveis ​​por um terço da população, acima de um quinto hoje.
A polícia iraquiana abriu fogo no centro de Bagdá hoje, depois que os manifestantes invadiram uma delegacia exigindo que eles recebessem empregos pelos quais alegavam ter pago subornos.	A polícia iraquiana abriu fogo no centro de Bagdá na quarta -feira, depois que manifestantes exigindo empregos invadiram uma delegacia e jogavam pedras em policiais, informou a polícia.
A média industrial da Dow Jones <.dji> acrescentou 28 pontos, ou 0,27 %, a 10.557, atingindo seu nível mais alto em 21 meses.	A média industrial da Dow Jones <.dji> subiu 49 pontos, ou 0,47 %, para 10.578.
Durante o mesmo trimestre do ano passado, a EDS declarou um lucro de US $ 354 milhões, ou 72 centavos por ação.	A EDS registrou uma perda no primeiro trimestre de US $ 126 milhões, ou 26 centavos por ação.
A Microsoft caiu 5 % antes do aberto para US $ 27,45 a partir do fechamento de US $ 28,91 de quinta -feira.	As ações da Microsoft caíram 4,7 % na negociação após o horário comercial, para US $ 27,54 em um fechamento da NASDAQ de US $ 28,91.
"Isso é extraordinariamente rápido", disse Matt Geller, analista da CIBC World Markets.	Na verdade, eles vão gravar vendas para a Velcade este ano ", disse Matt Geller, analista da CIBC World Markets.
O Giant Rock foi observado pela primeira vez em 24 de agosto pelo Programa de Pesquisa de Asteróides de Lincoln, perto da Terra, com sede em Socorro, Novo México.	A rocha foi observada pela primeira vez pelo programa de pesquisa de asteróides da Terra, também conhecido como linear.
Os rebeldes e as forças do governo foram acusados ​​de pilhar aldeias no campo da Libéria, apesar do acordo de paz.	Os rebeldes e as forças do governo, incluindo os Loyald a Taylor, foram acusados ​​de pilhar aldeias no campo da Libéria, apesar de um acordo de paz.
A Microsoft recebeu uma patente por um recurso em mensagens instantâneas que alerta um usuário quando a pessoa com quem está se comunicando está inserindo uma mensagem.	A Microsoft recebeu uma patente em um recurso popular de mensagem instantânea que mostra aos usuários quando a pessoa do outro lado da conversa está digitando uma mensagem.
quem terá sucesso sr. O 'Neill na Hyundai não está claro.	Não há sucessor claro para MR. O 'Neill em Hyundai.
"Precisamos mudar de hábitos antigos e repensar seriamente os negócios como de costume".	Ele pediu aos funcionários que "evitem complacência" e "mudassem de hábitos velhos e repensem seriamente os negócios como de costume".
As prisões revelaram novos detalhes sobre a investigação de quatro meses na casa de Selenski, Mount Olivet Road.	Os corpos de Kerkowski e Fassett foram desenterrados na casa de Selenski, Mount Olivet Road em 5 de junho.
Pretendemos apelar vigorosamente e ainda esperamos ser justificada em última análise.	Achamos que isso foi uma lei ruim, e ainda esperamos ser justificada em última análise.
"Esses atos desprezíveis foram cometidos por assassinos cuja única fé é o ódio", disse Bush, acrescentando que os Estados Unidos encontrarão os assassinos.	Esses atos desprezíveis foram cometidos por assassinos cuja única fé é o ódio e os Estados Unidos encontrarão os assassinos e aprenderão o significado da justiça americana.
De acordo com a lei do Kansas, é ilegal para crianças menores de 16 anos terem relações sexuais.	Na opinião, Kline observou que é ilegal para crianças que jovens tenham relações sexuais.
A transação expandirá as receitas de vendas da Callebaut do negócio de produtos de consumo para 45 %, de 23 %.	A transação expandirá as receitas de vendas da Callebaut do negócio de produtos de consumo em cerca de 45 % para um terço do total de vendas.
O exército da Indonésia tem sido frequentemente acusado de violações de direitos humanos durante a batalha de Gam pela independência, acusações geralmente negadas ao acusar os separatistas de cometer violações de direitos.	O exército da Indonésia foi acusado de violações de direitos humanos durante suas batalhas anteriores com o GAM, acusações que geralmente negam.
A economia do Iraque foi devastada durante anos de ONU. Sanções sobre o ex-presidente da ocupação do Kuwait, de Saddam Hussein, de 1990, e pela guerra liderada pelos EUA, para expulsá-lo, que terminou em abril.	A economia do Iraque foi destruída pelo ex-presidente Saddam Hussein e pela guerra liderada pelos EUA para expulsá-lo, que terminou em abril.
Um também apontou para a palavra refugiada em um dicionário inglês / turco.	Um homem havia brandido um dicionário inglês-turco e apontou a palavra "refugiado".
A maior parte dos fundos, cerca de US $ 65 bilhões, optará por operações militares no Iraque e no Afeganistão.	A maior parte do projeto - US $ 64,7 bilhões - vai para operações militares principalmente no Iraque e no Afeganistão.
sob os EUA A Constituição, a outra Câmara do Congresso, a Câmara dos Deputados, não vota em alianças estrangeiras.	os EUA A Câmara dos Deputados, a outra Câmara do Congresso, não vota em tratados.
Dolores Mahoy, 68, de Colorado Springs, Colorado. , é alguém que pode ser ajudado pela legislação pendente no Congresso.	Dolores e. Mahoy, 68, de Colorado Springs é apenas o tipo de pessoa que pode ser ajudada pela legislação pendente no Congresso.
A Comissão de Valores Mobiliários também iniciou uma investigação informal da Coca -Cola.	Essa investigação federal é separada de uma investigação informal da Comissão de Valores Mobiliários.
As questões avançadas superaram em número os declinadores cerca de 8 a 5 na Bolsa de Valores de Nova York.	As questões em declínio superaram em número os avançados um pouco mais de 3 a 1 na Bolsa de Valores de Nova York.
Há um total de 659 mulheres matriculadas na Academia, segundo o relatório.	Havia 659 mulheres matriculadas na academia no momento da pesquisa.
É uma preocupação nacional que tocará praticamente todos os americanos ", disse Abraham.	O impacto da escassez de gás natural "tocará praticamente todos os americanos", alertou o secretário de Energia Spencer Abraham ontem.
Um concurso de beleza a ser realizado na Itália na próxima semana pode ser o primeiro para pin-ups perfeitos para pixels.	Um novo concurso de beleza começando na Itália na próxima semana dará aos pin-ups perfeitos de pixel a chance de roubar o status de símbolo sexual de Sophia.
Nos Estados Unidos, 20,7 % de todas as mulheres fumam.	Nevada é onde a maioria das mulheres fuma, 28 %.
A estimativa de consenso dos analistas da primeira chamada Thomson foi uma perda de US $ 2,08 por ação, excluindo itens únicos.	A estimativa dos analistas pesquisados ​​por Thomson Primeira chamada foi por uma perda de US $ 2,75 por ação.
Lee Janzen, que estava empatado no topo da tabela de classificação com cinco buracos restantes, terminou com um 68 e empatado em sexto.	Lee Janzen, empatado no topo da tabela de classificação com cinco buracos restantes, terminou com um 68 para empatar em sexto com Bob Crane (67) em 269.
A Tenet está sob escrutínio desde novembro, quando o ex -executivo -chefe Jeffrey Bábakow disse que a empresa usou preços agressivos para desencadear pagamentos mais altos para os pacientes mais doentes do Medicare.	Em novembro, Jeffrey Brabakow, diretor executivo da época, disse que a empresa usou preços agressivos para obter pagamentos mais altos para os pacientes mais doentes do Medicare.
O Conselho da Boeing também deve decidir em sua reunião de dezembro oferecer o avião à venda às companhias aéreas.	Espera -se amplamente dar aprovação formal de Bair para oferecer o avião à venda às companhias aéreas.
Bush disse que forças de resistência hostis para os EUA Presença "Sinto como ... as condições são tais que podem nos atacar lá.	Há quem sente que as condições são tais que podem nos atacar lá.
Tem uma margem de erro de mais ou menos 4 pontos percentuais.	Essa pesquisa teve 712 prováveis ​​eleitores e erro de amostragem de mais ou menos 3,7 pontos percentuais.
Os advogados de defesa disseram que uma mudança de local era necessária porque a grande publicidade pré -julgamento havia contaminado o júri contra seu cliente.	Os advogados de defesa haviam solicitado uma mudança de local por dois motivos: eles argumentaram que a grande publicidade pré -julgamento havia contaminado o júri contra seu cliente.
Fundada em 1996, o LendingTree Exchange consiste em mais de 200 bancos, credores e corretores.	O LendingTree corresponde aos mutuários pela Internet com mais de 200 corretores hipotecários, bancos e outros credores.
A maioria dos contribuintes receberá cortes de impostos surpresa entre US $ 4 e US $ 11 por semana a partir de 1º de julho.	Os 9 milhões de contribuintes de renda da Austrália receberam cortes de impostos surpresa entre US $ 3 e US $ 11 por semana do tesoureiro Peter Costello na noite passada.
As ações da MONY estavam ganhando US $ 2,57, ou 9 %, para US $ 31,90 em negociações após o horário comercial no Instinet.	As ações de Mony subiram 8,76 %, para US $ 31,90 em negociações após o horário comercial em Nova York.
Gyorgy Heizler, chefe da unidade de desastre local, disse que o treinador estava carregando 38 passageiros.	O chefe da unidade de desastre local, Gyorgy Heizler, disse que o motorista do treinador não prestou atenção aos semáforos vermelhos.
As mensalidades em faculdades particulares de quatro anos tiveram uma média de US $ 19.710 este ano, um aumento de 6 % em relação a 2002.	Para o atual ano acadêmico, as mensalidades em faculdades públicas foram obtidas em média de US $ 4.694, quase US $ 600 em relação ao ano anterior.
A taxa de desemprego em todo o estado caiu para 6,4 %, abaixo dos 6,7 % revisados ​​em agosto.	A taxa de desemprego no condado de San Joaquin caiu no mês passado para 8,5 %, quase um ponto percentual completo em relação a agosto.
Diana estava em seu refrigerante mais baixo quando escreveu a carta a Paul Burrell alegando que havia uma trama para matá -la.	Burrell disse que Diana escreveu uma carta em outubro de 1996, alegando que havia uma trama para matá -la em um esmagamento e deu a ele para manter como seguro.
As luzes de segurança também foram instaladas e a polícia varreu o terreno para armadilhas.	As luzes de segurança também foram instaladas em um celeiro perto do portão da frente.
Mas EUA As tropas não encolhem a montagem de ataques e atacam seus inimigos quando seus locais puderem ser identificados.	Mas as tropas americanas não diminuem de montar ataques nos locais de seus inimigos que podem ser identificados.
Moore não teve comentários imediatos na terça -feira.	Moore não teve uma resposta imediata na terça -feira.
Um juiz ordenou que a criança colocada sob custódia do estado agosto. 8.	em agosto. 8, o juiz do tribunal juvenil Robert Yeates ordenou que Parker fosse colocado sob custódia protetora.
Gillespie enviou uma carta ao presidente da CBS, Leslie Moonves, pedindo uma revisão histórica ou um aviso.	O presidente do Comitê Nacional Republicano, Ed Gillespie, emitiu uma carta na sexta -feira ao presidente da CBS Television, Leslie Moonves.
Mas o porta-voz da Casa Branca, Ari Fleischer, disse ontem: "Os passos que os iranianos afirmam ter tomado em termos de captura de al-Qa 'IDA são insuficientes".	"As medidas que os iranianos afirmam ter tomado em termos de captura de Al Qaeda são insuficientes.
Dotson foi preso na segunda -feira em sua terra natal, Maryland e acusada de assassinato.	Dotson, 21, foi posteriormente acusado do assassinato de Dennehy.
O banco também disse que sua oferta estava sujeita ao contrato dos bancos seniores de Drax, titulares sênior de títulos e bancos de hedge até 30 de setembro de 2003.	A oferta também está sujeita a Goldman assinando um acordo com os bancos seniores da Drax, os titulares de títulos e os bancos de hedge até setembro. 30, dizia.
Os resultados foram divulgados na reunião de terça -feira em Seattle da American Thoracic Society e serão publicados no New England Journal of Medicine de quinta -feira.	Os resultados do estudo foram divulgados em uma reunião em Seattle da American Thoracic Society e também serão publicados na edição de amanhã do New England Journal of Medicine.
Sua dissidência se juntou ao chefe de juiz William h. Rehnquist e Justice Clarence Thomas.	Chefe de Justiça William h. Rehnquist e juízes Antonin Scalia e Clarence Thomas discordaram.
A United já pagou à cidade US $ 34 milhões em multas por não cumprir a primeira rodada de metas de emprego.	A United pagou US $ 34 milhões em multas por não cumprir as metas de emprego.
O escritório de Shelley informou na sexta -feira que 575.926 assinaturas foram relatadas a ele.	O escritório de Shelley divulgou contagens de assinaturas na sexta -feira e disse que os condados haviam relatado contar 575.926 assinaturas até agora.
Bush queria "ver uma aeronave aterrando da mesma maneira que os pilotos viram um pouso de aeronaves", disse ontem o secretário de imprensa da Casa Branca, Ari Fleischer.	Na terça -feira, antes do discurso de Byrd, Fleischer disse que Bush queria que '' visse uma aeronave aterrando da mesma maneira que os pilotos viram um pouso de aeronaves.
De pé com repórteres e fotógrafos a cerca de 150 metros dos portões da prisão, estava Brent Newbury, presidente da Associação Benevolente dos Patrulheiros do Condado de Rockland.	"A coisa toda é uma farsa", fumou Brent Newbury, presidente da Associação Benevolente dos Patrulheiros do Condado de Rockland.
"Eles foram brutalmente espancados, e é realmente uma maravilha que Porchia seja o único falecido neste caso".	"É uma maravilha que Porchia tenha sido o único falecido neste caso", acrescentou o Sax.
"As luvas estão desligadas", disse o funcionário da Unifi Rob O 'Neill.	O oficial da Unifi Rob O 'Neill disse: "As luvas estão desligadas.
Pratt & Whitney disseram que 75 % dos equipamentos de motor seriam terceirizados para a Europa, com a assembléia final na Alemanha.	Pratt & Whitney disseram que, se ganhasse o contrato, 75 % do equipamento do motor seria terceirizado para fornecedores europeus, com a assembléia final na Alemanha.
Os escritores da equipe Selwyn Crawford e Colleen McCain Nelson e Brian Anderson, da Dallasnews.com, contribuíram para este relatório.	Os escritores da equipe Brandon Formby e Colleen McCain Nelson contribuíram para este relatório.
A Comissão de Comércio teria sido um obstáculo significativo para esse acordo.	A Comissão de Comércio da Nova Zelândia havia dado a Westpac sem indicação se teria aprovado seu acordo.
Os promotores apresentaram uma moção informando a Lee que pretendem buscar a pena de morte.	Ele acrescentou que os promotores buscarão a pena de morte.
"Eles estão nas lojas há mais de seis semanas", diz Carney.	Os quartos geralmente ficam nas lojas por seis a oito semanas ", acrescentou Carney.
"Vamos mostrar que não os deixamos desligá -los", disse Marc Blondel, líder da União da Força Ouvriere.	"O movimento para defender as pensões está ganhando impulso, e não desistimos", disse Marc Blondel, líder da União da Força Ouvriere.
Ao contrário do que a PeopleSoft Management teria que você acredita, a Oracle pretende apoiar totalmente os clientes e produtos da PeopleSoft por muitos anos. "	Ellison disse que, ao contrário das alegações da PeopleSoft Management, a Oracle pretende "apoiar totalmente os clientes e produtos da PeopleSoft" por muitos anos.
American Masters: Arthur Miller, Elia Kazan e a Lista Negra: Nenhum sem pecado (Qua.	Observe a subposição desta terrível parábola na série "American Masters", "Arthur Miller, Elia Kazan e a Lista Negra: Nenhum sem pecado".
Esse pacote incluiu aumentos para os impostos sobre vendas e renda da cidade.	Ele também se opõe aos aumentos de vendas e imposto de renda pessoal no pacote.
A maior empresa de software do mundo disse que reconheceu a dificuldade que os vários patches colocados para as empresas e decidiram facilitar a aplicação das atualizações.	A maior empresa de software do mundo disse que reconheceu a dificuldade que os vários patches colocados para empresas que tentam aplicá -las.
Mas os declínios de preço permaneceram abaixo de 30 %, ano após ano, nos últimos dois trimestres, disse o analista da IDC John McArthur.	McArthur disse ao InternetNews.com que os preços dos preços moderados e permaneceram abaixo de 30 % em relação ao ano anterior nos últimos dois trimestres.
Putin saudou a Arábia Saudita como `` uma das nações muçulmanas mais importantes.	Antes da reunião, Putin disse que a Rússia considera a Arábia Saudita como um importante estado muçulmano.
As músicas são oferecidas por 99 centavos cada, ou US $ 9,99 para um álbum.	A empresa oferecerá músicas para 99 centavos e álbuns por US $ 9,95.
"Certamente o que sabemos sugere que devemos levar o que eles estão dizendo muito a sério", acrescentou.	"Não sabemos tudo [mas] o que sabemos sugere que devemos levar o que eles estão dizendo a sério", disse ele.
Sob a lei mexicana, a caça de recompensas é considerada uma forma de seqüestro.	A caça de recompensas é ilegal no México, e o caçador de recompensas foi acusado de sequestro.
As ações da Gillette subiram US $ 1,45, ou 4,5 %, para US $ 33,95 na tarde da bolsa de valores da tarde de Nova York.	As ações da Gillette fecharam 45 centavos em US $ 33,70 em negociações na quarta -feira na Bolsa de Nova York.
As ações de Jack in the Box, com sede em San Diego, fecharam em US $ 21,49, um aumento de 78 centavos, ou 3,8 %, na Bolsa de Valores de Nova York.	Ações da Outback Steakhouse, com sede em Tampa. Fechado em US $ 44,50, um aumento de US $ 1,78, ou 4,2 %, na Bolsa de Valores de Nova York.
O Dow Jones Industrials subiu mais de 140 pontos acima da marca de 9.000, pela primeira vez desde dezembro.	A Dow Jones Industrials superou brevemente a marca de 9.000 pela primeira vez desde dezembro. "
Os anúncios foram feitos na Convenção Internacional de Radiodifusão (IBC) em Amsterdã.	A apresentação foi na segunda -feira, mas o anúncio foi feito sexta -feira na Convenção Internacional de Radiodifusão em Amsterdã.
Os tribunais de apelação de todo o país emitiram decisões diferentes sobre o assunto, permitindo exibições públicas dos dez mandamentos em alguns casos e proibindo -os em outros.	Os tribunais inferiores se livraram do assunto, permitindo representações dos dez mandamentos em alguns casos e não em outros.
O governo escolheu três empresas para desenvolver planos para proteger aeronaves comerciais de ataques de mísseis a ombros, anunciaram as autoridades de segurança interna na terça-feira.	O Departamento de Segurança Interna anunciou na terça-feira que selecionou três empresas para continuar pesquisando maneiras de frustrar ataques de mísseis a ombros nos EUA Aeronaves comerciais.
Os partidos tâmeis culpam os tigres de libertação de Tamil Eelam (LTTE) por esses assassinatos.	O governo queria reviver conversas com os Tigres de Libertação de Tamil Eelam (LTTE) para discutir a estrutura provisória.
Dois dos britânicos, Sandy Mitchell, de Glasgow e William Sampson, nascido em Glasgow, enfrentam a pena de morte.	Sandy Mitchell, 44, de Kirkintilloch, Glasgow, e William Sampson, um cidadão britânico nascido em Glasgow, decapitando em público.
Ele pediu à paciência dos americanos ansiosos pelo serviço, que visa bloquear cerca de 80 % das ligações de telemarketing.	O serviço gratuito foi originalmente destinado a bloquear cerca de 80 % das chamadas de telemarketing.
Ele foi preso na noite de terça -feira em uma loja de pneus no noroeste de Atlanta depois de uma caçada humana.	Ele foi preso em Atlanta, Geórgia, na noite de segunda-feira pela polícia atuando em uma denúncia.
Jordan Green, advogado particular do prelado, disse que não tinha comentários.	O advogado de Brien, Jordan Green, se recusou a comentar.
Hadley, que tem um novo parceiro e criança, disse: "Estou absolutamente encantado.	Em comunicado divulgado por seus advogados, Hadley disse: "Estou absolutamente encantado com o resultado dos procedimentos.
As perdas ocorreram durante a noite em Willow Canyon, uma das três áreas nas montanhas de Santa Catalina ameaçadas pelo incêndio de 2 semanas que já havia escurecido 70.000 acres.	As perdas ocorreram durante a noite em Willow Canyon, uma das três áreas nas montanhas de Santa Catalina ameaçadas pelo ressurgente do Aspen Fire.
"Não queremos aguardar e deixar que um linchamento de cartão de crédito ocorra", declarou representante. Major Owens (D-Brooklyn).	"Nós não queremos ficar por aqui e ver um linchamento de cartão de crédito", disse ele.
O esforço é o mais recente esforço do governo Bush para expandir o papel das organizações religiosas nos serviços do governo.	10 de julho-O mais recente esforço do governo Bush para expandir o papel das organizações religiosas em serviços governamentais recruta grupos de jovens baseados na igreja em programas antidrogas.
No entanto, o uso comercial do kernel 2.6.0 ainda tem meses de folga para a maioria dos clientes.	Os lançamentos comerciais do kernel de 2.6 pelos principais distribuidores do Linux ainda permanecem meses de distância.
O ÍNDICE STANDAR EM ARMERAÇÃO & POBER 500 .SPX Avançou 2 pontos, ou 0,24 %, para 977.	O índice de composto NASDAQ .IXIC estava fora de 6,52 pontos, ou 0,39 %, em 1.645,66.
Dois funcionários disseram inicialmente que cerca de 300 trabalhadores foram presos em 61 lojas em 21 estados.	Mas os funcionários revisaram os números mais tarde e disseram que cerca de 250 foram presos em cerca de 60 lojas.
"Este acordo faz sentido para as duas empresas", disse Halla em comunicado preparado.	Brian Halla, CEO da Natsemi, afirmou que o acordo fazia sentido para as duas empresas.
Cinqüenta e sete senadores, incluindo 24 republicanos, assinaram a carta.	Dos que assinaram a carta, 57 são senadores, incluindo 24 republicanos.
As ações representam mais da metade dos 115,9 milhões de ações que Turner realizou no final de abril, de acordo com dados da Bloomberg.	A venda representa cerca de 52 % dos 115,9 milhões de ações, Turner, realizado no final de abril.
Mais cinco casos humanos de vírus do Nilo Ocidental foram relatados pelo Departamento de Saúde do Condado de Mesa na quarta -feira.	A partir desta semana, 103 casos do Nilo Ocidental humanos em 45 municípios foram relatados ao Departamento de Saúde.
senhor. Manuel e seu grupo entraram nos Estados Unidos atravessando a ponte ligando Matamoros e Brownsville.	Manuel e seu grupo entraram nos EUA da mesma maneira que milhares de pessoas fazem todos os dias, atravessando a ponte entre Matamoros e Brownsville.
De acordo com os regulamentos da NASD, MR. Young pode registrar uma resposta e solicitar uma audiência antes de um painel da NASD.	O analista, já deixado por Merrill, pode solicitar uma audiência antes de um painel NASD.
Suas palavras -chave são suportadas por portais da Web em língua chinesa.	Os portais da Web de idiomas chineses também suportam 3721 palavras -chave, disse o site.
O presidente iniciou seu discurso reconhecendo os ataques terroristas na Arábia Saudita que mataram pelo menos 29 pessoas, incluindo sete americanos.	Bush, no entanto, também atacou os atentados terroristas na Arábia Saudita que matou pelo menos 29 pessoas - incluindo vários americanos.
Sirius carrega a Rádio Pública Nacional, embora não inclua programas populares como "todas as coisas consideradas" e "Morning Edition".	Recentemente, Sirius começou a transportar a Rádio Pública Nacional, um acordo com Pooh-Poohed pelo XM porque não inclui programas populares como todas as coisas consideradas e Morning Edition.
"Estou muito orgulhoso dos cidadãos deste estado", Gov. John Baldacci disse que após os votos do referendo de terça -feira foram contados.	"Estou muito orgulhoso dos cidadãos deste estado", disse Gov. John Baldacci, um inimigo de cassino.
Entre os três grandes candidatos, Schwarzenegger está vencendo a batalha pelos independentes e os eleitores de crossover.	Schwarzenegger pega mais independentes e eleitores do que Bustamante.
Ele substituirá Ron Dittemore, que anunciou sua demissão em 23 de abril.	Dittemore anunciou seus planos de renunciar em 23 de abril.
Selenski já havia passado sete anos na prisão por uma condenação por assalto a bancos.	Selenski cumpriu cerca de sete anos de prisão por assalto a bancos.
Maddox, 87 anos, quebrou duas costelas quando caiu há cerca de 10 dias em um lar assistido, onde estava se recuperando da cirurgia intestinal, disse Virginia Carnes.	Maddox, que lutou contra o câncer desde 1983, quebrou duas costelas no início deste mês, quando caiu em um lar assistido, onde estava se recuperando da cirurgia.
Graham, um candidato presidencial, foi criticado por vários republicanos como "politizando" o relatório.	Graham, que co-presidiu o inquérito, é um candidato presidencial.
Em 2002, a Linksys ultrapassou a Cisco Systems como o principal fornecedor de equipamentos sem fio, representando 14,1 % da receita.	Rolfe disse que a Linksys ultrapassou a Cisco Systems no ano passado como o principal fornecedor de equipamentos da WLAN.
As escolas que não cumprem as metas estaduais por três anos seguidas devem oferecer aulas de aulas, além de transferências.	As escolas que não atendem às metas de teste por dois anos seguidas devem oferecer transferências.
A adulteração de remédios tem sido tão lucrativa que muitos dos presos viviam em casas de um milhão de dólares.	Aparentemente, adulterar a medicina era tão lucrativa, disseram os investigadores que muitos dos suspeitos moravam em casas de um milhão de dólares.
A estimativa de consenso dos analistas entrevistados pela Thomson Primeira chamada pediu um lucro de US $ 1,70 por ação.	Analistas entrevistados pela Reuters Research, uma unidade do Reuters Group Plc,, em média, prevê -se lucro de US $ 1,69 por ação.
Os relatórios iniciais da autópsia mostram que eles morreram de desidratação, hipertermia e asfixia.	Mais dois morreram depois, e os relatórios iniciais da autópsia mostram que eles sucumbiram à desidratação, hipotermia e asfixia.
Howard disse que também tinha fé no sistema sob o qual Hicks poderia ser julgado.	Howard também disse ontem que Hicks seria tratado razoavelmente, dizendo que tinha fé no sistema de justiça dos EUA.
Mahmud controlou o acesso a Saddam para todos, exceto membros imediatos da família, disseram autoridades do Pentágono.	Mahmud controlava o acesso a Saddam e estava frequentemente ao seu lado.
Os contrabandistas em uma van perseguiram uma picape e o SUV carregando outros contrabandistas e imigrantes ilegais, disse o xerife do condado de Pinal, Roger Vanderpool.	As pessoas em uma van abriram fogo contra uma picape e SUV que se acredita estar transportando imigrantes ilegais, disse o xerife do condado de Pinal, Roger Vanderpool.
O julgamento, com 125 testemunhas, poderia continuar até o início de 2004.	O julgamento, que pode durar até o início de 2004, deve ouvir a primeira das 125 testemunhas na sexta -feira.
Os computadores teriam sido localizados nos EUA , Canadá e Coréia do Sul.	Os PCs estão espalhados pelos Estados Unidos, Canadá e Coréia do Sul.
A vulnerabilidade afeta o Windows NT 4.0, NT 4.0 Terminal Services Edition, XP e 2000, bem como o Windows Server 2003.	A Microsoft emitiu um patch para a vulnerabilidade, que afeta o Windows NT 4.0, Windows NT 4.0 Terminal Services Edition, Windows 2000, Windows XP e Windows Server 2003.
A contribuição adicional traz total dos EUA Ajuda alimentar à Coréia do Norte este ano para 100.000 toneladas.	A doação de 60.000 toneladas traz o total dos EUA Contribuições para o ano para 100.000.
A União Europeia proibiu a importação de alimentos geneticamente modificados em 1998; Os Estados Unidos estão agora exigindo que a UE termine sua proibição.	O sindicato proibiu a importação de alimentos geneticamente modificados em 1998, depois que muitos consumidores temiam os riscos à saúde.
Ele projetou que Vanderpool estará disponível nos próximos cinco anos.	Os produtos com Vanderpool serão lançados dentro de cinco anos, disse ele.
Annika Sorensam tem sua primeira oportunidade de testar esse objetivo nesta semana no Campeonato LPGA do McDonald.	O aperitivo devorou, Annika Sorenstam passa para a entrada nesta semana no Campeonato LPGA do McDonald.
O Índice 500 Standard e Poor Standard & Poor .spx ganhou 3 pontos, ou 0,39 %, em 924.	O índice de composto NASDAQ com tecnologia <.ixic> subiu 6 pontos, ou 0,41 %, para 1.498.
De acordo com o censo de 2000, a população hispânica ou latina de Long Beach foi listada em 35,8 %.	De acordo com o Census Bureau, a população hispânica aumentou 9,8 % em relação aos números do censo de abril de 2000.
As autoridades apelaram ao público na sexta-feira para se apresentar e fornecer o que poderia ser a chave para resolver os tiroteios no estilo atirador que mataram três pessoas fora das lojas de conveniência da área.	As autoridades procuraram ontem o público para ajudar a resolver os tiroteios mortais no estilo atirador de três pessoas fora das lojas de conveniência da área de Charleston.
O ator Noah Wyle, que interpretou o Dr. John Carter desde o início dos shows em 1994, estendeu seu contrato com o programa até a temporada 2004-2005.	Noah Wyle, que jogou Dr. John Carter desde a série foi lançado em 1994, assinou uma extensão de um ano para seu acordo com o produtor Warner Bros. TV.
A Cisco assinou acordos semelhantes com a AT&T Corp. T.N, SBC Communications Inc. SBC.N e Sprint Corp. fon.n.	A Cisco tem relações semelhantes com os concorrentes da BellSouth SBC Communications, AT&T e Sprint Communications.
O OMS diz que o caso mais recente não se encaixa no seu perfil de SARs e não é um problema de saúde pública.	A OMS disse que o caso de Cingapura não se encaixava no seu perfil de SARs e "não era um problema internacional de saúde pública".
Harris e Klebold mataram 12 alunos e um professor antes de tirar suas próprias vidas em 20 de abril de 1999.	Harris e Klebold mataram 12 alunos, um professor e eles mesmos na escola.
"Condenamos o Conselho de Administração liderado pelos Estados Unidos", disse Muqtada al Sadr em um sermão em uma mesquita.	"Condenamos e denunciamos o Conselho de Administração, que é chefiado pelos Estados Unidos", disse Moqtada al-Sadr.
O segundo vem a HP (27 % com US $ 2,9 bilhões, um aumento de apenas 0,4 %).	A HP caiu para o segundo lugar, com as vendas do servidor crescendo 0,4 %, para US $ 2,9 bilhões.
Em um comunicado distribuído na sexta-feira, 28 organizações não governamentais chechenas disseram que boicotariam a votação.	Em um comunicado distribuído hoje, 28 organizações não-governamentais chechenas disseram que boicotariam a votação e alertaram os eleitores a esperar fraudes.
A população do estado era de 6.080.485 em 2000, de acordo com os EUA Censo.	Entre 1960 e 2000, no entanto, a população do estado cresceu 30,4 %, para 6.080.485.
18 de julho: Hurlbert registra uma única contagem de agressão sexual criminal contra Bryant.	Bryant, 24 anos, foi acusado de agressão sexual criminosa.
st. Presidente de Paulo e executivo -chefe Jay s. Fishman, 51 anos, será CEO da Companhia Combinada.	Jay Fishman, 51 anos, presidente e diretor executivo de São Paulo, será o diretor executivo da Companhia Combinada.
nós. As forças recentemente prenderam cerca de 40 suspeitos de militantes estrangeiros perto da fronteira com a Síria e agora os estão interrogando.	O terceiro Regimento de Cavalaria Blindado recentemente prendeu cerca de 40 suspeitos de combatentes perto da fronteira com a Síria, disseram autoridades.
Em vez disso, Weida decidiu que o caso de Meester sob a acusação de estupro, sodomia, agressão indecente e fornecimento de álcool a menores deveriam prosseguir para um tribunal-marcial.	Douglas Meester, 20, é acusado de estupro, sodomia, agressão indecente e fornecimento de álcool a menores.
Isso se compara com um lucro de US $ 1 milhão, ou o ponto de equilíbrio, em US $ 1,39 bilhão em receita durante o mesmo período do ano passado.	A receita total do segundo trimestre foi de US $ 1,48 bilhão, um aumento de US $ 1,39 bilhão no mesmo período do ano passado.
Eles fizeram uma descoberta semelhante em Houston em outra aeronave, disse o sudoeste de Dallas em comunicado.	A companhia aérea disse que uma descoberta semelhante foi feita no avião em Houston.
Rosenthal se recusou a comentar a situação de Garrett na terça -feira, mas disse em comunicado: "Tivemos uma grande negociação de contrato.	O criador e produtor executivo do programa, Phil Rosenthal, brincou em comunicado: "Tivemos uma grande negociação de contrato.
Com o poder de volta, os trabalhadores do estado voltaram para seus empregos na manhã de sexta -feira.	Pataki disse que se o poder fosse restaurado, os trabalhadores estaduais voltariam ao trabalho na manhã de sexta -feira.
O Exército da Bolívia lutou para impedir que colunas de manifestantes entrassem na capital com fome de alimentos na quarta-feira como um levante popular contra o presidente.	O Exército da Bolívia lutou para impedir uma coluna de mineradores que usam dinamite para entrar na capital sitiada na quarta-feira, deixando dois mortos como uma revolta popular contra o presidente.
O Nasdaq caiu cerca de 1,3 % no mês, marcando uma sequência de sete meses de vitória.	O NASDAQ caiu aproximadamente 0,4 % no mês, a caminho de tirar uma sequência de 7 meses de ganhos.
O relatório foi encontrado em outubro. 23, escondido dentro de um antigo aglutinante de três anéis não relacionado à investigação.	O relatório foi encontrado na semana passada escondida dentro de um manual de treinamento que pertencia a Hicks.
nós. As tropas mataram quase duas dúzias de militantes do Taliban depois de serem criticados no sul do Afeganistão, no mais recente de uma série de tais ataques.	nós. Os soldados mataram cerca de duas dúzias de militantes do Taliban no sul do Afeganistão depois que seu comboio foi atacado, disse o militar no domingo.
O A920 vem com uma impressora, scanner e copiadora por US $ 89.	O All-in-One A920 da Dell é um dispositivo de nível básico que combina funções de impressora, scanner e copiadora por US $ 89.
No sábado, o Comitê Internacional da Cruz Vermelha disse que estava fechando temporariamente seus escritórios em Bagdá e Basra.	O Comitê Internacional da Cruz Vermelha, com medo da segurança de sua equipe que opera no Iraque, anunciou que estava temporariamente fechando seus escritórios em Bagdá e Basra.
A campanha de solidariedade da Palestina da Irlanda, da qual O Muireagáin foi membro, recebeu sua libertação.	A campanha de solidariedade da Palestina da Irlanda, da qual ele era membro, disse que estava pesquisando um projeto de troca de escolas.
Glover disse que o assassino usou um "slipknot peculiar" na ligadura que ele usou para estrangular algumas das vítimas.	Glover disse que o assassino usou um `` slipknot peculiar '', incluindo um cabo coaxial e um cabo de extensão, para estrangular algumas das vítimas.
Ela disse que os advogados de Jane Doe pediram à Verizon para reter seu nome porque estava planejando desafiar a intimação.	Jane Doe, decidindo lutar contra a intimação, pediu à Verizon para reter seu nome.
Ele levantou sua tela de radar pessoal na semana passada, dei a ele meu arremesso e ele foi bastante favorável ", disse ele.	"Ele se levantou na tela de radar pessoal na semana passada, e eu tive que fazer meu arremesso.
Em setembro, um pesquisador de Cingapura de 27 anos contratou SARs enquanto trabalhava em um laboratório.	Em um caso em agosto, um trabalhador de laboratório de 27 anos em Cingapura desenvolveu SARS.
Um número abaixo de 50 sugere contração no setor de manufatura, enquanto um número acima que indica expansão.	Uma leitura acima de 50 sugere crescimento no setor, enquanto um número abaixo desse nível indica contração.
Um processo foi arquivado na tentativa de bloquear a remoção do monumento dos Dez Mandamentos do edifício.	Os apoiadores pediram a um tribunal federal na segunda -feira para bloquear a remoção de um monumento de dez mandamentos do edifício judicial do Alabama.
Britz ganhou US $ 3,77 milhões em salário, bônus e outras compensações, e Kinney ganhou US $ 3,76 milhões.	Johnston ganhou US $ 5,8 milhões em salário e bônus em 2001 como presidente e como consultor de meio período ganhou US $ 1 milhão em 2002.
Esse caminhão foi visto na área de Campbells Creek, ajustando essa descrição, disse Morris.	Uma caminhonete preta também foi vista na área de Campbells Creek, disse Morris.
Mas nos primeiros 30 segundos depois que Young entrou no ringue, a família sabia que era uma partida desigual, disse Meyers.	Mas nos primeiros 30 segundos da luta, os membros da família sabiam que era uma partida irregular, disse Jodie Meyers, irmã de Stacy Young.
O presidente Michael Powell e colegas da FCC na audiência de quarta -feira.	O chefe da FCC, Michael Powell, preside a audiência na segunda -feira.
A média industrial da Dow Jones subiu 0,3 % em 9.886,75, enquanto o índice de composto da NASDAQ foi 0,4 % maior em 1.986,97.	Em Wall Street, a média industrial da Dow Jones subiu 0,5 % em 9.905,8 e o composto da Nasdaq adicionou 0,7 % a 1.995,1.
Teerã deixou claro que assinará apenas o protocolo adicional que introduz tais inspeções se a proibição da importação da tecnologia nuclear ocidental civil for levantada.	Teerã deixou claro que apenas assinará o protocolo se a proibição de importações de tecnologia nuclear ocidental pacífica for levantada.
O Congresso duas vezes antes passou de restrições semelhantes apenas para ver o presidente Bill Clinton os vetar.	O Congresso aprovou duas vezes notas semelhantes, mas o então presidente Clinton os vetou as duas vezes.
Mas eu prefiro falar sobre altos padrões do que padrões baixos. "	"Eu prefiro estar falando sobre números positivos em vez de negativos.
Sob o programa, EUA Os funcionários trabalham com as autoridades portuárias estrangeiras para identificar, segmentar e pesquisar cargas de alto risco.	Sob o programa, as autoridades americanas trabalham com as autoridades portuárias estrangeiras para procurar carga de alto risco antes que ele possa chegar aos Estados Unidos.
Niels disse a um entrevistador em 1999 que achava que o velho o sobreviveria por muitos anos.	Em 1999, dois anos antes de sua morte, Sr. Nielsen disse a um entrevistador que achava que o rosto do rock o sobreviveria por muitos anos.
um, capitão. Doug McDonald, permaneceu hospitalizado em estado crítico na quinta -feira.	Sua irmã de 20 anos, Allyson, foi gravemente queimada e permaneceu hospitalizada em estado crítico.
Na quarta -feira, o total dos membros da Guarda Nacional e da Reserva ligou para o serviço ativo em todo o mundo estava em 154.603.	A partir de ontem, o número total de tropas da Guarda Nacional e Reserva chamadas ao DIVIDO em todo o mundo era de 154.603.
Durante um período de quase uma década, os associados de telemarketing arrecadaram mais de US $ 7 milhões.	A Telemarketing Associates, contratada pela Vietnow, levantou US $ 7,1 milhões de 1987 a 1995.
Os corpos do ex -homem de Invercargill, Warren Campbell, 32, e o companheiro de escalada Jonathan Smith, 47, foram recuperados de baixo do Mt D 'Archiac no final da manhã de ontem.	Warren David Campbell, 32, e o companheiro de escalada Jonathan Smith, 47 anos, não retornaram conforme o esperado na terça -feira de subir no mt d 'Archiac no distrito de McKenzie.
senhor. Geoghan estava morando em uma unidade de custódia de proteção desde que foi transferida para a prisão em 3 de abril.	Ele estava sob custódia protetora desde que foi transferido para Souza-Baranowski em abril, disseram autoridades.
A plataforma democrática de 2000 apoiou "toda a inclusão de famílias gays e lésbicas na vida da nação".	A plataforma de 2000 do democrata não apoiou explicitamente casamentos gays, mas apoiou "a total inclusão de famílias gays e lésbicas na vida da nação".
Suas ações caíram 71 centavos, ou 3,5 %, na negociação após o horário comercial, para US $ 19,55.	As ações subiram 63 centavos, ou 3 %, fecharem em US $ 20,26 em negociação de sessão regular da Nasdaq.
Cingapura não relatou casos suspeitos de SARS na quarta -feira, mas as autoridades em quarentena 70 pessoas que tiveram contato com o paciente de Taiwan.	Ainda assim, Cingapura em quarentena 70 pessoas que estavam em contato próximo com o cientista.
Ex -candidato a governador de Nova York, ele se denominou um defensor de uma melhor governança corporativa.	senhor. McCall, que concorreu sem sucesso para o governador de Nova York em 2002, se denominou um defensor de uma melhor governança corporativa.
Centenas de repórteres e fotógrafos inundaram os terrenos do tribunal antes da audiência, que foi transportada ao vivo nas redes nacionais de cabo.	Centenas de repórteres e fotógrafos inundaram a cidade e a curta audiência envolvendo o All-Star de cinco vezes foi transportada ao vivo nas redes nacionais de cabo.
As vendas de chips da AMD aumentaram 7 %, ano a ano, para US $ 402 milhões.	As vendas no segundo trimestre cresceram 7 %, para US $ 645 milhões, de US $ 600 milhões em 2002.
A jusante em Mount Vernon, o rio Skagit deveria atingir a 36 pés - 8 pés acima do estágio de inundação - hoje à noite, disse Burke.	Esperava -se que o Skagit atinja durante a noite a 38 pés em Mount Vernon, a 10 pés acima do estágio de inundação, informou o Serviço Nacional de Meteorologia.
Os agentes do FBI prenderam um ex -sócio da empresa de contabilidade Big Four Ernst & Young Erny.Ul por acusações criminais de obstruir investigações federais, EUA Autoridades disseram na quinta -feira.	Um ex -parceiro da empresa de contabilidade Ernst & Young foi preso ontem por agentes do FBI nos EUA por acusações de obstruir investigações federais.
Shelia Chaney Wilson parecia agitada quando veio ajudar a se preparar para Turner Monumental A.M.E. A próxima celebração do 104º aniversário da Igreja, disseram os adoradores.	Os congregantes da Igreja de Turner Monumental AME disseram que Shelia Chaney Wilson, 43 anos, ficou agitada quando chegou à igreja, no bairro de Kirkwood, no lado leste da cidade.
Ele era o ás de diamantes em um pacote de cartões que representavam fugitivos iraquianos que foram emitidos para os EUA tropas.	Ele era o ás de diamantes em um EUA Deck de cartas mostrando fotos dos líderes iraquianos mais procurados.
Miodrag Zivkovic, da Aliança Liberal do Montenegro, ganhou 31 % dos votos, enquanto o Dragan Hajdukovic independente recebeu 4 %.	Um radical pró-independência, Miodrag Zivkovic, da Aliança Liberal, ficou em segundo lugar com 31 % dos votos.
Até agora, a Geórgia retornou, exceto US $ 70.000 do dinheiro que conectou.	A Geórgia recebeu todos os US $ 70.000 de seu dinheiro de volta com a ajuda do FBI.
Yeager disse que o suspeito no ataque alvo mostrou tendências de ser um criminoso anterior.	Yeager disse que o incidente parecia estar isolado, mas o suspeito mostrou tendências de ser um agressor anterior.
A nação insular registrou 65 novos casos em 22 de maio, um recorde de um dia e 55 novos casos em 23 de maio, tornando a epidemia de Taiwan a que mais cresce no mundo.	Taiwan registrou 65 novos casos em 22 de maio, um recorde de um dia e 55 novos casos em 23 de maio, tornando sua epidemia o crescimento mais rápido do mundo.
O defensor do Cubs, Sammy Sosa, foi suspenso por oito jogos pela Major League Baseball na sexta -feira por usar um bastão de arrumar.	Sammy Sosa foi suspenso por oito jogos pela Major League Baseball na sexta -feira por usar um bastão de arrumar e imediatamente recorreu da decisão.
Metade das mulheres recebeu uma dose diária da droga e metade tomou um placebo.	Metade das mulheres recebeu um comprimido diário da combinação de estrogênio mais progestina enquanto o restante recebeu um placebo.
Na segunda -feira, a Dow caiu 5,25, ou 0,1 %, em 8.983,80, tendo derramado 2,3 % na semana passada.	Nas negociações antecipadas, a média industrial da Dow Jones caiu 39,94, ou 0,4 %, em 8.945,50, tendo escorregado 3,61 pontos na segunda -feira.
O título de 30 anos US30YT = RR caiu 14/32 para um rendimento de 4,26 %, de 4,23 %.	O título de 30 anos US30YT = RR perdeu 16/32, levando seu rendimento para 4,20 % para 4,18 %.
Os feridos foram levados para hospitais em Jefferson City e Columbia, uma cidade universitária a cerca de 48 quilômetros ao norte.	Os feridos foram levados para hospitais em Jefferson City e Columbia, a cerca de 48 km norte; Suas condições não estavam disponíveis imediatamente.
Quando a polícia removeu os quatro da casa, eles pesavam 136 libras combinadas.	Cada garoto pesava menos de 50 libras quando foi removido da OCT em casa. 10.
O dólar estava em 117,85 ienes contra a moeda japonesa, um aumento de 0,1 %.	Contra o franco suíço, o dólar estava em 1.3289 francos, um aumento de 0,5 % no dia.
Enquanto os Ibrahims tinham uma operação de separação, Goodrich e Dr. David Staffenberg planeja cerca de três para os Aguirres, com várias semanas entre cada um.	Em vez de uma longa operação para separar os gêmeos, Goodrich e Dr. David Staffenberg planeja cerca de três, com várias semanas entre cada uma.
A empresa se expandiu para fornecer outros serviços para compradores, incluindo serviços de pagamento.	A empresa expandiu esses serviços básicos, oferecendo pagamento e até financiamento.
As explosões mataram duas pessoas e feriram mais de 150 outras.	O ataque dos Jogos Olímpicos de Atlanta matou uma mulher e feriu mais de 100 outras pessoas.
Em 2001, o presidente Bush nomeou Kathy Gregg para o Conselho de Administração da Associação de Marketing de Empréstimos para Estudantes.	Em 2001, o presidente Bush a nomeou para a Associação de Marketing de Empréstimos para Estudantes, a maior EUA credor para estudantes.
A arquidiocese de Boston enfrentou ondas de escândalo que não apenas irritaram os defensores das vítimas, mas os paroquianos e alguns sacerdotes.	As ondas do escândalo irritaram não apenas os defensores das vítimas, mas os paroquianos e alguns sacerdotes, a ponto de que a lei não podia mais administrar a arquidiocese.
Um magistrado federal em Fort Lauderdale ordenou que ele fosse mantido sem fiança.	Zuccarini foi ordenado sem fiança na quarta -feira por um juiz federal em Fort Lauderdale, Flórida.
A posição do departamento ameaça alienar os conservadores sociais, que forneceram forte apoio político ao Sr. Ashcroft e o presidente Bush.	A posição do departamento decepcionou alguns oponentes do aborto e ameaça alienar os conservadores sociais que forneceram forte apoio político a Ashcroft e ao presidente Bush.
A África do Sul tem o maior número de casos do mundo com 4,7 milhões de pessoas infectadas com HIV ou AIDS.	Com 4,7 milhões de pessoas infectadas com HIV ou AIDS, a África do Sul tem o maior número de casos de Aids do mundo.
Nessa posição, Elias se reportará a Joe Tucci, presidente e CEO da EMC.	Como vice -presidente executivo da New Ventures, Elias se reportará a Joe Tucci, presidente e diretor executivo da EMC.
O novo comandante do Exército é o comandante da Brigada Blindada de Masaka, o brigadeiro Aronda Nyakairima, que agora é promovido ao major -general.	O presidente Yoweri Museveni promoveu o brigadeiro Aronda Nyakairima para o major -general e o nomeou comandante do exército.
"Se isso é um democrata, devo estar na reunião errada", disse ele.	E se isso é um democrata, devo estar na reunião errada ", disse ele a aplausos estrondosos de seus apoiadores.
O MailBlocks foi fundado cinco anos depois que a WebTV foi adquirida pela Microsoft por US $ 425 milhões.	A WebTV foi vendida para a Microsoft em 1997 por US $ 425 milhões e hoje é chamada MSN TV.
"É uma grande vitória para o Maine, e é uma grande vitória para outros estados.	O programa do Maine pode ser um modelo para outros estados.
Além de O 'Connor, a opinião da maioria de Rehnquist se juntou aos juízes David Souter, Ruth Bader Ginsburg e Stephen Breyer.	Juntando -se a ele, na opinião da maioria, estavam os juízes Sandra Day O 'Connor, David h. Souter, Ruth Bader Ginsburg e Stephen G. Breyer.
A Metropolitan Transportation Authority recebeu duas semanas para restaurar a tarifa de US $ 1,50 e as antigas taxas ferroviárias, declarou York.	A Metropolitan Transportation Authority, que planeja apelar, foi dada até 28 de maio para restaurar a antiga tarifa do metrô e do ônibus e as antigas taxas de ferrovias.
Os Jets Embraer estão programados para serem entregues em setembro de 2006.	A aeronave Bombardier e Embraer será entregue aos EUA Airways até setembro de 2006.
"Hoje, estamos tentando transmitir esse problema ao presidente russo Vladimir Putin e ao presidente dos EUA, George W Bush".	"Hoje, estamos tentando transmitir esse problema ao presidente russo Vladimir Putin (notícias - sites) e ao presidente Bush (notícias - sites)".
O estado quer matar os lobos em aproximadamente uma área de 1.700 milhas quadradas perto da vila de McGrath.	O estado quer matar os lobos em aproximadamente uma área de 1.700 milhas quadradas perto de McGrath para estabelecer uma espécie de berçário de alces.
Peterson disse à polícia que pescou sozinha na Baía de São Francisco na véspera de Natal, retornando a uma casa vazia.	Peterson disse à polícia que deixou sua esposa por volta das 9h30 da manhã de dezembro. 24 para pescar sozinho na Baía de São Francisco.
A pesquisa em Empire State, do Fed, excedeu em muito as expectativas ao saltar para 26,8 em junho, um recorde de 10,6 em maio.	Os preços haviam recuado dos máximos offshore quando a Pesquisa do Empire State excedeu em muito as expectativas, saltando para 26,8 em junho, um recorde de 10,6 em maio.
"Posso dizer que estou sendo forçado a exílio pela superpotência mundial", disse ele.	"Estou sendo forçado a exílio pela superpotência do mundo", disse Taylor em um endereço em vídeo em sua casa.
O chefe do Det, o insp, Norman McKinlay, disse que havia "evidências de que um corpo ou corpos foram nessa área".	O inspetor -chefe do detetive Norman McKinlay, liderando a investigação, disse: "Há evidências de que um corpo ou corpos estão nessa área.
Os investigadores analisaram meticulosamente praticamente todos os aspectos dos assuntos pessoais e financeiros de Campbell, reconheceu Campbell.	Os investigadores continuam a investigar praticamente todos os aspectos dos assuntos pessoais e financeiros de Campbell, disse o ex -prefeito.
O chanceler do conselho Robert Bennett se recusou a comentar sobre questões de pessoal na terça -feira, assim como Mills.	senhor. Mills se recusou a comentar ontem, dizendo que nunca discutiu o pessoal.
O general Jeffrey disse que doaria sua pensão militar para caridade pelo período em que estava no cargo em Yarralumla.	O major-general Jeffery disse que daria sua pensão militar à caridade enquanto serviu em Yarralumla.
O gerente de Tampa Bay, Lou Piniella, o técnico de bancada John McLaren e o defensor da direita Aubrey Huff foram expulsos por discutir depois que Huff foi chamado por greves para terminar o nono.	O gerente de Tampa Bay, Lou Piniella, o técnico de bancada John McLaren e Huff foram ejetados no meio do nono.
O empreendimento possui cinco refinarias de petróleo e mais de 2.100 postos de gasolina na Rússia e na Ucrânia.	O TNK-BP possui seis unidades produtoras de petróleo, cinco refinarias e 2.100 postos de gasolina.
Outras mudanças no plano refinam sua visão original, disse Libeskind.	Muitas das mudanças são melhorias no plano original, disse Libeskind.
A receita subiu para US $ 616,5 milhões, de US $ 610,6 milhões no ano anterior.	A receita aumentou um pouco, de US $ 610,6 milhões para US $ 616,5 milhões.
O índice Broad Standard & Poor's 500 <.spx> subiu 8,79 pontos, ou 0,96 %, em 929,06.	O índice de composto NASDAQ com tecnologia <.ixic> saltou 26 pontos, ou 1,78 %, para 1.516.
Rep. Peter Deutsch, D-Fla. , criticou os esforços da FDA na Flórida.	Peter Deutsch, D-Fla. , disse que queria parabenizar o FDA.
Nem o diretor atlético do estado de Iowa, Bruce Van de Velde, nem Morgan poderiam ser encontrados para comentar.	O diretor atlético do estado de Iowa, Bruce Van de Velde, não confirmou que uma oferta foi feita à Lebo.
Atualmente, existem 37 casos prováveis ​​ativos no GTA, em comparação com 70 casos em 6 de junho.	e, globalmente, o número de casos prováveis ​​ativos diminuiu para 573.
A águia masculina foi encontrada por um zookê no início da quinta -feira, sofrendo de feridas graves de punção em seu abdômen.	A águia de 21 anos, encontrada por um zookê no início da quinta-feira, teve ferimentos graves no abdômen e nas costas, disse a porta-voz Julie Mason.
Agnew disse que Pinellas começou a iscar quando os casos de raiva "passaram de zero para 30" em 1995.	Ainda assim, os casos de pinellas de raiva caíram acentuadamente para 17 em 1996 e 3 em 1997, disse Agnew.
Marc Garber, advogado de Whitley, tinha uma visão diferente.	O advogado de Whitley, Marc Garber, chamou a decisão de "uma enorme vitória".
As ações da Bioreliance fecharam 2 centavos ontem a US $ 47,98 por ação.	As ações da Bioreliance foram vendidas a US $ 47,98 no final do mercado ontem, abaixo de 2 centavos.
Apenas cinco meses atrás, Dean se comprometeu a aceitar dinheiro dos contribuintes e prometeu atacar qualquer democrata que não tivesse.	Apenas cinco meses atrás, Dean se comprometeu a aceitar o dinheiro dos contribuintes e os limites de gastos que o acompanham e prometeu atacar qualquer democrata que não o tivesse.
A SARS matou 296 pessoas no continente da China e infectou mais de 5.200.	Em todo o continente da China, a doença matou 300 pessoas e infectou mais de 5.270.
O Finder reprojetado também possui pesquisa, rótulos coloridos para organização personalizada de documentos e projetos e navegação dinâmica da rede para servidores de arquivo Mac, Windows e UNIX.	Ele também suporta rótulos coloridos para organizar melhor documentos e navegação dinâmica da rede para servidores de arquivos Mac, Windows e Unix.
O advogado que representa conceitos de tocha, Rich Marsden não respondeu a telefonemas repetidos.	Funcionários da Torch e JetBlue não responderam a telefonemas repetidos do Mercury News buscando comentários.
Ele foi voluntariamente castrado em 2001, uma operação que ele afirma que removeu sua capacidade de despertar sexualmente.	Devries, que foi voluntariamente castrado em agosto de 2001, disse que a cirurgia retirou sua capacidade de despertar sexualmente.
O composto S&P / TSX subiu 87,74 pontos na semana, enquanto o composto de troca de risco TSX ganhou 44,49 pontos.	Na semana, a média industrial da Dow Jones subiu 11,56 pontos, enquanto o mercado de ações da Nasdaq ganhou 39,42 pontos.
Por sua vez, o SUSE licenciará o Java 2 Standard Edition, ao mesmo tempo em formalizar um contrato existente para distribuir a máquina virtual Java da Sun para a execução de aplicativos Java.	O SUSE de Nuremberg, Alemanha, licenciará a Java 2 Standard Edition da Sun e a Machine Virtual Java da Sun Sun em sua linha de software Linux.
Os artistas estão preocupados com o plano que prejudicaria aqueles que mais precisam de ajuda - artistas que têm dificuldade em fazer fila.	Os artistas dizem que o plano prejudicará a cultura francesa e punirá aqueles que mais precisam de ajuda - artistas que têm dificuldade em alinhar o trabalho.
As longas filas se formaram fora dos postos de gasolina e as pessoas correram para obter dinheiro de máquinas de dinheiro no domingo, enquanto os israelenses se preparavam para enfrentar uma greve que ameaçava paralisar o país.	As longas filas se formaram domingo fora dos postos de gasolina e as pessoas correram para obter dinheiro de máquinas de dinheiro, enquanto os israelenses apoiados para os efeitos da greve.
O índice de composto Nasdaq pesado em tecnologia caiu 3,99, ou 0,2 %, para 1.682,72, após uma vitória de 55,93 de dois dias.	O índice de composto NASDAQ, com tecnologia, diminuiu 8,52 pontos, ou 0,51 %, para 1.670,21.
Martin, 58 anos, será libertado hoje depois de cumprir dois terços de sua sentença de cinco anos pelo homicídio culposo de Fred Barras, de 16 anos.	Martin cumpriu dois terços de uma sentença de cinco anos pelo homicídio culposo de Barras e por Fearon.
Não sabemos se algum será SARs ", disse o Dr. James Young, comissário de segurança pública de Ontário.	"Estamos sendo hiper-vigilantes", disse o Dr. James Young, Comissário de Segurança Pública de Ontário.
As vendas para o trimestre vencem as expectativas, aumentando 37 % ano a ano, para 1,76 bilhão de euros.	As vendas aumentaram 37 % ano a ano, para 1,76 bilhão, superando as expectativas.
A empresa disse que emitiria orientações revisadas para todo o ano fiscal do próximo mês, quando libera seus resultados no segundo trimestre.	A empresa disse que renovaria suas orientações para 2003, quando anuncia que seu segundo trimestre resulta em meados de julho.
Os acionistas da IDEC possuiriam 50,5 % das ações da empresa combinada e os acionistas da Biogen os 49,5 % restantes.	As empresas disseram que os detentores da IDEC possuiriam cerca de 50,5 % das ações da empresa combinada.
No entanto, o guru de código aberto insistiu: "Esse ataque estava errado e foi perigoso para nossos objetivos".	"Esse ataque estava errado e foi perigoso para nossos objetivos", disse Raymond.
"Não decidimos usar uma linha branca ininterrupta ou pontilhada, mas esse é um experimento que vale a pena apresentar", disse David Richardson, gerente de críquete da ICC.	"Nós não decidimos usar uma linha branca ininterrupta ou pontilhada", disse Dave Richardson, gerente de críquete da ICC.
Shinseki se aposenta na quarta-feira após uma carreira de 38 anos que incluiu combate no Vietnã e chefe dos EUA esforços de manutenção da paz na Bósnia.	A carreira de Shinseki incluiu combate no Vietnã e chefe dos EUA esforços de manutenção da paz na Bósnia.
O departamento também enviou amostras de água e solo ao Laboratório de Saúde do Estado.	As amostras de água estão sendo enviadas ao Departamento de Saúde do Estado para análise.
"Mas isso não os limpa da obrigação de fazer todo o possível para proteger os civis, e não é isso que estamos vendo".	"Mas isso não os limpa da responsabilidade de fazer todo o possível para minimizar os danos civis".
Ross Garber, advogado de Rowland, disse na terça -feira que compareceria à reunião e pediria para falar sobre o assunto.	Ross Garber, consultor jurídico de Rowland, disse que o governador não teria comentários sobre o acordo de condomínio.
A seu pedido, ele será transferido no distrito.	Superintendente Distrital j. Chester Floyd disse a repórteres na segunda -feira que McCrackin será transferido no distrito.
Frank Quattrone, o ex-Credit Suisse First Boston Technology Investment-Banking Guru, supostamente se declarou inocente na terça-feira por acusações de obstrução de justiça e adulteração de testemunhas.	NOVA YORK - (Dow Jones) - O ex -banqueiro de investimentos da estrela Frank Quattrone se declarou inocente na terça -feira por acusações criminais de obstrução de justiça e adulteração de testemunhas.
Um tribunal federal de apelações decidiu na terça -feira que o governo estava livre para reter os nomes de mais de 700 pessoas detidas após setembro de setembro. 11, 2001.	Um tribunal federal de apelações decidiu na terça -feira que os EUA O governo pode reter os nomes das pessoas detidas como parte da investigação de 11 de setembro, revertendo uma decisão do tribunal inferior.
Anteriormente, ele tinha visto o mecânico sorridente de Java Oriental apenas na televisão.	Hughes viu o rosto de Amrozi na televisão, as imagens infames do mecânico sorridente de Java East.
Dois anos depois, a cobertura do seguro começaria.	De acordo com o acordo, a cobertura do Medicare para benefícios de drogas começaria em 2006.
As imagens de satélite da NASA mostram que o gelo do Ártico está diminuindo a uma década de quase 10 %.	Os pesquisadores descobriram que o gelo do mar no Ártico está desaparecendo a uma taxa de 9 % a cada década.
O blue-chip Dow Jones Industrial Average .dji caiu 86,56 pontos, ou 0,94 %, para 9.109,99, depois de desistir de mais de 1 % antes.	A média industrial da Dow Jones .dji caiu 79,43 pontos, ou 0,86 %, para 9.117,12 na sexta -feira.
"Os produtos de biotecnologia, se alguma coisa, podem ser mais seguros que os produtos convencionais por causa de todos os testes", disse Fraley, acrescentando que 18 países adotaram biotecnologia.	"Os produtos de biotecnologia, se alguma coisa, podem ser mais seguros que os produtos convencionais por causa de todos os testes", disse Robert Fraley, vice -presidente executivo da Monsanto.
A média industrial da Dow Jones terminou o dia de 10,89 em 9.837,94, depois de avançar 111,04 quarta -feira.	A média industrial da Dow Jones caiu 10,89 pontos, ou 0,11 %, para 9.837,94.
A hora era por volta das 4 da manhã de 18 de março, poucas horas antes dos primeiros mísseis Pinpoint choveram na capital.	A apreensão ocorreu às 4 da manhã de 18 de março, poucas horas antes do primeiro American Air Assault.
Um professor certificado nacionalmente com um mestrado, Kelley faz um salário de US $ 65.000 em seu 30º ano.	Um professor certificado nacionalmente com um mestrado, Kelley, em seu ensino de 30 anos, ganha US $ 65.000.
Em Viena, a IAEA disse que Elbaradei aceitaria o convite, embora nenhuma data ainda tenha sido marcada.	Em Viena, a Agência Internacional de Energia Atômica disse na segunda -feira Elbaradei havia aceitado o convite do Irã, mas disse que nenhuma data ainda havia sido marcada.
O índice de composto NASDAQ com tecnologia <.ixic> subiu 7,42 pontos, ou 0,45 %, em 1.653,44.	O Índice 500 Standard e Poor Standard & Poor .Spx foi 0,46 pontos mais baixo, ou 0,05 %, em 997,02.
A epidemia começou em novembro na província de Guangdong, no continente, mas a República da China do povo se recusou a reportar com sinceridade sobre sua propagação por quatro meses.	A epidemia da RPC começou na província de Guandong em novembro, mas o governo do Partido Comunista se recusou a reportar com sinceridade sobre seu spread por quatro meses.
Druce enfrentará acusações de assassinato, disse Conte.	Conte disse que Druce será acusado de assassinato.
Isso comparado com US $ 35,18 milhões, ou 24 centavos por ação, no período do ano anterior.	Os ganhos foram afetados por um benefício fiscal não recorrente de US $ 8 milhões no período do ano anterior.
Os ministros da UE foram convidados para a conferência, mas cancelados porque o sindicato está fechando negociações sobre reforma agrícola, disse Gerry Kiely, um representante da Agricultura da UE em Washington.	Gerry Kiely, representante da Agricultura da UE em Washington, disse que os ministros da UE foram convidados, mas cancelados porque o sindicato está fechando negociações sobre reforma agrícola.
Nick Markakis, canhoto do Young Harris Junior College, na Geórgia, foi ao Orioles com a sétima escolha.	Em seguida, Baltimore levou Nick Markakis, um arremessador canhoto e defensor do jovem Harris Junior College, na Geórgia.
Continuamos esperançoso de que a cidade concorde em trabalhar conosco e participar de discussões de boa fé sobre esse assunto. "	Alhart disse que o governador "permanece esperançoso de que a cidade continue trabalhando conosco e se envolvendo em discussões de boa fé".
Algumas mulheres também estão preocupadas com o fato de tantas mulheres estarem recorrendo à cirurgia estética em uma busca pela perfeição corporal.	Algumas mulheres também expressam preocupação com uma sociedade na qual mais pessoas do que nunca estão se voltando para uma cirurgia estética em uma busca pela perfeição corporal.
A notificação foi relatada pela primeira vez na sexta -feira pelo MSNBC.	MSNBC.com primeiro relatou o pedido da CIA na sexta -feira.
"Agora, o outro cara, ele tem vergonha de sua festa", disse Street para rir.	"O outro cara, ele tem vergonha de sua festa, e eu não o culpo.
Desde então, Perry convocou duas sessões legislativas especiais para tentar forçar o plano de redistribuição.	Desde então, o Texas Gov. Rick Perry chamou duas sessões especiais tentando promover a medida.
No entanto, não há foto de Peter Hollingworth na edição de junho examinada pelo Herald ontem.	No entanto, não há fotografia do Dr. Hollingworth na edição de junho da revista examinada pela época de ontem.
Em sua nova posição, a Dynes ganhará US $ 395.000, um aumento significativo sobre o salário de Atkinson de US $ 361.400.	A Dynes receberá US $ 395.000 por ano; O salário de Atkinson é de US $ 361.400.
"Continuamos trabalhando com os sauditas nisso, mas eles não o fizeram, até o momento deste trágico evento, forneceu a segurança adicional que solicitamos".	"Mas eles não, até o momento deste evento trágico em particular, forneceram a segurança que havíamos solicitado", disse Jordan.
A agência "considerará em tempo hábil quaisquer declarações fiscais ou pagamentos devidos" agosto. 15 Se eles forem enviados até agosto. 22.	A agência disse que consideraria em tempo hábil quaisquer declarações fiscais ou pagamentos devido de sexta a agosto. 22 Se eles forem concluídos até agosto. 22.
Um comunicado divulgado por Dei disse que Green começaria a dirigir o carro em uma base intermediária, começando na próxima semana no Winston Open no Motor Speedway da Lowe.	Foi anunciado que Green substituirá o Park na Dale Earnhardt Inc. não. 1 Chevrolet, começando com o Winston Open no Motor Speedway da Lowe na próxima semana.
O adversário da semifinal de Costa é o espanhol Juan Carlos Ferrero, a quem ele venceu na final do ano passado.	Costa jogará Juan Carlos Ferrero em seguida em uma revanche da final do ano passado.
Os médicos especularam que o próprio estrogênio do corpo protege contra danos celulares e melhora o fluxo sanguíneo.	Sua crença foi baseada na especulação de que o estrogênio impede o dano celular e melhora o fluxo sanguíneo.
O índice de composto NASDAQ com tecnologia <.ixic> adicionou 8,27 pontos, ou 0,51 %, a 1.633,53.	O Índice de 500 do Standard e Poor Standard & Poor .spx aumentou 4,3 pontos, ou 0,44 %, para 980,52.
Atualmente, os democratas têm uma vantagem de 17 a 15 na delegação do Congresso do estado.	A delegação do Congresso do Texas agora é de 17 a 15 democrata.
Nenhum americano foi relatado entre as baixas, de acordo com o capitão. Michael Calvert, porta -voz do regimento.	Nenhuma das baixas eram americanos, disse o capitão. Michael Calvert, porta -voz do regimento.
Achamos que eles têm o direito de escolher.	"Achamos que os clientes da PeopleSoft merecem o direito de escolher", disse Ellison.
"Encontramos a arma de fumar", disse Scott Hubbard, membro do conselho.	"Encontramos a arma de fumar", disse Hubbard, diretor do Centro de Pesquisa Ames da NASA na Califórnia.
Chaudhry foi libertado 56 dias depois e os militares de Fiji instalaram um governo indígena liderado por Qarase, que venceu as eleições democráticas em setembro de 2001.	Os militares de Fiji instalaram um governo indígena liderado por Qarase, que venceu as eleições democráticas em setembro de 2001.
Mas, no final, tudo o que o worm fez foi visitar um site de pornografia, disse Vincent Weafer, diretor de segurança da Symantec Security Response na Califórnia.	Mas Vincent Weafer, diretor de segurança da Symantec Security Response, disse que tudo o que o vírus fez foi visitar um site de pornografia.
"Essa criança foi literalmente negligenciada à morte", disse o promotor do condado de Armstrong, Scott Andreassi.	O procurador do distrito do condado de Armstrong, Scott Andreassi, disse que as muitas fotos de família em casa não incluíram Kristen.
A Microsoft disse na sexta -feira que está interrompendo o desenvolvimento de futuras versões do Macintosh de seu navegador do Internet Explorer, citando a concorrência do navegador Safari da Apple Computer.	A Microsoft parará de desenvolver versões de seu software de navegador do Internet Explorer para computadores Macintosh, dizendo que o Safari da Apple agora é tudo o que a Apple precisa.
Chapman não foi preso imediatamente e deve aparecer para a acusação em 3 de julho.	senhor. Chapman, que não foi preso, deve comparecer à acusação na próxima quinta -feira, disseram os promotores.
O presidente Bush levantou um recorde de US $ 49,5 milhões para sua campanha de reeleição nos últimos três meses, com contribuições de 262.000 americanos, disse o presidente da campanha do presidente na terça-feira.	O presidente Bush levantou US $ 83,9 milhões desde o início de sua campanha de reeleição em maio e tem US $ 70 milhões para gastar, informou sua campanha na terça-feira.
As autoridades de Ohio, Indiana e Michigan procuraram os corpos.	Até agora, as autoridades também pesquisaram áreas na Pensilvânia, Ohio, Indiana e Michigan.
Ele disse que os governos europeus "bloquearam todas as novas bio-cultos por causa de medos infundados e não científicos.	"Eles bloquearam todas as novas bio-cultos por causa de medos infundados e não científicos", disse Bush.
Uma pergunta era se a França, que enfureceu Washington ao liderar a acusação contra a ONU. Autorização para a guerra, votaria "sim" ou se abstenha.	França, que enfureceu Washington ao liderar a acusação contra a ONU. A aprovação para a guerra também procurou mudanças.
O procurador do distrito do condado de Luzerne, David Lupas, disse em entrevista coletiva na segunda -feira que as autoridades estavam `` continuando a fazer progressos significativos '' no caso.	Nenhuma acusação foi apresentada nessas mortes, mas o promotor do condado de Luzerne, David Lupas, disse que as autoridades estavam "continuando a fazer progressos significativos" no caso.
os EUA O Conference Board disse que sua última medida de confiança nos negócios atingiu 60 depois de cair para 53 em sua pesquisa no primeiro trimestre.	O conselho da conferência disse que sua medida de confiança nos negócios, que caiu para 53 no primeiro trimestre de 2003, melhorou para 60 no segundo trimestre mais recente.
Os juízes disseram que a Constituição permite que o governo administre apenas medicamentos "em circunstâncias limitadas".	Em uma decisão de 6-3, os juízes disseram que esses medicamentos antipsicóticos podem ser usados ​​apenas em "circunstâncias limitadas".
Seus representantes legais começaram a se reunir com os advogados dos demandantes na semana passada para discutir um acordo.	Os advogados da Arquidiocese e dos Autores começaram a se reunir na semana passada para chegar ao acordo fora da quadra.
Os idosos teriam que pagar 50 % de seus custos de drogas até US $ 3.450.	Acima disso, o Medicare pagaria 90 % de todos os custos com drogas.
A veterana diplomata da Malyasian conheceu Suu Kyi na quarta -feira na casa do lago em Yangon, onde está em prisão domiciliar.	Razali Ismail se reuniu por 90 minutos com Suu Kyi, uma vencedora de 1991 do Prêmio Nobel da Paz, em sua casa à beira do lago, onde está em prisão domiciliar.
O empresário extravagante sinalizou o plano depois de uma reunião em Londres com o ministro do Turismo da Austrália, Joe Hockey.	Sir Richard estava falando após uma reunião em Londres com o ministro do Turismo da Austrália, Joe Hockey.
Os títulos do governo foram vendidos bruscamente depois que Greenspan disse ao Congresso na terça -feira que os EUA A economia "poderia muito bem estar embarcando em um período de crescimento prolongado".	Greenspan disse ao Congresso na terça -feira que os EUA A economia "poderia muito bem estar embarcando em um período de crescimento sustentado".
Novo serviço de download legítimo lançamentos com usuários de PC em mente.	Buymusic é o primeiro serviço de música para download pago sem assinatura para usuários de PC.
Para Kathy Nicolo (Jennifer Connelly), a casa significa estabilidade e família.	Kathy Nicolo (Jennifer Connelly) está desesperada por sua família não descobrir que sua vida se desfez.
O título de 30 anos US30YT = RR aumentou 22/32 para um rendimento de 4,31 %, contra 4,35 % no fechamento de quarta-feira.	O título de 30 anos US30YT = RR cresceu 1-3 / 32 para um rendimento de 4,30 %, abaixo dos 4,35 % na quarta-feira.
O índice de atividade de não manufatura do Instituto de Gerenciamento de Suprimentos aumentou inesperadamente em abril, disseram relatórios.	O Institute for Supply Management disse que seu índice de atividade não manufature aumentou para 50,7 de 47,9 em março.
Na semana passada, seus advogados perguntaram ao Gov. Mark r. Warner para conceder clemência, mas o governador se recusou a intervir.	Na semana passada, seus advogados pediram à Warner que concedesse clemência sob certas condições que levariam a uma nova audiência de sentença.
A porta -voz da Maria Cheng concordou, dizendo: "Parece muito com um evento isolado".	"Parece muito com um evento isolado", disse a porta -voz da Organização Mundial da Saúde, Maria Cheng.
A polícia disse que seus dois filhos pequenos estavam sozinhos no apartamento por até dois dias.	A polícia disse que seus dois filhos pequenos estavam sozinhos por até dois dias enquanto ela estava morta.
O padre, o REV. John f. Johnston, 64, da 35th Avenue em Jackson Heights, foi acusado de assédio agravado e posse criminosa de uma arma.	o REV. John Johnston, 64 anos, foi acusado de assédio agravado na caixa de telefone e por posse criminal de uma arma, de acordo com uma declaração policial.
Gov. Linda Lingle e membros de sua equipe estavam na base da Marinha e assistiram ao lançamento.	Gov. Linda Lingle e outros dignitários estão programados para estar na base para assistir ao lançamento.
O acordo inclui US $ 4,1 milhões em honorários e despesas de advogados.	Os advogados dos queixosos receberiam US $ 4,1 milhões do acordo.
Três nenhum voto o mataria por enquanto.	Seriam necessários três votos para matar a expansão do ACC.
São realizados cerca de 660 prisioneiros de 42 países, incluindo o Canadá, muitos capturados durante a guerra contra no Afeganistão, a rede da Al Qaeda.	Cerca de 660 prisioneiros de 42 países estão sendo mantidos na base naval da Baía de Guantánamo, muitos capturados durante a guerra contra a Al Qaeda no Afeganistão.
para chegar a João a. Dvorak, que cobre o Kansas, ligue para (816) 234-7743 ou envie um e-mail para jdvorak @ kctar.com.	Para chegar a Brad Cooper, repórter municipal do condado de Johnson, ligue para (816) 234-7724 ou envie um e-mail para bcooper @ kcstar.com.
O promotor Jim Hardin chamou a decisão de vitória para a família de Kathleen Peterson.	Os membros da família de Kathleen Peterson não estavam presentes.
À primeira vista, a distinção desenhada pelos criadores do registro de não chamadas parece desenhar a linha precisamente no lugar certo.	À primeira vista, os criadores do registro parecem ter desenhado a linha entre chamadas isentas e proibidas no lugar certo.
E agora é tudo o que ele quiser dizer: Alesha Badgley, diretor social do Centro de Enfermagem e Reabilitação de Stone County, disse nesta semana.	E agora é tudo o que ele quiser dizer ", confirmou o diretor social do Centro de Enfermagem e Reabilitação de Stone County, Alesha Badgley.
A denominação nacional da Igreja Episcopal, com 2,3 milhões de membros, é os EUA ramo da comunhão anglicana de 77 milhões de membros.	A Igreja Episcopal, com 2,3 milhões de membros, é o ramo americano da Comunhão Anglicana em todo o mundo, que possui 77 milhões de adeptos.
"Sinto -me confiante dizendo que a HP não é mais uma história de integração", disse Fiorina.	"Ainda temos muito o que fazer, mas sinto -me confiante de que a HP não é mais uma história de integração".
A polícia britânica prendeu 21 pessoas na terça -feira em conexão com o suspeito assassinato ritual de um garoto africano cujo torso foi encontrado no rio Thames.	A polícia prendeu 21 pessoas em conexão com o assassinato de uma criança nigeriana cujo tronco sem cabeça e sem limite foi encontrado flutuando no rio Tamisa.
O melhor que os pesquisadores podem fazer é entender o processo e a substância de decisões de negócios isoladas ... e questionar sua competência como gerente. "	O advogado de Ebbers, Reid Weingarten, disse, apesar da investigação completa: "o melhor que os investigadores podem fazer é entender o processo e a substância de decisões de negócios isoladas".
No final da tarde, a média industrial da Dow Jones subiu 12,81, ou 0,1 %, em 9.331,77, tendo ganhado 201 pontos na segunda -feira ao seu nível mais alto desde julho de 2002.	No comércio matinal, a média industrial da Dow Jones caiu 8,76, ou 0,1 %, em 9.310,20, tendo ganhado 201 pontos na segunda -feira.
O presidente ucraniano Leonid Kuchma interrompeu hoje uma visita à América Latina como uma luta de fronteira amarga entre a Ucrânia e a Rússia se deteriora ainda mais.	A disputa levou o presidente ucraniano Leonid Kuchma a interromper uma visita de estado à América Latina.
O Departamento de Justiça entrou com uma ação na quinta-feira contra o Estado do Mississippi por não terminar o que as autoridades federais chamam de abuso "perturbador" de jovens e condições "inconscicionais" em duas instalações estatais.	O Departamento de Justiça entrou com um processo de direitos civis na quinta-feira contra o Estado do Mississippi, alegando abuso de infratores juvenis em duas instalações estatais.
O zagueiro do Chelsea, Marcel DeSailly, foi o mais recente a se manifestar.	Marcel DeSailly, o capitão da França e o zagueiro do Chelsea, acredita que o último é verdadeiro.
As autoridades chechenas que trabalham para o governo apoiado por Moscou são uma meta frequente para rebeldes e a tensão está alta antes da eleição presidencial do próximo domingo na Chechênia devastada pela guerra.	Autoridades do governo apoiado por Moscou da Chechênia são uma meta frequente para os rebeldes, e a tensão está alta antes da eleição presidencial de domingo na região devastada pela guerra.
Eric Gagne fez um nono perfeito para sua 23ª defesa em tantas oportunidades.	Gagne marcou dois em um nono turno perfeito para sua 23ª defesa.
As ações fecharam na NASDAQ logo abaixo de sua alta de 52 semanas, por US $ 32,17, US $ 1,54.	A negociação das ações da Echostar fechou terça-feira com uma alta de 52 semanas de US $ 32,17, um aumento de US $ 1,54.
Ela era a única mulher em sua unidade e membro da Teamsters Local 995.	Ela era a única mulher empregada como trabalhadora de armazém e operadora de equipamentos pesados ​​e a única mulher em suas equipes locais.
Janice Kelly disse que seu marido recebeu garantias de altos funcionários do mod de que seu nome não seria tornado público.	Ela disse ao inquérito que seu marido havia recebido garantias de seu gerente de linha e altos funcionários do ministério de que, quando ele se apresentou, seu nome não seria tornado público.
Se condenados, eles enfrentam até cinco anos de prisão e uma multa de US $ 250.000 em cada uma das 11 acusações.	Se condenado, cada um enfrenta até cinco anos de prisão e uma multa de US $ 250.000 ou mais com base na quantidade de ganhos envolvidos.
A polícia especial deteve Khodorkovsky no início do sábado, na cidade da Siberiana de Novosibirsk, onde seu avião havia feito uma parada de reabastecimento.	A polícia deteve Khodorkovsky no início do sábado, quando seu jato fez uma parada de reabastecimento na cidade da Siberiana de Novosibirsk.
A Sony Ericsson também disse que encerraria seu centro de P&D GSM / UMTS em Munique, Alemanha, para aumentar a lucratividade.	A Sony Ericsson também disse que planeja fechar seu local de P&D em Munique, Alemanha, para os aparelhos GSM e UMTS.
Mas o país está se esforçando para impedir que se espalhe para a vasta paisagem, onde a maioria de seus 1,3 bilhões de pessoas vivem.	A China está se esforçando para impedir que a doença se espalhe para o campo, onde a maioria de seus 1,3 bilhões de pessoas vive.
Os registros do Departamento de Saúde e Meio Ambiente do Kansas mostram que houve 88 abortos realizados em meninas de 14 anos ou mais no ano passado.	As estatísticas do Departamento de Saúde e Meio Ambiente do Kansas mostram que 11.844 abortos foram realizados no estado no ano passado.
nós. O rendimento de títulos corporativos se espalhou nas negociações irregulares na sexta -feira, quando Wall Street trabalhou para se levantar após a maior falta de energia de todos os tempos na América do Norte.	nós. As ações subiram um pouco no volume da luz de penas na sexta-feira, quando Wall Street se reagrupou após a maior queda de energia da América do Norte.
A evacuação correu bem, embora os passageiros não tenham dito o que estava acontecendo, disse Hunt.	Os passageiros foram evacuados sem problemas, embora não tenham sido informados o que estava acontecendo, disse ele.
"A descoberta de que o bug do mapa está presente na grande maioria dos sofredores de Crohn significa que está quase certamente causando a inflamação intestinal", afirmou em comunicado.	Os pesquisadores dizem que o fato de o bug do mapa estar presente na grande maioria dos pacientes com Crohns significa que está quase certamente causando a inflamação intestinal.
Entre 1993 e 2002, foram relatadas 142 alegações de agressão sexual.	De 1993 a 2002, houve 142 agressões sexuais relatadas na Academia.
Smith disse simplesmente "Oh, meu Deus", nos segundos depois, de acordo com Weinshall.	Nos segundos após o acidente, ela acrescentou, o capitão Smith disse simplesmente: "Oh meu Deus".
A expectativa de vida dos meninos nascidos em 2001 foi de 74,4 anos, dois anos desde 1990.	Segundo o relatório, a expectativa média de vida aumentou quase dois anos desde 1990.
Cooley disse que espera que Muhammad seja chamado da mesma forma como testemunha em uma audiência pré -julgamento para Malvo.	Lee Boyd Malvo será chamado como testemunha na quarta -feira em uma audiência pré -julgamento para o companheiro de atirador de elite John Allen Muhammad.
"Ele realmente nos deixou com um sorriso no rosto e sem as últimas palavras", disse a filha Linda Hope.	"Ele realmente nos deixou com um sorriso no rosto e sem as últimas palavras ... ele nos deu um beijo e foi isso", disse ela.
Durante o período completo de 12 meses, as conexões de modem a cabo de alta velocidade aumentaram 49 %.	No período do ano inteiro, encerrado em 30 de junho de 2003, as linhas de alta velocidade aumentaram 45 %.
Ele também poderia ser barrado permanentemente do setor de valores mobiliários.	Young enfrenta uma excelente, suspensão ou sendo permanentemente barrada da indústria de valores mobiliários.
"Eles eram um casal inspirador, altruísta e corajoso", disse o diretor de cinema vencedor do Oscar.	Ele disse: “Eles eram um casal inspirador, altruísta e corajoso.
Acreditamos que o relatório é totalmente consistente com o que os tribunais decidiram ... que as ações do departamento estão totalmente dentro da lei.	Comstock disse que vários tribunais federais decidiram que as detenções estão totalmente dentro da lei.
Uma segunda vítima, Michael Walker, 23 anos, foi atingida no torso, a bala perfurando seu pulmão.	A outra vítima, Michael Walker, da 550 Barbey Street, foi atingida no pescoço.
Cerca de 25 governos assinaram nos últimos quatro meses, cerca de metade dos dos últimos três semanas.	De acordo com a lista do Departamento de Estado, cerca de 25 nações assinaram acordos bilaterais nos últimos quatro meses, cerca da metade nas últimas três semanas.
Em uma entrevista, Healey, que é um criminologista, reconheceu que grande parte do sentimento entre os legisladores aqui e em todo o país era cautela em relação à pena de morte.	Em uma entrevista, MS. Healey, que é criminologista, disse que muitos parlamentares aqui e em todo o país compartilharam uma cautela em relação à pena de morte.
A juíza-executiva do condado de Franklin, Teresa Barton, disse que um bombeiro foi atingido por um raio e foi levado ao Centro Médico Regional de Frankfort.	Um bombeiro do condado, foi atingido por um raio e estava em estado estável no Centro Médico Regional de Frankfort.
porta -voz da polícia Brig. gen. Edward Aritonang confirmou no sábado que outros dois foram presos, um em Jacarta e outro em Magelang, Central Java.	O general do brigadeiro Edward Aritonang, porta -voz da polícia, confirmou ontem que outros dois foram presos, um em Jacarta e outro em Magelang, Java Central.
O juiz federal William Barbour disse na terça -feira que impôs a sentença máxima porque os Avants não demonstraram remorso na brutal assassinato.	nós. O juiz distrital William Barbour disse que impôs o máximo porque os Avants não demonstraram remorso.
De fato, Sr. Weill, um viciado em trabalho auto-descrito, disse que planejava permanecer muito envolvido na empresa.	Ainda assim, Sr. Weill continuará sendo um poder na empresa.
Cerca de 120 jurados em potencial estavam sendo solicitados a concluir um longo questionário.	Os jurados foram levados para o tribunal em grupos de 40 anos e pediram para preencher um questionário.
Cinco jurados alternativos também foram escolhidos, com um final definido para ser selecionado sexta -feira de manhã no painel.	Cinco jurados alternativos também foram selecionados, com uma sexta suplente a ser escolhida na sexta -feira.
Gregory Parseghian, ex -banqueiro de investimentos, foi nomeado CEO.	Greg Parseghian foi nomeado o novo executivo -chefe.
O California Farm Bureau não retornou imediatamente ligações em busca de comentários.	O California Farm Bureau não teve imediatamente uma resposta oficial à decisão de terça -feira.
O relatório cita o casamento do suposto comandante operacional dos atentados Bali, Mukhlas, com Farida, uma "jovem altamente cosmopolita e bem-educada".	O relatório cita o casamento do suposto comandante operacional dos atentados de Bali, Mukhlas, como um exemplo de como Ji usa o casamento para crescer.
O Conselho do Berço de Liberdade não é o primeiro a reverter a posição do grupo nacional.	O Conselho da Filadélfia não é o primeiro a desafiar a política nacional.
Mas o primeiro -ministro disse à BBC que não se incomodava com as pesquisas e que continuaria fazendo o que acreditava estar certo.	Ele disse que não se incomodou com as pesquisas e que continuaria fazendo o que acreditava estar certo, tanto na política estrangeira quanto doméstica.
gen. Sattler lidera uma força -tarefa conjunta combinada baseada no navio no Golfo de Aden e no Oceano Índico.	O general Sattler lidera uma força -tarefa conjunta combinada a bordo do navio de comando Monte Whitney.
"É absurdo", disse o treinador do Funny Cide, Barclay Tagg.	Enquanto isso, o treinador de Funny Cide, Barclay Tagg, chamou as alegações de "ridículas".
O painel ordenou que o departamento de comércio emitisse números revisados ​​para as tarefas dentro de 60 dias.	Ele pediu ao departamento de comércio que responda dentro de 60 dias.
Os analistas de Wall Street esperavam 22 centavos por ação, de acordo com Thomson Primeira chamada.	Os resultados foram de 3 centavos por ação abaixo da previsão de analistas pesquisados ​​pela Thomson First Call.
A decisão legal segue três dias de intensa especulação Hewlett-Packard co. pode estar oferecendo lances para a empresa.	A decisão legal segue três dias de volatilidade selvagem nas ações da RIM sobre especulações de que a gigante do PC Hewlett-Packard Co. pode estar oferecendo lances para a empresa.
No ano passado, autoridades cubanas disseram que nenhuma das quase duas dúzias de músicos cubanos nomeados receberam os EUA vistos a tempo para participar do Grammy em Los Angeles.	Autoridades cubanas disseram que no ano passado nenhuma de cerca de duas dúzias de músicos cubanos indicados a receberam os EUA Vistos a tempo de comparecer ao Grammy latino.
As descobertas foram publicadas na edição de 1º de julho dos Anais da Medicina Interna.	As descobertas estão sendo publicadas hoje nos anais da medicina interna.
As medidas podem ser adotadas pelo Senado completo na sexta -feira.	Ratliff disse que espera levar as duas medidas ao Senado completo até sexta -feira.
O porta -voz da Enron, Eric Thode, se recusou a comentar sobre a ordem de mediação.	"Achamos que é uma ótima notícia", disse o porta -voz da Enron, Eric Thode.
Os analistas do Departamento do Trabalho acham que as estatísticas da folha de pagamento da pesquisa de empresas fornecem uma imagem mais precisa da economia porque os números da pesquisa são baseados em uma amostra maior.	Os analistas disseram acreditar que as estatísticas da folha de pagamento fornecem uma imagem mais precisa da economia porque são baseadas em uma amostra maior.
Os pais querem que ela se mantivesse viva; Seu marido diz que nunca quis ser mantida viva artificialmente.	Michael Schiavo argumentou que sua esposa nunca quis ser mantida viva artificialmente.
Anteriormente, ele disse à França Inter-Radio: "Acho que agora podemos qualificar o que está acontecendo como uma epidemia genuína".	"Acho que agora podemos qualificar o que está acontecendo como uma epidemia genuína", disse o ministro da Saúde Jean-Francois Mattei na França Inter Radio.
Terri Schiavo, 39, deve morrer nas próximas duas semanas no hospício da área de Tampa, onde passou os últimos anos.	Terri Schiavo, 39 anos, passou pelo procedimento no Hospice da Área de Tampa Bay, onde vive há vários anos, disse seu pai, Bob Schindler.
A empresa lançará 800 pontos quentes, ou "zonas Wi-Fi", no final deste verão, e planeja ter mais de 2.100 até o final do ano.	O serviço será lançado no final deste verão com 800 locais e a Sprint planeja 2.100 locais até o final do ano.
Antes de ingressar na Kodak, Palumbo trabalhou para a Procter & Gamble Corp. , onde ele administrou produtos como Folgers e Pantene Shampoo.	Antes de ingressar em Eastman Kodak, MR. Palumbo ocupou cargos de marketing sênior da Procter & Gamble.
McDevitt recebeu o controle de três aspectos cruciais do policiamento nos Salomões.	McDevitt recebeu o controle de três aspectos do policiamento pelo comissário William Morrell.
A ascensão do ouro elevou outros metais preciosos mais alto, desviando a prata para US $ 4,81 / 83 a uma onça de US $ 4,77 / 79 citados pela última vez em Nova York.	O salto de Gold aumentou outros metais preciosos, enviando prata para US $ 4,83 / 85 a uma onça de US $ 4,80 / 82 citados pela última vez em Nova York.
Funcionários da North Carolina Speedway em Rockingham não foram encontrados.	As autoridades da NASCAR não foram encontradas para comentar na terça -feira.
Eles disseram que a criança foi levada ao Centro Médico do Condado de Nassau para observação.	O garoto foi levado ao Centro Médico da Universidade de Nassau, onde os funcionários disseram que estava "indo bem".
Tisha Kresler, porta -voz da Crossing Global, se recusou a comentar.	Um representante global de cruzamento não teve comentários imediatos.
As ações da LendingTree subiram US $ 5,99, ou 40,1 %, para US $ 20,68 nas negociações da tarde no mercado de ações da NASDAQ.	As ações da LendingTree subiram US $ 6,21, ou 42 %, para US $ 20,90, depois de atingir US $ 21,36 antes.
Os sindicatos também realizaram uma greve de cinco dias em março que forçou todos, exceto um dos salões de jantar de Yale a fechar.	Os sindicatos também realizaram uma greve de cinco dias em março; Os ataques precederam oito dos últimos 10 contratos.
Gov. Rick Perry disse que, embora se opusesse à expansão do jogo, ele relutava em vetar a continuação da Comissão da Loteria.	Gov. Rick Perry se opõe à expansão do jogo, mas disse que seria "pressionado" para vetar a conta do pôr-do-sol da loteria.
Na negociação no meio da tarde, o índice de composto da NASDAQ subiu 8,34, ou 0,5 %, para 1.790,47.	O índice de composto NASDAQ .ixic caiu 8,59 pontos, ou 0,48 %, para 1.773,54.
Em Kentucky, o procurador -geral democrata Ben Chandler enfrenta os EUA Rep. Ernie Fletcher.	Kentucky: O republicano Ernie Fletcher, membro da Câmara de três mandatos, está lutando contra o procurador-geral democrata Ben Chandler.
A média industrial da Dow Jones caiu 98,32, ou cerca de 1,1 %, para 9011,53.	A média industrial da Dow Jones terminou o dia em queda de 98,32 pontos em 9.011,53.
O plano 401 (k) da Enron cobriu cerca de 20.000 trabalhadores, aposentados e beneficiários.	As ações da Enron compreendiam até 61 % das portfólios 401 (k) dos trabalhadores.
O Comitê Judiciário do Senado dos EUA superou um obstáculo significativo ontem na batalha para criar um fundo fiduciário para pagar vítimas de exposição ao amianto.	O Comitê Judiciário do Senado venceu na terça -feira um obstáculo significativo na batalha para criar um fundo fiduciário para pagar vítimas de exposição ao amianto, mas os obstáculos mais difíceis permanecem.
Mas ela não disse se ela certificará o orçamento de dois anos de US $ 117,4 bilhões para 2004-05.	Ela disse que ainda não sabia se certificaria o orçamento.
Seria difícil superestimar os perigos potenciais da vulnerabilidade de Chamada de Procedimento Remoto (RPC).	A falha envolve o protocolo de chamada de procedimento remoto (RPC), que lida com comunicações entre computadores.
Embora a obesidade possa aumentar o risco de problemas de saúde, argumentam os céticos, o mesmo acontece com o fumo e o colesterol alto.	Embora a obesidade possa aumentar o risco de uma série de problemas de saúde, argumentam os céticos, o mesmo acontece com o fumo e o colesterol alto, que não são considerados doenças.
Michelle Wie Chips no domingo, durante sua vitória por 1 a Virada Nirapathpongporn no 27º EUA Campeonato de Links Públicos Amadores das Mulheres.	Agora ela tem seu primeiro troféu após a vitória nos vínculos públicos amadores de mulheres dos EUA aqui no domingo.
A Sony disse que o PSP também apresentaria uma tela LCD de 4,5 polegadas, slots de expansão de stick de memória.	Ele também possui um 4,5 na tela LCD e instalações de expansão de memória com iluminação traseira.
Em um dos três locais de amostragem em Huntington Beach, a leitura de bactérias voltou aos 160 em 16 de junho e 120 em 23 de junho.	As leituras voltaram aos 160 nos dias 16 e 120 de junho, em 23 de junho, em um dos três locais de amostragem em Huntington Beach.
Os conservadores americanos estão claramente em minoria dentro da Igreja Episcopal.	A carta indica o interesse do Vaticano em reforçar os conservadores na Igreja Episcopal.
Onde linhas longas costumavam capturar 10 peixes por 100 ganchos nas últimas décadas, agora têm sorte de pegar um, segundo o estudo.	"Enquanto as longas filas usadas para pegar 10 peixes por 100 ganchos, agora têm sorte de pegar um", disse Myers.
O novo livro do senador de Nova York, "Living History", aparece um certo best -seller.	Hillary Clinton, senadora de Nova York e ex -primeira -dama, tem um livro de segunda -feira intitulado Living History.
Carnival Corp. As ações estavam sendo negociadas a US $ 31,29 durante as negociações do meio -dia de quarta -feira, queda de 72 centavos ou 2,25 %.	Carnival Corp. As ações caíram 2,5 %, ou 81 centavos, a US $ 31,20 na Bolsa de Valores de Nova York.
Mas as críticas ao Senado ao Plano da Câmara ocorreram na terça -feira em várias frentes.	e vários republicanos do Senado estão irritados com o mapa da Câmara.
Como resultado, Murphy procurou substituir a irmã de Strier, Ethel Celnik, como administrador.	Murphy disse que a irmã de Strier, Ethel Celnik, estava no tribunal na época, mas Strier não estava.
Custará cerca de US $ 20.000 por curso de oito semanas de tratamento, comparável a outras terapias de câncer injetadas, disse uma porta-voz.	Custará cerca de US $ 20.000 por curso médio de tratamento -16 a 17 semanas.
A regra impede grupos de anúncios que promovem, apóiam, atacam ou se opõem a um candidato a qualquer momento.	Ele confirmou as regras de fallback que impedem os mesmos grupos de publicar anúncios que promovem, apoiam, atacam ou se opõem a um candidato a qualquer momento.
A Cisco reduziu os gastos para compensar as vendas lentas.	Em resposta às vendas lentas, a Cisco reduziu os gastos.
Kansas City convocou o jogador Chris Lubanski, da Kennedy-Kenrick High School, na Pensilvânia, com a quinta escolha.	O Royals escolheu Chris Lubanski, um defensor do ensino médio da Pensilvânia que atingiu .528, com a quinta escolha.
Sterling caiu 0,8 % em relação ao dólar em US $ 1,5875 GBP =.	O dólar subiu 0,15 % em relação à moeda japonesa para 115,97 ienes.
A média industrial da Dow Jones .dji subiu 41,61 pontos, ou 0,44 %, para 9.415,82.	O Dow Jones subiu 41,61 pontos na sexta -feira, um ganho de 0,4 % no dia e 0,7 % na semana.
"Desde o início, não queríamos ver alguém fazer um corte no salário.	mas Sr. Crosby disse à Associated Press: "Desde o início, não queríamos ver alguém fazer um corte no pagamento.
"Houve vários sinais burocráticos e administrativos - não há uma pessoa responsável aqui", disse Gehman.	Ao recusar a oferta da NIMA, Gehman disse: '' Houve vários sinais de perdidos burocráticos e administrativos aqui.
Devries fez uma parada na cidade na quarta -feira - registrando -se como agressor sexual no Departamento de Polícia de Soledad.	O molestador de crianças condenado Brian Devries falou em resposta à indignação da comunidade na quarta -feira à tarde depois de se registrar como criminoso sexual no Departamento de Polícia de Soledad.
às 17h EDT, o centro de Grace ficava perto da latitude 25,6 norte, longitude 93,7 oeste ou cerca de 280 milhas leste-sudeste de Corpus Christi.	Às 11 horas da manhã, o Centro de Fabian ficava perto da latitude 18,1 norte e longitude 53,2 oeste, ou cerca de 550 milhas a leste dos Leewards.
No sábado, um saque de 149 mph contra Agassi igualou o recorde mundial de Russeski.	No sábado, Roddick igualou o recorde mundial com um 149 m.p.h. Sirva em vencer Andre Agassi.
Equipes de inspetores entraram em uma área restrita em um parque sem serem parados; Outros tiraram fotos de áreas sensíveis sem serem desafiadas.	Equipes de inspetores entraram em uma área restrita em um parque sem serem parados pelos funcionários; Outros tiraram fotos de áreas sensíveis à segurança sem que ninguém os contestasse.
O Índice 500 Standard e Poor Standard & Poor .spx subiu 10 pontos, ou 1,10 %, para 943.	O índice de composto Nasdaq .ixic saltou 43,64 pontos, ou 2,89 %, para 1.553,73.
Outubro de aquecimento de petróleo Os futuros de petróleo liquidaram 0,85 centavos em 69,89 centavos por galão.	O óleo de aquecimento de outubro terminou 0,41 centavo a 70,74 centavos por galão.
Levine confirmou que Cohen Alon tentou vender a história durante a Copa do Mundo.	O advogado de Ms Cohen Alon, Donald Levine, confirmou que tentou vender a história em fevereiro.
senhor. Bankhead disse que as cenas de crime indicaram que o assassino era "muito metódico".	O porta -voz do GBI, John Bankhead, disse que as cenas de assassinato mostraram que o assassino era muito metódico.
"Isso nos leva muito mais perto de dizer que a espuma pode causar esse tipo de dano", disse Hubbard, membro do Conselho de Investigação de Acidentes de Columbia.	"Acho que isso nos leva muito mais perto de dizer que a espuma pode causar esse tipo de dano", disse Hubbard.
"Não tínhamos nada a ver com a decisão interna de pessoal de @ Stake", disse o porta -voz da Microsoft, Sean Sundwell.	"A Microsoft não tinha absolutamente nada a ver com a decisão de pessoal interno de Atstake", disse Sundwall.
Os egiptologistas lançaram dúvidas na terça-feira à alegação de uma expedição de que ela pode ter encontrado a múmia da rainha Nefertiti, um dos egípcios antigos mais conhecidos.	Os egiptólogos pensam que podem ter identificado a mamãe da rainha Nefertiti há muito procurada, uma das belezas lendárias do mundo antigo.
Os rovers idênticos atuarão como geólogos robóticos, procurando evidências de água passada.	Os Rovers atuam como geólogos robóticos, movendo -se em seis rodas.
O plano de longo alcance da Treasurys é fornecer aos compradores de varejo de todos os títulos do Tesouro a capacidade de gerenciar suas participações on-line em uma única conta.	O Tesouro disse que deseja dar aos compradores de varejo de todos os títulos do Tesouro a capacidade de gerenciar participações on -line em uma única conta.
"O Canadá é um país pequeno e precisa de empresas como essa, negócios como este".	Um nacionalista apaixonado, Sr. D 'Alessandro disse: "O Canadá é um país pequeno e precisamos de mais empresas como essa".
Ele foi listado ontem à noite em condição crítica, mas estável, no Kings County Hospital Center, disse a polícia.	Essa vítima, um morador de Nova Jersey, estava em condição crítica, mas estável, no hospital.
O título de 30 anos US30YT = RR cresceu 1-3 / 32 para um rendimento de 4,30 %, abaixo dos 4,35 % na quarta-feira.	Às 11 horas da manhã (1500 GMT), a nota de 10 anos US10YT = RR subiu 11/32 para um rendimento de 3,36 %, de 3,40 % na quarta-feira.
Representantes de PureTunes não foram encontrados imediatamente para comentar na quarta -feira.	Os representantes da PureTunes não puderam estar localizados quinta -feira para comentar o processo.
As ações da IAC fecharam ontem US $ 2,81, ou 7,6 %, por US $ 34,19.	As ações da InterativeCorp fecharam em US $ 34,19, queda de US $ 2,81, ou 7,6 % no mercado de ações da NASDAQ.
Byrd, falando do piso do Senado, disse que questionou "os motivos de um presidente de deskbound que assume a roupa de um guerreiro para fins de um discurso".	"Mas eu questiono os motivos de um presidente da mesa que assume a roupa de um guerreiro para os propósitos de um discurso".
O Ministério da Defesa está enfrentando uma reivindicação de compensação de 20 milhões de centenas de mulheres quenianas que afirmam ter sido estupradas por soldados britânicos.	Centenas de mulheres quenianas alegando que foram atacadas e estupradas por soldados britânicos receberam assistência jurídica do governo na quarta -feira para buscar seu caso contra o Ministério da Defesa.
Oficial da polícia S.K. Tonapi disse à Reuters pelo menos 40 pessoas que haviam sido mortas e mais de 100 feridos.	O porta -voz do Ministério do Interior do Estado, Vasant Pitke, disse à Reuters que pelo menos 42 pessoas foram mortas e 112 feridas.
As ações da USA Interactive subiram US $ 2,28, ou 7 %, para US $ 34,96 na sexta -feira na negociação composta do mercado de ações da NASDAQ e ganharam 53 % este ano.	As ações da LendingTree subiram US $ 6,03, ou 41 %, para fechar em US $ 20,72 no mercado de ações da NASDAQ ontem.
Os projetos de lei semelhantes aprovaram a Câmara duas vezes, mas morreram no Senado.	Dois anos atrás, a Câmara aprovou uma versão semelhante que se afastou no Senado.
O fechamento do programa afetou os ganhos do terceiro trimestre por ação por um centavo.	A empresa disse que isso impactou os ganhos por um centavo por ação.
Ainda tive uma chance de lutar ", disse Hewitt depois de lutar para superar Davydenko por 6-3 4-6 6-3 7-6 (7-5) na quadra central.	"Ainda não sou o favorito", disse Hewitt depois de lutar contra Davydenko por 6-3 4-6 6-3 7-6 (7-5) na quadra central.
"Jeremy é um cara legal", disse Barber, acrescentando: "Jeremy está vivendo a vida dos sonhos do atleta de Nova York.	Ele também disse que o Shockey está "vivendo a vida dos sonhos de um atleta de Nova York.
A mulher foi hospitalizada em 15 de junho, disseram autoridades de saúde do Kansas.	As autoridades de saúde do Missouri disseram que não havia sido hospitalizado e está se recuperando.
As lascas azuis se aproximaram ao meio -dia da quarta -feira, quando uma onda de avisos de lucro drenou parte do otimismo que dirigiu uma manifestação nos últimos três meses.	nós. As ações caíram no comércio de manhã cedo na quarta -feira, quando uma onda de avisos de lucro drenou parte do otimismo que dirigiu uma manifestação nos últimos três meses.
O índice de compósito NASDAQ com tecnologia <.ixic> adquirido em 5,91 pontos, ou 0,29 %, para 2.053,27.	O índice de compósito NASDAQ focado na tecnologia <.ixic> Advanced 6 pontos, ou 0,30 %, para 2.053, apagando as perdas anteriores.
Mas a Mitsubishi Tóquio Financial (JP: 8306: notícias, gráfico, perfil) caiu 3.000 ienes, ou 0,65 %, para 456.000 ienes.	Sumitomo Mitsui Financial (JP: 8316: Notícias, gráfico, perfil) caiu 2,5 % em 198.000 ienes.
Dois Kuwaitis e seis palestinos com passaportes jordanianos estavam entre os suspeitos, disse o funcionário.	Eles incluem dois Kuwaitis e seis palestinos com passaportes jordanianos, e o restante é iraquiano e sauditas, disse o funcionário.
Seu aniversário, 21 de abril, foi declarado feriado e ela participou de uma recepção e uma bola.	Quando sua avó, a então princesa Elizabeth, completou 21 anos em 1947, o dia foi declarado férias públicas e ela participou de uma recepção e uma bola.
Sorkin, que enfrenta acusações de conspiração para obstruir a justiça e mentir a um grande júri, deveria ter sido julgado separadamente.	Sorkin deveria ter sido julgado separadamente por acusações de conspiração e mentira para um grande júri.
O homem, que entrou nos correios em Lakeside, pouco antes das 15h. , desistiu de deputados por volta das 18h30.	O homem havia entrado nos correios na Woodside Avenue, na Maine Avenue, pouco antes das 15h.
Os escritórios do FBI "Menos de 10" realizaram investigações envolvendo visitas a mesquitas, informou o Departamento de Justiça.	Além disso, o Departamento de Justiça disse que o FBI conduziu "menos de 10" "investigações envolvendo visitas às mesquitas.
Fora do tribunal, Sriyanto, que enfrenta até 25 anos de prisão, negou que havia feito algo errado.	Fora do tribunal, Sriyanto negou à idade de que ele havia feito algo errado.
A presidente da Universidade de Michigan, Mary Sue Coleman, disse em comunicado no site da Universidade ", nossos valores fundamentais não foram alterados.	"Nossos valores fundamentais não mudaram", disse Mary Sue Coleman, presidente da universidade, em comunicado em Ann Arbor.
Dois astrônomos que examinam a região em torno de Júpiter detectaram 20 novas luas, elevando o total do Planet gigante para 60.	Os astrônomos marcaram mais oito luas orbitando Júpiter, elevando seu total conhecido para 60.
As ações da Comcast Classe A subiram 8 centavos em US $ 30,50 nas negociações matinais no mercado de ações da NASDAQ.	As ações subiram 48 centavos para US $ 30 ontem no comércio do mercado de ações da NASDAQ.
Thomas foi unido na íntegra por Rehnquist e em partes de O 'Connor e Scalia.	Ele se juntou ao chefe de juiz William h. Rehnquist e juízes Sandra Day O 'Connor e Antonin Scalia.
"O que eles fizeram é uma tentativa pouco velada de fazer uma corrida final pela Constituição", disse ela.	O advogado da igreja, Shirley Phelps-Roper, ficou claro: "O que eles fizeram é uma tentativa pouco velada de fazer uma corrida final pela Constituição", disse ela.
Quando você cruzou a linha, você violou o direito constitucional ", disse Charles Weisselberg, professor de direito da UC Berkeley.	Quando você atravessou a linha, você violou o direito constitucional ", disse Charles Weisselberg, que ensina direito na Universidade da Califórnia, Berkeley.
Relatórios preliminares foram que os homens não eram vistos juntos no aeroporto, disseram fontes.	Os homens tinham passaportes paquistaneses e supostamente foram vistos juntos no aeroporto no início da noite, disseram fontes de aplicação da lei.
Toronto ontem teve 64 casos prováveis ​​de SARS e nove casos suspeitos.	Na quarta -feira, havia 65 casos prováveis ​​de SARS na região de Toronto.
O índice composto da NASDAQ aumentou 13,70, ou 0,8 %, para 1700,34.	O índice de compósito NASDAQ, com tecnologia, ganhou 13,73 pontos, ou 0,81 %, para terminar em 1.700,34.
Toll, a segunda maior empresa de transporte da Austrália, na semana passada ofereceu à NZ75 uma parte da Tranz Rail.	Na semana passada, o pedágio se ofereceu para comprar a empresa para a NZ75C por ação, ou US $ NZ158 milhões.
Pensa -se que cerca de 1.557 genes no cromossomo 6 sejam funcionais.	Acredita -se que os 1.557 genes restantes sejam funcionais.
A Messagelabs, que executa servidores de email terceirizados para 700.000 clientes em todo o mundo, disse que havia filtrado 27.000 e-mails infectados em 115 países na quinta-feira de manhã.	A Messagelabs, que administra servidores de email terceirizados para 700.000 clientes em todo o mundo, rotularam o Worm como "alto risco" e relata mais de 31.000 infecções em 120 países.
No segundo trimestre, Anadarko agora espera volume de 46 milhões de Boe, abaixo dos 48 milhões de Boe.	A produção para o segundo trimestre foi reduzida para 46 milhões de barris de 48 milhões de barris.
nós. As tropas não encontraram resistência durante a varredura de cinco horas perto de Tikrit, a cidade natal de Saddam Hussein e o centro de uma região de apoiadores do partido de Baath.	Tikrit é a cidade natal de Saddam Hussein e a região ao redor é conhecida como um viveiro de apoiadores do partido de Baath e ex-oficiais militares iraquianos de alto escalão.
A mulher se sentiu ameaçada e foi ao escritório do magistrado, disse a polícia.	A mulher relatou que se sentiu ameaçada e obteve um mandado de prisão da Stackhouse do escritório do magistrado local.
Miodrag Zivkovic, da Aliança Liberal do Montenegro, ganhou 31 % dos votos, enquanto o Dragan Hajdukovic independente recebeu quatro por cento.	Miodrag Zivkovic, o líder da aliança liberal da oposição pró-independência, ficou em segundo lugar com 31 % dos votos.
Carlson disse na terça -feira que não se recusaria do caso.	Autoridades de serviço disseram que Carlson se recusou a se recusar do caso.
As ações da Oracle também foram mais altas, negociando 12 centavos por US $ 13,60.	As ações da Oracle, com sede em Redwood Shores, subiram 14 centavos para US $ 13,62.
No período do ano anterior, Pearson registrou 26 milhões de lucro antes dos impostos.	Há um ano, a empresa registrou um lucro de 26 milhões de libras.
Com todos os relatórios de distritos, Fletcher-um congressista de três mandatos de Lexington-teve 57 % da votação.	Com todos os relatórios de distritos, Fletcher teve 88.747 votos, ou 57 % do total.
Até quinta -feira, a Oracle disse que 34,75 milhões de ações da PeopleSoft foram apresentadas.	Cerca de 34,7 milhões de ações foram oferecidas, disse a Oracle em comunicado.
Em Hong Kong, 24 pacientes ficaram em quarentena quarta-feira depois que sete trabalhadores do Hospital Público desenvolveram sintomas semelhantes à gripe.	Depois de sete profissionais de saúde em um hospital público, adoeceram com sintomas semelhantes a gripe.
No lado positivo, Coca-Cola Co. (NYSE: KO - NEWS - PESSOAS) RECORDO RECURTO MAIOR DO TRIMESTIMENTO NA QUINTA -FEIRA DE QUINTA -FEIRA, AJUDADO POR DEMANCEIRA EUROPEIRA.	Coca-Cola Co. (KO) relatou um lucro maior no trimestre, ajudado pela demanda européia, no início da quinta -feira.
A Yucaipa possuía Dominick antes de vender a cadeia para Safeway em 1998 por US $ 2,5 bilhões.	A Yucaipa comprou a Dominick em 1995 por US $ 693 milhões e a vendeu para Safeway por US $ 1,8 bilhão em 1998.
A taxa de desemprego aumentou um décimo de um ponto percentual para 6,1 %, o nível mais alto desde julho de 1994.	Prevê -se que a taxa de desemprego tenha marcado um ponto percentual para 6,1 %.
Como parte de seu acordo, Sr. Delainey concordou em cooperar na investigação contínua.	Dave Delainey concordou em cooperar com os promotores federais em troca do apelo.
Graves relatados em Albuquerque, Villafranca de Austin e Ratcliffe de Laredo.	Pete Slover relatou de Laredo e Gromer Jeffers de Albuquerque.
Um aumento de 25 % aumentaria as mensalidades de graduação para cerca de US $ 5.247 anualmente, incluindo taxas diversas baseadas no campus.	O aumento de 25 % leva a taxa de graduação anual da UC para US $ 4.794 e as taxas de pós -graduação para US $ 5.019.