renderizar um idioma em outro idioma	reafirmar (palavras) de um idioma em outro idioma.
nações unificadas por interesses, histórico ou instituições compartilhados	um grupo de nações com interesses comuns.
converter em substâncias absorvíveis (como se) com calor ou processo químico	Amoleça ou se desintegrar por meio de ação química, calor ou umidade.
dedicar ou se adaptar exclusivamente a uma habilidade, estudo ou trabalho	dedicar -se a uma área especial de trabalho.
varanda de madeira elevada de uma casa	Uma varanda que se assemelha ao convés de um navio.
metade de um arco de arco e flecha	qualquer uma das duas metades de um arco da alça à ponta.
Um dispositivo removível que é um acessório para objeto maior	uma peça ou acessório suplementar.
restringir ou confinar	Coloque os limites (extensão ou acesso).
Oriente, esteja posicionado	ser oposto.
Traga de volta à vida, retorne dos mortos	causa para ficar vivo novamente.
qualquer coisa ilusória, não concreta ou real	algo sem substância concreta.
um nome ou característica que identifica um produto ou tipo de coisa	um nome dado a um produto ou serviço.
o processamento ou operação de algo	Uma sequência definida de etapas, parte de um programa de computador maior.
linha, capa	Cubra a frente ou a superfície de.
determinar um padrão; estimar uma capacidade ou medição	estimar o valor de.
uma interpretação, uma conta ou leitura de um evento ou situação	uma representação mental do significado ou significado de algo.
Evento social festivo, celebração	Uma ocasião em que as pessoas podem se reunir para interação social e entretenimento.
Faça ajustes finos para a operação ideal; Ajuste a uma certa escala.	Faça ajustes finos ou divida em intervalos acentuados para uma medição ideal.
uma letra ou poema curto destinado a ser cantado	Uma música narrativa com um refrão recorrente.
empunhar ou manipular efetivamente uma entidade concreta	manusear efetivamente.
empregar ou ser empregado em uma posição	nomear alguém para (um cargo ou um emprego).
grupo de pessoas definidas por uma profissão específica	organização de artistas e pessoal associado (especialmente teatral).
Móveis para armários de armazenamento	Móveis para escritório que consistem em um recipiente para manter papéis em ordem.
sinal (aprovação ou interesse) por piscar; Coloque brevemente um olho.	sinal piscando.
capital social em uma corporação	Qualquer uma das partes iguais nas quais o capital social de uma corporação é dividido e a propriedade é evidenciada por um certificado de ações.
provar ou corroborar	estabelecer ou fortalecer como com novas evidências ou fatos.
(o conteúdo de) uma comunicação.	Uma comunicação (geralmente breve) que é escrita, falada ou sinalizada.
uma prótese parcial	Uma prótese ancorada nos dentes em ambos os lados dos dentes ausentes.
mova para uma posição mais baixa, encerrar algo	encerrar uma associação com.
fluxo, a partir de líquidos	Reduza ou faça com que seja reduzido de um estado sólido para um líquido, geralmente por aquecimento.
selar, isolar ou proteger	Trate o corpo ou qualquer parte dele, envolvendo -o, como com cobertores ou folhas, e aplicando compressas, ou enchendo -o para fornecer cobertura, contenção ou terapia ou absorver sangue.
cicatriz fisicamente; Crie uma marca em alguém ou algo	fazer marcas sublinhadas.
cercar completamente; Fechar dentro, como se com uma cobertura ou borda.	cercar completamente.
o ato ou evento de encerrar um processo, estado, situação	o fim de uma palavra (um sufixo ou final flexível ou morfema final).
o preço de um bem ou serviço	uma afirmação de que alguém é culpado de uma falha ou ofensa.
representar ou retratar em arte, palavras ou modelo	Crie uma imagem ou semelhança de.
viajar ou ser moldado como um zigue -zague	dobrar na forma de uma manivela.
irritar, assediar ou zombar, talvez de brincadeira.	zombar ou tirar sarro de brincadeira.
(causa para) cheirar mal.	Seja extremamente ruim na qualidade ou no desempenho de um.
Classificação social ou posição	a posição relativa ou a posição das coisas ou especialmente as pessoas em uma sociedade.
Ponder, considere, observe cuidadosamente	Considere em detalhes e sujeito a uma análise para descobrir características ou significado essenciais.
persuadir ou alcançar a aceitação	persuadir alguém a aceitar algo.
matéria física deixada para trás após um processo de remoção	matéria que permanece após a remoção de algo.
qualquer forma alta e vertical	Qualquer coisa que se aproxime da forma de uma coluna ou torre.
inflar fisicamente	tornar -se inflado.
Elemento metálico radioativo pesado, número atômico 92	um elemento metálico radioativo prateado tóxico e tóxico; ocorre em muitos isótopos; usado para combustíveis nucleares e armas nucleares.
reclamar de algo ou dizer coisas significativas para alguém.	Diga coisas más.
se preocupe, seja incomodado por, preocupe -se com	ficar ofendido ou incomodado por; se ofenda com, seja incomodado por.
os pontos registrados de um jogo, em um determinado momento	Um número que expressa a realização de uma equipe ou um indivíduo em um jogo ou concurso.
editar para bloquear a verdade; impedir a distribuição	sujeito a censura política, religiosa ou moral.
Uma breve reunião casual com alguém	uma convergência casual ou inesperada.
uma conexão elétrica entre condutor e terra	Uma conexão entre um dispositivo elétrico e um grande corpo condutor, como a Terra (que é considerada com tensão zero).
o ato de um agente de encerrar uma atividade ou evento	o ato de acabar com algo.
pessoas notáveis ​​ou famosas (reais ou ficcionais)	uma pessoa bem conhecida ou notável.
uma pessoa que manipula ou controla um dispositivo ou máquina	um agente que opera algum aparelho ou máquina.
Encontre, determine o lugar de	Determine ou indique o local, local ou limites de, como se por um instrumento ou por uma pesquisa.
Para se envolver em plotagem ou atividades de natureza ilegal ou enganosa	Aja em uníssono ou acordo e em segredo para um propósito enganoso ou ilegal.
ser equivalente, tenha o mesmo efeito que algo	ser equivalente ou equivalente a.
(causa para) sobreviver	causa para se mover puxando.
o dinheiro	Um presente voluntário (como dinheiro, serviço ou idéias) feito por alguma causa que vale a pena.
uma vocalização emocional repentina	uma expressão alta de emoção (especialmente quando inarticulada).
Volte, restaurar, reviver	Volte para um estado anterior.
assentamento de pessoas distantes de sua terra natal	um corpo de pessoas que se estabelecem longe de casa, mas mantêm laços com sua terra natal; Os habitantes permanecem nacionais de seu estado natal, mas não estão literalmente sob o sistema de governo do estado de origem.
(A descoberta ou exibição de) evidências factuais que estabelecem a verdade de algo.	Uma série formal de declarações mostrando que, se uma coisa é verdadeira, outra coisa se segue necessariamente.
entrar em um reino, envolva -se com	causa para se mover; causa para estar em uma determinada posição ou condição.
um projeto ou empreendimento	Atividade sincera e consciente destinada a fazer ou realizar algo.
um sistema padronizado de medições para o peso	Um sistema de unidades usadas para expressar o peso de algo.
uma preocupação ou caso	Alguma situação ou evento que é pensado.
ter uma forte atração sexual por	sentir ou desejar; quer fortemente.
Uma expressão substituta, enunciada para uma palavra tabu	Um personagem em branco usado para separar palavras sucessivas ao escrever ou imprimir.
instalação para armazenamento seguro de coisas, geralmente dinheiro	uma instalação onde as coisas podem ser depositadas para armazenamento ou salva -se.
emitir ou causar para emitir ruído	faça um certo barulho ou som.
Faça contato físico com, possivelmente com o efeito de manipular fisicamente.	causa para estar em breve contato com.
Descubra ou seja informado de uma nova informação, entenda ou perceba	Conheça ou perceba, geralmente acidentalmente.
chefe de um país	o diretor executivo de uma república.
toque com os lábios.	toque com os lábios ou pressione os lábios (contra a boca de alguém ou outra parte do corpo) como uma expressão de amor, saudação, etc.
uma força física natural de desenhar em direção a algo	a força usada na tração.
uma mudança que é uma diminuição	uma diminuição gradual; a partir da carga armazenada ou corrente.
uma avaliação, uma estimativa de valor, uma nota	um número ou carta indicando qualidade (especialmente do desempenho de um aluno).
tendo responsabilidade por gerenciar ou supervisionar	Uma corrida impetuosa em relação a alguém ou algo.
falhar ou sofrer falha	sofrer falha, como em alguma empresa.
uma abundância de algo	propriedade de abundância abundante.
um texto autoritário ou a citação correspondente.	Uma breve nota reconhecendo uma fonte de informação ou de uma passagem citada.
uma instância de percepção visual.	(geralmente seguido por `de ') um grande número ou quantidade ou extensão.
flutue, mova -se para frente e para trás	influencie e para lá.
o alívio da angústia	uma mudança para melhor.
Uma cerimônia marcando a admissão em uma comunidade religiosa.	Um sacramento admitindo uma pessoa batizada para uma participação plena na igreja.
um gesto social de saudação deferente	uma expressão cortês (por palavra ou ação) de estima ou consideração.
mudar para um novo local, estado ou situação	Causa (um computador) para executar um único comando.
Mude um para o outro	Dê e receba um do outro.
uma parada completa, como um ponto de pontuação	Um ponto de pontuação (.) Colocado no final de uma sentença declarativa para indicar uma parada completa ou após abreviações.
algo que é desejado	algo desejou, especialmente uma injeção intravenosa de uma droga narcótica.
para crescer rapidamente	aumentar rapidamente e de maneira descontrolada.
Fale em um tom de voz agudo, como um animal ou humano.	Faça sons agudos.
animais domesticados mantidos para uso ou lucro	Uma variedade especial de animais domesticados dentro de uma espécie.
uma disciplina, um ramo do conhecimento	A disciplina que registra e interpreta eventos passados ​​envolvendo seres humanos.
uma pessoa que é agressivamente perseguida, perseguida	Uma pessoa que é o objetivo de um ataque (especialmente uma vítima de ridículo ou exploração) por alguma pessoa ou influência hostil.
vítima de pessoal	Pessoal militar perdido pela morte ou captura.
escapar ou evitar uma situação ou responsabilidade	Use astúcia ou engano para escapar ou evitar.
uma perda relativa de preço, valor	Uma perda envolveu desistir ou vender algo a menos do que seu valor.
uma diminuição mensurável ou quantitativa	uma diminuição aguda repentina em alguma quantidade.
Altere a chave, tom, tom ou volume de, provavelmente por razões estéticas.	Mude a chave de, na música.
Uma mensagem escrita de não aceitação	Uma mensagem se recusando a aceitar algo que é oferecido.
(causa para) parar de falar ou trazer o silêncio	mova -se para que uma abertura ou passagem seja obstruída; Faça o fechamento.
ferir, arranhar a superfície	cortar a superfície de; desgaste a superfície de.
uma estrutura de plantas perto do topo da planta.	Uma estrutura de frutificação semelhante a um guarda -chuva ou um cone que forma o topo de um fungo carnuda perseguido, como um cogumelo.
uma lista escrita de coisas particulares sendo oferecidas	Uma lista de detalhes (como um Playbill ou Bill of Fare).
Uma marca notacional usada por escrito, diacrítica	Uma marca diacrítica usada para indicar estresse ou colocada acima de uma vogal para indicar uma pronúncia especial.
o estado de acreditar ou ter confiança em algo ou alguém	a característica de acreditar na honestidade e confiabilidade dos outros.
uma tentativa ou esforço para atingir uma meta	uma tentativa de conseguir algo.
aumento da quantidade, extensão ou intensidade	suba ou adiante.
Limpe, lave bem	Limpe com fricção dura.
Compressa fora de forma ou em pequenos pedaços	Fique ferido, quebrado ou distorcido pela pressão.
objeto de ponto ou direto, arma ou soprar algo ou alguém	apontar ou fazer ir (golpes, armas ou objetos como equipamentos fotográficos) para.
Empregar ou utilizar, colocar em serviço	dar ou transmitir fisicamente.
gire, vento, trança ou torcer juntos, talvez como ao realizar renda.	Faça renda.
um recipiente decorativo, geralmente para segurar flores	Um pote aberto de vidro ou porcelana usado como ornamento ou para segurar flores.
preservar, manter em segurança, usar frugalmente	Preserve com açúcar.
uma lancha aberta usada para transporte	Uma lancha com um deck aberto ou meio deck.
um processo de desenvolvimento, aumento ou avanço	um processo de se tornar maior ou mais longo ou mais numeroso ou mais importante.
Certifique -se de.	Tenha cuidado ou certo de fazer algo; certifique -se de algo.
fornecer ou fornecer algo necessário ou desejado	dê algo útil ou necessário.
um instrumento afiado em lâmina para raspar o cabelo	Ferramenta de borda usada no barbear.
Aprenda, assimilar um corpo de conhecimento	Aprenda lendo livros.
apoiar ; resistir ; nutrir ou fornecer	prolongar ou estender em duração ou espaço.
Afaste -se, impeça que aconteça ou não faça algo	abster -se de fazer algo.
algo que fornece conselhos.	algo que fornece orientação ou conselho sobre uma decisão ou curso de ação.
o ato de copiar as ações de outra pessoa.	uma representação de uma pessoa que é exagerada para o efeito cômico.
uma entidade física	uma entidade separada e independente.
diminuir em vigor, impacto ou efeito	fazer menos grave ou severo.
um julgamento ou opinião sobre algo	um julgamento das qualidades de algo ou alguém.
açoitar ou chicote	Bata severamente com um chicote ou haste.
Ato, forma ou progresso de acordo com um plano ou ideal	forma ou influência; dê orientação a.
germinar, como em uma planta.	produzir brotos, galhos ou germinar.
esfera social, escopo de atividade ou interesse	um determinado ambiente ou caminhada da vida.
Um layout vertical estático, p. texto ou números	uma matriz vertical de números ou outras informações.
reconhecer, ser familiar ou bem versado com	estar ciente ou ciente de um fato ou de uma informação específica; possuir conhecimento ou informação sobre.
um retrato de alguém ou algo, através de palavras ou comportamento	Qualquer semelhança de uma pessoa, em qualquer meio.
Um dispositivo para controlar a taxa de alguma atividade, p. , químico ou mecânico	Qualquer um dos vários controles ou dispositivos para regular ou controlar o fluxo, pressão, temperatura, etc.
formar um todo estético ou conceitual.	causa para formar um todo unido, ordenado e esteticamente consistente.
pernas humanas, uso informal	Termos informais para a perna.
objetivo ou objetivo	o objetivo destinado a ser atingido (e que se acredita ser atingível).
proteger do calor, frio ou outras condições prejudiciais	coloque ou separe.
uma lote ou porcentagem de algo	ativos pertencentes a ou devido ou contribuídos por uma pessoa ou grupo individual.
Algo que atinge a vitória	um evento que cumpre seu objetivo pretendido.
alinhar ou fazer paralelo; trazer para o ajuste adequado	Coloque em uma linha ou organize para ser paralelo ou reto.
um mobiliário doméstico que é uma tampa de tecido	Camas de cama que consistem em uma cobertura de pano leve (um afegão ou colcha) que é casualmente jogado sobre alguma coisa.
quadro em malha sobre janelas e portas	uma cobertura protetora que consiste em redes; pode ser montado em uma estrutura.
uma medida da probabilidade ou probabilidade de um evento	uma medida de quão provável é que algum evento ocorra; um número que expressa a proporção de casos favoráveis ​​para todo o número de casos possíveis.
Qualquer pessoa que julgue ou encontre falhas em algo.	Alguém que freqüentemente encontra falhas ou faz julgamentos severos e injustos.
o resgate ou liberação de alguém, algo	recuperação ou preservação de perda ou perigo.
Observe, percebe	Observe com cuidado ou preste muita atenção.
limite, mantenha -se sob controle, determinar, proibir	Para obrigar ou deter ou como se por ameaças.
Fique de fora, se projete, se projete	estender ou projetar no espaço.
para agir como o anfitrião de	ser o anfitrião de ou para.
Coloque o fim, tornar inválido um processo que já está iniciado	tornar inválido para uso.
Aproveite, goste de ou aprovar	sentir sobre ou para; Considere, avalie ou considere.
por cento	uma proporção em relação a um todo (que geralmente é a quantidade por cem).
um atributo ou qualidade aproximada de algo	uma definição ou exemplo aproximado.
o ato de ter e controlar a propriedade.	o estado ou fato de ser proprietário.
uma protuberância física, grande ou pequena	Uma elevação natural (especialmente uma rochosa que se projeta no mar).
estimar ou calcular o valor numérico de algo	Avalie ou estimar a natureza, qualidade, habilidade, extensão ou significado de.
uma parte ou porcentagem de um todo	A parte desempenhada por uma pessoa ao trazer um resultado.
elemento mais leve, número 1 atômico 1	um elemento univalente não metálico que normalmente é um gás diatômico altamente inflamável incolor e inodoro; O elemento mais simples, mais leve e abundante do universo.
um custo unitário de algo	uma única chance ou instância.
Mova -se para frente e para trás	mova -se ou balançando em um padrão de ascensão e queda ou onda.
um período cíclico de tempo definido por um sistema de calendário	Um período de tempo contendo 365 (ou 366) dias.
enfrentar um evento e sobreviver; aguentar	rosto e suportar com coragem.
(medicina) A capacidade de um organismo de se defender contra doenças.	(medicina) A condição na qual um organismo pode resistir a doenças.
uma declaração, uma ideia expressa na linguagem	uma breve declaração.
executar um dever	fazer dever ou manter escritórios; servir em uma função específica.
Soldado que é membro de um grupo de forças especiais	Um membro de uma unidade militar treinou como tropas de choque para ataques de atropelamento.
Torne -se mestre de, superar, dominar	subir em cima de; lidar com com sucesso.
área de tecido danificado e cortado em um corpo vivo	Uma vítima para o pessoal militar resultante de combate.
Revolver	Altere as direções como se girasse em um pivô.
duas vezes a quantidade ou quantidade de algo	Uma quantidade que é duas vezes maior que outra.
Dê um incentivo à ação, provide ou desperte, pedi ou faça com que atue.	provocar ou mexer.
direção funerária	o comércio de um diretor funerário.
Para acender ou pegar fogo	Pegue fogo.
uma grande quantidade aproximada de algum atributo ou coisa	um exemplo concentrado de algo.
medicação	uma substância usada como medicamento ou narcótico.
um método para resolver um problema	a ação bem -sucedida de resolver um problema.
atingir um objetivo, atingir uma referência ou objetivo	desenvolver de maneira positiva.
Tire algo ou alguém para longe de algum lugar	vá embora ou vá embora.
um reforçador em uma roupa	(náutica) composta por um cabo pesado ou um cabo de fio usado como suporte para um mastro ou longarina.
uma passagem subterrânea construída	Uma passagem através ou debaixo de algo, geralmente underground (especialmente um para trens ou carros).
discernir, identificar ou saber por causa de uma experiência anterior	estar plenamente consciente ou ciente de.
mover ou alterar a própria posição ou qualidade	mova -se muito ligeiramente.
incorporar ou envolver uma coisa em outra	Incorpore um ingrediente alimentar em uma mistura, girando repetidamente sem mexer ou bater.
guia, desenhe através	passar, do outro lado ou através.
resgatar, resgatar, entregar de dano ou perigo	abster -se de prejudicar.
bater (como se) com um chicote ou haste	ataque como se por chicotear.
O procedimento médico de girar manualmente o útero	Turnual manual de um feto no útero (geralmente para ajudar na entrega).
Crie uma vantagem ou borda	incluir em ou como se estivesse em um quadro.
reinicie ou continue uma atividade após uma interrupção ou pausa	pegue ou comece de novo.
capturar, eare, descobrir no ato	Descubra ou apareça acidentalmente, de repente ou inesperadamente; Pegue alguém fazendo algo ou em um determinado estado.
iniciação, fundação, introdução de algo	o ato de iniciar algo pela primeira vez; apresentando algo novo.
uma forma amassada ou dobrada	uma forma angular ou arredondada feita dobrando.
Treine, tutor ou comportamento social polonês, gosto, julgamento	Ensine ou refine a ser discriminativo em gosto ou julgamento.
uma atividade mental de interpretar ou interpretar	uma interpretação de um texto ou ação.
enfatizar; chamar atenção para; sublinhado	Desenhe uma linha ou linhas abaixo para chamar a atenção.
possibilidade para o futuro	uma previsão do curso de uma doença.
exigir ou precisar de algo que esteja faltando	precisar.
uma indicação ou manifestação de algo, geralmente físico	uma indicação de dano.
uma breve e súbita explosão de luz	um brilho momentâneo.
venha ou traga de volta à vida, saúde, existência ou use	causa para recuperar a consciência.
um estado mental de tristeza.	Um estado mental caracterizado por um senso pessimista de inadequação e uma falta desanimada de atividade.
Mudança de posição ou localização	O ato de mudar a localização de algo.
(causa) mover -se através de um espaço, circuito ou sistema, usu. retornando ao ponto de partida	mover em círculos.
traga a consonância	Traga (várias coisas) em consonância ou se relaciona harmoniosamente.
Envie, envie para	causa para se mover; causa para estar em uma determinada posição ou condição.
estado de ser unificado	o estado de se unir ou unido ou vinculado.
(causa) tornar -se diferente ou aquire um caráter diferente, possivelmente durante o desenvolvimento.	Torne -se distinto e adquirir um personagem diferente.
um objetivo ou objetivo	o objetivo destinado a ser atingido (e que se acredita ser atingível).
Aproveite e leve cativo; tomar ou obter posse de algo	Tome posse de força, como após uma invasão.
dar, dedicar, prometer	Dê inteiramente a uma pessoa, atividade ou causa específica.
Decida um horário específico para um evento	fazer um cronograma; Planeje a hora e o local para eventos.
valorize uma coisa ou curso de ação mais altamente do que outro	como melhor; valor mais altamente.
Dê algo por uma causa	Dê a uma instituição de caridade ou boa causa.
fornecer uma diretriz	mobilizar com rubricas ou regular pelas rubricas.
uma suprimento social, como namoro ou suplicação	Uma petição ou apelo feito para uma pessoa de status ou classificação superior.
falhar na força ou saúde e deixar de função	quebrar, literal ou metaforicamente.
Responder verbalmente ou em forma escrita a uma pergunta, comentário, carta ou discurso	reaja verbalmente.
um pequeno corte em uma superfície física	Um leve corte de superfície (especialmente um entalhe feito para manter uma contagem).
porque algo é o caso	causa para se mover; causa para estar em uma determinada posição ou condição.
um estado de confinamento em um pequeno espaço	O ato de se forçar (ou ser forçado) dentro ou através de um espaço restrito.
declarar ou explicar o significado	Dê uma definição para o significado de uma palavra.
fazer com que os animais se movam	buscar comida ou esporte (como animais selvagens).
ser contra, resistir	agir contra ou em oposição a.
Uma quantidade de dinheiro adicionada a uma conta bancária	dinheiro depositado em um banco ou em alguma instituição semelhante.
causa para existir; criar	trazer para existir.
desempenho, rotina	Um curto desempenho teatral que faz parte de um programa mais longo.
As pessoas se reuniram em um movimento rítmico	Uma festa de pessoas se reuniu para dançar.
um servidor de computador	(Ciência da Computação) Um computador que fornece às estações clientes acesso a arquivos e impressoras como recursos compartilhados para uma rede de computadores.
proibir, proibir	Proibir a distribuição pública de (um filme ou um jornal).
arquivos de texto do computador	(Ciência da Computação) Um arquivo de computador que contém texto (e possivelmente formatando instruções) usando caracteres ASCII de sete bits.
um ato de fala de reconhecer gratidão por algo	um reconhecimento de apreciação.
um estado de fingir ser alguém, outra coisa	Uma aparência externa que deturpa a verdadeira natureza de algo.
Torne -se difundido como uma ideia ou sentimento.	causa para se tornar amplamente conhecido.
conectar -se a; atingir um alvo ou objetivo	percebem com os sentidos rapidamente, repentinamente ou momentaneamente.
renda cobrada como imposto por um governo	Renda do governo devido à tributação.
ser o fator decisivo em um estado de coisas ou um resultado	forma ou influência; dê orientação a.
fim	Coloque um fim.
uma região alocada para manter algo	A parte particular do espaço ocupada por algo.
reconhecer uma contribuição ou causa	confiar em; Confie na verdade ou veracidade de.
arranjo	Arranjo lógico ou compreensível de elementos separados.
sistema de arranjo	um esquema de arranjo.
fechar dentro dos limites; privar a liberdade	Fechar dentro dos limites, limite ou retire -se do movimento.
para coletar, adquirir ou reunir	reunir -se ou reunir -se.
entregar uma conversa formal ou repreensão longamente	censura severamente ou com raiva.
Um par de pessoas acasaladas, p. , casado	um par de pessoas que vivem juntas.
podridão; tornar -se impróprio para consumo	tornar -se impróprio para consumo ou uso.
trava um com o outro	Fique engajado ou entrelaçado um com o outro.
faça votos, junte -se ou deixe participar de uma ordem religiosa	faça votos, como em ordem religiosa.
atividade de venda	A atividade geral de venda.
dar, permitir	permitir.
Escola Pública Secundária, séries 9-12	Uma escola secundária pública geralmente incluindo as séries 9 a 12.
Benjamin Rush, médico e líder revolucionário americano.	médico e líder revolucionário americano; Signal da Declaração de Independência (1745-1813).
compartimento de bagagem de um carro	Termo britânico para o compartimento de bagagem em um carro.
tem um monopólio de; Controle completamente	ter ou explorar um monopólio de.
reduzir para um composto molecular mais simples	Reduza (petróleo) para um composto mais simples por rachaduras.
causa para se interessar	atrair; porque ficar apaixonado.
permanecer emocionalmente ou intelectualmente apegado sem o contato físico necessário.	permanecer emocionalmente ou intelectualmente ligado.
O ato de transportar mercadorias comericamente a taxas mais baratas que as taxas expressas.	transportar mercadorias comercialmente a taxas mais baratas que as taxas expressas.
(uma ocorrência de) A preservação ou gerenciamento de recursos naturais.	a preservação e o tratamento cuidadoso do meio ambiente e dos recursos naturais.
Remova a vagem, casca ou concha	cair da vagem ou casca.
abster -se de comer ou de certos alimentos	abster -se de comer.
sentir -se quente ou doloroso, como se fosse queimado	sentir -se quente ou doloroso.
(causa para) voltar depois de ser recusado	Volte depois de ser recusado.
uma perda de função	perda de capacidade de funcionar normalmente.
administrador, quem controla recursos	alguém que controla recursos e despesas.
um fogão, aparelho de cozinha	Um aparelho de cozinha usado para cozinhar alimentos.
enxágüe a boca de um com enxaguatório bucal, gargarejo	Enxágue a boca e a garganta de um com enxaguatório bucal.
uma quantidade que é um cálculo aproximado	um cálculo aproximado de quantidade ou grau ou valor.
Ligue um eixo; rodar	Ligue ou ao redor de um eixo ou um centro.
oferta de casamento	uma oferta de casamento.
Tente ganhar favor ao lisonjear ou mostrar submissão ou medo.	mostrar submissão ou medo.
A submissão pública de um registro legal	a entrada de um documento legal no registro público.
murchar, murchar ou madurar imperfeitamente, como de uma flor.	murchar ou murchar ou madurar imperfeitamente.
tenha fé em, apostar em	ter fé ou confiança em.
explodir em chamas (telic)	Comece a queimar ou explodir em chamas.
os processos cognitivos e a capacidade de lembrar.	Os processos cognitivos pelos quais a experiência passada é lembrada.
mecanismo que controla o nível da água em uma seção do canal	gabinete que consiste em uma seção do canal que pode ser fechada para controlar o nível da água; Usado para elevar ou abaixar vasos que passam por ele.
uma preocupação ou preocupação onerosa	uma preocupação onerosa ou difícil.
alguém ou algo que é o agente de atender às expectativas desejadas	alguém (ou algo) sobre o qual as expectativas estão centralizadas.
um lado nítido de um objeto	um lado nítido formado pela interseção de duas superfícies de um objeto.
o golpe forte de uma bola	Batendo uma bola de golfe de uma camiseta com um motorista.
material fino em pó; os restos de algo destruído ou quebrado.	os restos de algo que foi destruído ou quebrado.
jogue com força	absoluto com força; absoluto veementemente.
trate uma substância com algum agente; Adicione um agente a.	tratar com um agente; adicione (um agente) a.
Passe pelo esôfago	Passe pelo esôfago como parte de comer ou beber.
Mova -se livremente (geralmente dentro de um espaço limitado)	causar mover -se ou operar livremente dentro de um espaço limitado.
secretar ou formar água	secrete ou forme água, como lágrimas ou saliva.
o estado de estar em contato	o estado de estar conectado.
Uma variante de um tema musical que emprega notas de duração reduzida do tema original	A declaração de um tema em notas de menor duração (geralmente metade do comprimento do original).
hora de vir	a hora ainda por vir.
o estado legal de dinheiro	o estado de dever algo (especialmente dinheiro).
um estilo e tamanho de tiposeneto	Um tamanho e estilo específico do tipo em uma família de tipos.
demanda, peça ou tome como um devido	demanda como sendo devida ou propriedade; afirmar que está certo ou título para.
causa para ser desconfiado ou rejeitado; danificar a reputação de.	danificar a reputação de.
Dê direitos iguais a, a partir do direito de votar.	dar direitos iguais a; de mulheres e minorias.
(causa para) prolongar ou expandir no tempo ou algum reino abstrato	prolongar no tempo; causa para ser ou durar mais.
uma mochila, pacote na parte de trás	um pacote (especialmente um carregado nas costas).
uma pessoa que fornece informações ou bens	uma pessoa que transmite (carrega ou transmite).
tendo um entendimento intuitivo ou apreciação de algo	uma compreensão intuitiva de algo.
adesão aos princípios morais	aderir aos princípios morais.
fazer sexo com	ter relações sexuais com.
participe ou forneça um banquete	participe de um banquete ou banquete.
idolizar / mostrar devoção a	mostrar devoção a (uma divindade).
faça um som de tique -taque	Faça um som de clique ou marcar.
correr ou fluir lentamente	Corra ou flua lentamente, como em gotas ou em um fluxo instável.
Escreva um programa de computador.	Escreva um programa de computador.
um estado de ordem social em conformidade com a lei existente	um estado de ordem em que os eventos estão em conformidade com a lei.
um dispositivo de armazenamento eletrônico.	um dispositivo de memória eletrônica.
Uma linha de referência usada para alinhar letras	Uma linha leve usada em letras para ajudar a alinhar as letras.
a qualidade da dedicação, fixidade de propósito	A característica da fixidade sincera e firme de propósito.
Olhe furtivamente para alguma coisa.	Olhe furtivamente.
Lanke -se, livre -se de algo	livrar-se de .
Recupere a posse ou volte novamente	recuperar ou encontrar de volta; recuperar o uso de.
Um coeficiente atribuído aos elementos em uma distribuição de frequência para indicar a importância relativa de cada elemento	(Estatística) Um coeficiente atribuído a elementos de uma distribuição de frequência para representar sua importância relativa.
(causa para) se mover	causa para se mover e redondos.
ser devido	ser devido ao reembolso.
prestar assistência médica para.	Forneça cuidados veterinários.
Faça o fim, faça novo	fazer novo.
cubra, tampe ou trate a superfície de	Coloque um casaco; cobrir a superfície de; Forneça com uma superfície.
beisebol: atingir um batedor	Afaste -se (uma massa), (de um jarro).
recuperar ou compensar, a partir de uma perda financeira.	recuperar ou compensar.
duplicado, combine	duplicar ou corresponder.
Articulações vocais indistintas	Articulação indistinta.
o ato de afastar algo	o ato de aplicar força para afastar algo.
Mova -se ou dirige com força como se por um soco.	Dirija à força como se por um soco.
uma surpresa intensa, muitas vezes desagradável	Uma surpresa desagradável ou decepcionante.
Faça menos emocionalmente hostil; conquistar mental ou emocionalmente.	tornar menos hostil; conquistar.
Uso informal para um gato doméstico, muitas vezes jovem	Termos informais referentes a um gato doméstico.
o ato de classificar uma coisa dos outros.	classificando uma coisa dos outros.
o ato de afixar ou conectar coisas fisicamente	o ato de prender as coisas juntas.
as pessoas que moram em um acampamento	um grupo de pessoas que moram juntas em um acampamento.
um desenvolvimento imprevisto.	um desenvolvimento imprevisto.
Traga para uso popular / comum em geral	Atenda ao gosto popular para tornar popular e presente ao público em geral; trazer para uso geral ou comum.
tornar impuro; fazer radioativo	tornar impuro.
um implemento longo e fino, geralmente feito de madeira	um implemento que consiste em um comprimento de madeira.
rejeitar ou rejeitar formalmente uma crença anteriormente considerada; retrair uma declaração.	rejeitar ou rejeitar formalmente uma crença anteriormente mantida, geralmente sob pressão.
(porque) virar para o lado esquerdo.	Vire ou vá para o porto ou lado esquerdo, de um navio.
implica como um acompanhamento ou resultado necessário	impor, envolver ou implicar como um acompanhamento ou resultado necessário.
Anexe fisicamente a algo.	consertar; Anexe.
atribuir a uma tarefa específica	atribuir a uma tarefa específica.
Evento culminante	Seja o evento culminante.
ato de construir	o ato de construir algo.
O componente principal de processamento de informações de um computador, de um chip de microprocessador	(Ciência da Computação) A parte de um computador (um chip de microprocessador) que faz a maior parte do processamento de dados.
Considere novamente, geralmente com o objetivo de mudar	Considere novamente (um projeto de lei) votado antes, com o objetivo de alterá -lo.
Cancelar, reverter, anular	Cancelar, anular ou reverter uma ação ou seu efeito.
definir; determinar qualidades essenciais de	determine a qualidade essencial de.
A busca e matança ou captura de animais.	A busca e matança ou captura de animais selvagens considerados um esporte.
manipular os registros de um instrumento musical	manipular os registros de um órgão.
mova -se em um curso irregular	Mova -se de um lado para o outro ou de um lugar para outro, geralmente em um curso irregular.
a concessão ou concessão legal de direitos	o ato de conceder direitos.
choque de corrente elétrica para o corpo	Uma resposta reflexa à passagem da corrente elétrica através do corpo.
fique grávida.	fique grávida; passar por concepção.
o concedido de uma franquia, o infrancização	o ato de certificar ou conceder uma franquia.
ato de distribuir	o ato de reportar ou distribuir algo.
o estado de estar mais do que satisfeito ou saciado.	o estado de estar mais do que cheio.
emoção subjetiva ou desejo consciente	o aspecto subjetivo consciente do sentimento ou emoção.
O ato de propor alguém como candidato a alguma coisa.	a condição de ter sido proposta como candidato adequado para nomeação ou eleição.
Para caçar snipe	caçar ou atirar no snipe.
Hunt for Hawks	caça com falcões.
Uma camada horizontal contínua de tijolos	(Construção) Uma camada de alvenaria.
Uma breve tentativa de algum esforço	uma tentativa geralmente breve.
propagação de ondas de volta de uma superfície	O fenômeno de uma onda de propagação (luz ou som) sendo jogada de volta de uma superfície.
examinar minuciosamente; Pesquise diligentemente	examinar minuciosamente.
Aproveite, goste de ou aprovar	gostar de.
uma pessoa sob a tutela ou custódia de outro	uma pessoa que está sob a proteção ou sob custódia de outra.
atacar ou atingir bruscamente, talvez como no esporte.	atacar bruscamente, como em alguns esportes.
voar para dentro ou em um plano de planador	voe para dentro ou como se estivesse em um plano de planador.
um quarto de um ano	uma quarta parte de um ano; três meses.
tornar uma coisa abstrata apertada ou mais restritiva	Faça apertado ou mais apertado.
fornecer (uma pessoa ou grupo) com poder ou autoridade	fornecer poder e autoridade.
Corra em um ritmo moderadamente rápido, como para o exercício.	Corra em um ritmo moderadamente rápido.
envolver completamente; formar uma cobertura.	formar uma cobertura impenetrável.
molde para fundição, definindo concreto	um molde para definir concreto.
causar atrito; desgastar ou corroer	desgastar ou corroer.
um sentimento por algo que desejava intensamente.	algo que é desejado intensamente.
Coloque ou guarde em uma garrafa	Armazene (líquidos ou gases) em garrafas.
ser um sinal ou indicação de; tem como significado.	ser um sinal ou indicação de.
o ato de escolher, escolhendo um entre muitos	o ato de escolher ou selecionar.
ato de ficar distante, afastando -se de	o ato de se tornar mais distante.
tomar casamento; Realizar uma cerimônia de casamento	aceitar o casamento.
Pule, salte ou mova -se para cima e para baixo ou de lado como uma maneira de movimento.	Pule, salte ou mova -se para cima e para baixo ou de lado.
uma fortificação militar, fortaleza	uma fortaleza.
a elite da moda de uma determinada comunidade	a elite da moda.
chamado característico de um animal	a expressão característica de um animal.
tornar ou tornar -se mais agudo ou intenso	Faça mais intenso, mais forte ou mais acentuado.
uma jornada para algum propósito.	Uma jornada para algum propósito (geralmente incluindo o retorno).
falso ou falsificado; controle de maneira fraudulenta.	manipular de maneira fraudulenta.
frutas cozidas com açúcar, geléia	Frutas preservadas cozinhando com açúcar.
o ato de liderar ou orientar os outros	a atividade de liderar.
revestimento usado como repelente à umidade	Uma camada final aplicada para excluir a umidade.
uma pessoa que limpa chaminés	Alguém que limpa a fuligem de chaminés.
brilhar intensamente; Emite uma luz constante e uniforme de uma fonte.	Emite uma luz uniforme e estável sem chamas.
se comportar de uma certa maneira; ter um efeito ou resultado específico	se comportar de uma certa maneira.
Comunique -se com um assobio	expresso ou absoluto com um assobio.
Uma abelha masculina cuja função é fertilizar a rainha	Abelha macho sem ferrura em uma colônia de abelhas sociais (especialmente abelhas) cuja única função é acasalar com a rainha.
Uma partida esportiva, boxe	uma partida de boxe ou luta livre.
causa para reproduzir (plantas ou animais)	causa para procriar (animais).
A sensação de aborrecimento por ser prejudicada ou frustrada.	Um sentimento de aborrecimento por ser prejudicado ou criticado.
Mova -se com rodas	Avance ou se estivesse em rodas ou um veículo com rodas.
[Forneça um local de descanso novo ou diferente	Forneça um novo assento.
atividade de extrair minério ou outra matéria do solo	o ato de extrair minérios ou carvão etc da terra.
Para interromper, entre não convidado	entre não convidado.
uma pessoa ou coisa igual a outra em valor ou significativa.	uma pessoa ou coisa igual a outro em valor ou medida, força ou efeito ou significado etc.
uma causa ou fonte de dano	uma causa de dor ou lesão ou perda.
tornar (mais) compreensível	deixar claro e (mais) compreensível.
o estado de ser retido	o ato de reter algo.
um problema, algo errado	um problema.
esticar ou mais completamente	estique completamente.
Continue a viver, existir ou prosperar	Continue a viver com dificuldades ou adversidades.
uma carícia com os lábios	o ato de acariciar com os lábios (ou um exemplo).
Forneça trilhos, como por deitar.	deita com trilhos.
a abordagem próxima de um objeto para outro	o movimento de um objeto em relação a outro.
Faça um buraco com uma ferramenta pontiaguda	Faça um buraco, especialmente com uma ferramenta de energia ou mão pontiaguda.
Fix (algo antigo) com uma nova parte; melhorar .	peça (algo antigo) com uma nova parte.
o ato de danificar algo, causando quebra	o ato de quebrar alguma coisa.
o nível do solo de um edifício de vários andares	O piso de um prédio que fica mais próximo do nível do solo ao redor do edifício.
Uma quantidade de algo	uma quantidade de dinheiro.
uma sala grande	A grande sala de uma mansão ou castelo.
Deixe de fora, omite, impeça de entrar	impedir a entrada; Mantenha fora.
Sniff no ingresso.	cheirar ou cheirar ingressos.
fornecer hospedagem para	fornecer moradia para.
alterar o objetivo ou o funcionamento de um sistema.	Altere o objetivo ou função inerente de algo.
fornecer ferramentas ou itens para um propósito específico	fornecer com (algo) geralmente para um propósito específico.
Gain Points em um jogo; adicione (números)	Gain Points em um jogo.
viajar na frente de, ser o primeiro, preceder	viajar na frente de; vá antes dos outros.
Remova esfregando	Remova por ou como se estivesse esfregando ou apagando.
a parte superior dura do nariz humano	A crista dura que forma a parte superior do nariz.
faça brilhar	fazer (uma superfície) brilhar.
recuperar, retornar ao antigo estado	retornar a uma condição anterior.
Remova a vagem, casca ou concha	Retire as cascas de.
acelerar o processo de	acelerar o progresso de; facilitar.
(porque) balançar e perder o terceiro arremesso, eliminando	Atingindo balançando e perdendo o campo cobrado como o terceiro.
Literal e quantifiavelmente aumentam em classificação ou status social.	aumentar em classificação, caráter ou status.
alterar por meios químicos, para fazer imagens.	Torne visível por meio de soluções químicas.
doença viral altamente infecciosa	uma doença viral altamente contagiosa febril aguda.
fazer um certo tamanho ou classificar de acordo com o tamanho	fazer um tamanho; traga um tamanho adequado.
Remova tocos de árvores de uma área.	Remova os tocos de árvores de.
Passe a língua, aceite a língua	passe a língua.
uma imagem visual gerada por computador	uma imagem que é gerada por um computador.
fazer melhor em uma competição; ganhar	Saia melhor em uma competição, raça ou conflito.
força aerodinâmica que se opunha à gravidade	O componente das forças aerodinâmicas que atuam em um aerofólio que se opõe à gravidade.
Comece abruptamente, acenda	Comece abruptamente.
um anúncio local feito em uma transmissão pública	(Broadcasting) Um anúncio local inserido em um programa de rede.
fazendo real ou concreto	algo que é feito real ou concreto.
Soa acentuadamente ou estridente, como se estabilize.	soa acentuadamente ou estridente.
o ato de ganhar oficialmente a entrada para algum lugar	o ato de admitir alguém para entrar.
passar um tempo na prisão	passar um tempo na prisão ou em um campo de trabalho.
Segure, conter dentro	conter ou segurar; tem dentro.
ato de informar verbalmente	o ato de informar por relatório verbal.
solicitar com força	Solicite com urgência e força.
a qualidade da dissimilaridade	a qualidade de ser diferente ou diferente.
Jogue rapidamente, filmar	Jogue rapidamente.
mova -se e para dentro de um ponto ou ponto específico, permaneça próximo	Mova -se de um lado para o outro.
Aumente algo ou alguém desagradável; mostrar deferência para alguém ou alguma autoridade.	Aumente algo ou alguém desagradável.
o rompimento ou rescisão de um relacionamento social	a rescisão ou desintegração de um relacionamento (entre pessoas ou nações).
destruição de um navio	destruir um navio.
o ato humano de fazer algo novo.	o ato de iniciar algo pela primeira vez; apresentando algo novo.
Ride (uma bicicleta ou motocicleta)	andar de moto.
A principal atividade que se faz para ganhar dinheiro.	A principal atividade em sua vida que você faz para ganhar dinheiro.
manter ou preservar uma condição, estado ou atividade particular	Continue um determinado estado, condição ou atividade.
uma resposta falada ou escrita a uma pergunta	Uma declaração (falada ou escrita) que é feita para responder a uma pergunta, solicitação ou crítica ou acusação.
Comitê com poderes de supervisão	um comitê com poderes de supervisão.
uma seção de uma composição, textual ou musical	Uma seção curta de uma composição musical.
um equipamento para alterar o movimento de uma máquina para a direção oposta	As engrenagens pelas quais o movimento de uma máquina pode ser revertido.
Faça uma caminhada de digestão após uma refeição	Dê um passeio pela saúde de um ou para ajudar na digestão, como após uma refeição.
forma ou forma bifurcada	uma parte de uma forma bifurcada ou ramificada.
inserir ou fechar com um plugue	Encha ou feche firmemente com ou como se com um plugue.
incitar algum ato de insubordinação	Incitar, mover ou persuadir a algum ato de ilegalidade ou insubordinação.
anunciar formalmente o término de um acordo	anunciar o término de, como dos tratados.
batida ou libra rapidamente	causa para palpitar ou bater rapidamente.
fazer uma linha ou marcas em uma superfície; copiar seguindo as linhas de	faça uma marca ou linhas em uma superfície.
recitar como um canto, inteno	recitar com entonação musical; Recite como um canto ou um salmo.
a capacidade dos computadores de trocar informações digitais entre eles e usar isso	(Ciência da Computação) A capacidade de trocar e usar informações (geralmente em uma grande rede heterogênea composta por várias redes de área local).
ato de aplicar força	O ato de aplicar força de repente.
o processo de se tornar menos ou menor	um processo de se tornar menor ou mais curto.
estar no comando de; exercer autoridade ou controle sobre.	Exercite o controle ou o poder autoritário.
ser um fator ou desempenhar um papel em algo	ser ou fazer parte de ou dentro.
uma extensão de terra	uma área estendida de terra.
Mova um implemento com um movimento circular, misture	mover um implemento através.
privar de coragem, esperança ou otimismo	privar de coragem ou esperança; tirar a esperança de; causa para se sentir desanimado.
as forças armadas	uma força que é um ramo das forças armadas.
mobilizar com esporas de metal.	mobilizar com excesso.
Remova a água de uma substância.	Remova a água de.
Forneça trilhos, como por deitar.	fornecer trilhos.
fazer ou ser um resumo	ser um resumo de.
ser afetado com smut ou oídio	afetar com smut ou oídio, como uma colheita como o milho.
falar ou se comportar amorosamente; fazer sexo com.	Fale ou se comporte amorosamente, sem intenções graves.
Desculpe alguma infração social menor; Aceite uma desculpa para alguma coisa.	aceitar uma desculpa para.
indicar, ser sinais ou sintomas de	ser um sinal para ou um sintoma de.
uma solicitação verbal ou por escrito para acesso a algo.	Uma solicitação verbal ou por escrito de assistência ou emprego ou admissão em uma escola.
tem um resultado lógico	tem como conseqüência lógica.
viajar a pé.	cruze a pé.
o ato de sucção	o ato de chupar.
um bando de couro ou corda feita para identificar animais.	Uma faixa de couro ou corda que é colocada em torno do pescoço de um animal como arnês ou para identificá -lo.
coloque um arnês.	coloque um arnês.
fornecer ou equipar especificamente com móveis.	fornecer ou equipar com móveis.
mover -se (a cabeça ou o corpo) rapidamente para baixo ou para longe (de alguma coisa).	mover -se (a cabeça ou o corpo) rapidamente para baixo ou para longe.
razão ou estabelecimento por dedução	razão por dedução; Estabelecer por dedução.
fazer grávida; fertilizar e fazer crescer.	fertilizar e fazer crescer.
encontre a solução para ou entender o significado de	Encontre a solução para (um problema ou pergunta) ou entenda o significado de.
Mova -se de maneira confusa ou sem propósito.	mova -se de maneira confusa.
Aumente com algo desagradável	Aumente algo ou alguém desagradável.
um meio ou agência pela qual algo é comunicado.	um meio ou agência pela qual algo é expresso ou comunicado.
desmontar em peças constituintes	desmontar em suas peças constituintes.
Um programa teatral curto que faz parte de um programa mais longo.	Um curto desempenho teatral que faz parte de um programa mais longo.
Decreto, emita um pedido	emitir um pedido.
o término, final de uma reunião	o término de uma reunião.
um indicador que é o consultor geralmente.	um indicador de que você geralmente você.
Aumente o volume acústico de.	Aumente o volume de.
Aberto a membros de todas as raças e grupos étnicos	aberto (um local) para membros de todas as raças e grupos étnicos.
Reduza para pequenos pedaços batendo ou abreviando	Reduza para pequenos pedaços ou partículas batendo ou abrasando.
Bata uma mosca (beisebol)	acerte uma mosca.
A pesca exausta, permitindo puxar a linha	Exaustão permitindo puxar a linha.
ser ou entrar em conflito	ser incompatível; estar ou entrar em conflito.
produzir um clique fonêmico.	produzir um clique.
ângulo com um gancho e linha e desenhe a água	ângulo com um gancho e uma linha desenhados pela água.
a face da frente de um prédio	o rosto ou a frente de um prédio.
tornar algo mais diversificado ou variado	Faça algo mais diversificado e variado.
emitir títulos em algo	emitir títulos em.
Mulheres com roupas de baixo sem mangas	A UNDARENÇÃO DE UMA MULHER DE MULHER.
mova -se muito rápido.	Mova -se muito rápido.
opor ou abordagem, como em hostilidade ou competição	Opor, como em hostilidade ou competição.
tornar mais complexo ou intrincado	tornar mais complexo, intrincado ou mais rico.
porque ser / mostrar para ser inválido	mostrar para ser inválido.
Crie uma nova entidade juntando componentes ou membros	Crie juntando componentes ou membros.
a atividade de fornecer suprimentos	a atividade de fornecer ou fornecer algo.
tornar ou ficar mais brilhante ou mais leve	tornar mais claro ou mais brilhante.
atores em uma peça	os atores em uma peça.
Leve a alma de alguém no céu	Pegue a alma de alguém no céu.
disciplina em atividades pessoais ou sociais.	disciplina em atividades pessoais e sociais.
uma pessoa comendo uma refeição, geralmente em um restaurante	uma pessoa que come uma refeição (especialmente em um restaurante).
uma explosão repentina (emocional).	Uma explosão repentina.
fazer ou ficar mais difícil	tornar difícil ou mais difícil.
a parte introdutória de uma história	A seção introdutória de uma história.
material de trabalho com uma ferramenta	Trabalhe com uma ferramenta.
fazer ou tornar -se menos rigoroso ou grave	tornar menos grave ou rigoroso.
apoio colocando -se sobre ou contra algo sólido	suporte colocando -se contra algo sólido ou rígido.
parte, cessar ou quebrar associação com (alguma coisa).	papel ; cessar ou quebrar a associação com.
ter meios financeiros para obter, comprar ou fazer algo	Tenha o meio financeiro de fazer algo ou comprar algo.
Uma lista de candidatos nomeados por um partido político para concorrer à eleição.	Uma lista de candidatos nomeados por um partido político para concorrer à eleição para escritórios públicos.
Diga, Estado, ou tome novamente	Para dizer, declare ou se apresente novamente.
Permitir a passagem do ar	Permita a passagem do ar.
unir; fundir -se com algo já existente	une -se ou se fundir com algo já existente.
Use recursos ou materiais	use (recursos ou materiais).
fazer ou ficar mais difícil	Torne -se difícil ou mais difícil.
(causa para) estar firmemente preso ou fechado.	causa para ser firmemente ligado.
tornar ou tornar -se mais largo ou mais extenso	Torne -se mais amplo ou mais largo ou mais extenso.
liberdade irrestrita para usar algo.	liberdade irrestrita para usar.
reivindicar, o ato de tomar posse ou poder sobre algo.	o ato de tomar posse ou poder sobre algo.
dê estrutura a	dê uma estrutura para.
Marque com cicatrizes	Marque com uma cicatriz.
(Baseball) Marque o corredor da base para tirá -lo.	Marque o corredor da base para tirá -lo.
ser refletido como ondas de calor, luz ou choque; .	Seja refletido como calor, som ou ondas leves ou de choque.
um concorrente com maior probabilidade de ganhar	um concorrente que se pensa provavelmente vencerá.
fazer ou se tornar mais longo	Torne -se longo ou mais longo.
estar na base no final de um turno	estar na base no final de um turno, de um jogador.
Qualquer uma das duas categorias (masculino ou feminino) nas quais a maioria dos organismos é dividida, ou propriedades -chave que distinguem as categorias.	Qualquer uma das duas categorias (masculino ou feminino) nas quais a maioria dos organismos é dividida.
(Ciência) O peso atômico de um elemento que tem a mesma capacidade de combinação que um determinado peso de outro elemento.	o peso atômico de um elemento que tem a mesma capacidade de combinação que um determinado peso de outro elemento; O padrão é 8 para oxigênio.
fornecer uma alternância	Forneça uma alternância ou alternância.
(causa) mover -se para frente e para trás ou de um lado para o outro	causa para se mover para frente e para trás.
medir a profundidade de um corpo de água	Meça a profundidade de (um corpo de água) com uma linha de som.
Faça um barulho alto, como um animal	Faça um barulho alto, como do animal.
o ato de ficar para descansar após uma viagem.	o ato de chegar à terra após uma viagem.
junte -se ou reúna (dois) objetos, idéias ou pessoas	traga dois objetos, idéias ou pessoas.
Faça referência a algo.	faça referência a.
Comporte -se violentamente, como se estivesse em um estado de grande raiva; quebrar ou rasgar violentamente.	Comporte -se violentamente, como se estivesse no estado de uma grande raiva.
formar uma espiral ou mover -se em um curso em espiral.	Mova -se em um curso espiral ou em zigue -zague.
uma sensação de aversão, aversão, antipatia	um sentimento de aversão ou antipatia.
liberação (gás ou energia) como resultado de uma reação química ou decomposição física (talvez em sentido metafórico)	liberação (gás ou energia) como resultado de uma reação química ou decomposição física.
superado de espanto; flabbergast	superado de espanto.
se comportar de maneira condescendente	se comportar de maneira patrocinadora e condescendente.
levar para a família ou grupo de um	Leve a família de um.
(Contrat Bridge) A oferta mais alta se torna a configuração do contrato no número de truques que o licitante deve fazer.	(Ponte do contrato) A oferta mais alta se torna o contrato definindo o número de truques que o licitante deve fazer.
vá em uma campanha ou para a guerra	vá em uma campanha; vá para a guerra.
reagir ou responder a uma chamada, comando ou estímulo	reaja a um estímulo ou comando.
(literalmente) som com ressonância.	som com ressonância.
uma lesão na pele causada por radiação, calor ou produtos químicos	Uma lesão causada pela exposição ao calor ou produtos químicos ou radiação.
fazer uma conexão causal ou lógica; agrupe	faça uma conexão lógica ou causal.
Aplique condicionador para tornar suave e brilhante.	Aplique o condicionador para tornar suave e brilhante.
exercitar ou ter poder de memória	Exercite, ou tenha o poder da memória.
um sentimento ou estado de extrema raiva.	um estado de extrema raiva.
enrugado, amassado ou amassado.	Fique enrugado ou amassado ou amassado.
admitir para testar / prova	admitir para testar ou prova.
Um período contábil de 12 meses	Qualquer período contábil de 12 meses.
elogie as qualidades para vender ou promover	faça um plugue para; elogie as qualidades ou para vender ou promover.
escuridão relativa de uma cor	escuridão relativa ou leveza de uma cor.
ataque pesadamente, especialmente com um punho ou implementação.	atacar pesadamente, especialmente com o punho ou um bastão.
Faça receptivo ou disposto a uma ação ou crença.	Faça receptivo ou disposto a uma ação, atitude ou crença.
abrir novamente, abra de novo	abrir novamente ou novamente.
uma formulação conceitual; uma maneira de conceber algo.	uma maneira de conceber algo.
aquecer metal antes de trabalhar	Aqueça um metal antes de trabalhar.
Sinta a forte necessidade de comer	Sinta a necessidade de comer.
estar em contato físico direto com	estar em contato físico direto com; faça contato.
dê uma merda; receba suck.	dê uma merda para.
Cobrindo para uma cama	Capa decorativa para uma cama.
aderência, penetrar ou rasgar com ou como se com os dentes ou mandíbulas	Para agarrar, cortar ou rasgar com ou como se com os dentes ou mandíbulas.
Jogue um instrumento de cordas com um arco	Jogue em um instrumento de corda com um arco.
dúvida ou uma impressão de que algo pode não ser o caso.	uma impressão de que algo pode ser o caso.
Um arremesso de sucesso ou tentativa para um ponto após um touchdown.	Um lance livre bem -sucedido ou tente para apontar após um touchdown.
expresse audivelmente; sons absolutos (não necessariamente palavras); indicar.	expresse audivelmente; sons absolutos (não necessariamente palavras).
retenha -se na incerteza ou falta de vontade	Faça uma pausa ou segure em incerteza ou falta de vontade.
uma porção de uma bebida	uma única porção de uma bebida.
Dê um incentivo ou motivo de ação.	Dê um incentivo à ação.
o dia anterior hoje	o dia imediatamente antes de hoje.
levar ou capturar por força ou autoridade	Pegue ou capture por força.
(Medicine) Aplique um gesso para.	Aplique um gesso fundido para.
interferir na atividade de outra pessoa	interferir na atividade de outra pessoa.
Atribua um novo tempo para um evento	Atribua uma nova hora e local para um evento.
valor medido pelo que deve ser dado ou feito para obter algo.	valor medido pelo que deve ser dado ou feito ou submetido a obter algo.
Toque ou segure com as mãos	Toque, levante ou segure com as mãos.
raspar ou esfregar para aliviar a coceira	Raspe ou esfregue como se quisesse aliviar a coceira.
dar um relato detalhado de	narrar ou dar um relato detalhado de.
Qualquer atividade que adquira a atenção de uma pessoa.	Qualquer atividade que ocupe a atenção de uma pessoa.
causa para ficar acordado ou alerta	causa para ficar acordado ou consciente.
fornecer um banquete ou banquete	Forneça um banquete ou banquete para.
o ato de dificultar os planos ou esforços de alguém.	um ato de dificultar os planos ou esforços de alguém.
tolo ou farsa (alguém).	tolo ou farsa.
levantar as apostas ou aposta de um jogo por um fator de 2	Aumentar as apostas em um jogo de cartas em um fator de 2.
O (período de) controle de um país por forças militares de uma potência estrangeira.	o controle de um país por forças militares de uma potência estrangeira.
(Ciência da Computação) A ocorrência de um resultado incorreto produzido por um computador.	(Ciência da Computação) A ocorrência de um resultado incorreto produzido por um computador.
Dê prazer, satifação ou felicidade; ser agradável a	Dê prazer ou seja agradável a.
o preenchimento macio sob uma sela	Um bloco macio colocado sob uma sela.
Elecate ou idealizar em alusão à transfiguração de Cristo	elevar ou idealizar, em alusão à transfiguração de Cristo.
incapacidade do coração de bombear sangue para sustentar funções de vida	incapacidade do coração de bombear sangue suficiente para sustentar funções corporais normais.
causa para vibrar em um padrão diferente	causa para vibrar em um padrão definido.
avisar ou chamar uma sensação de preparação	avisar ou despertar a um senso de perigo ou pedir para um estado de preparação.
adaptar -se a condições novas ou diferentes.	adaptar ou se conformar a condições novas ou diferentes.
Mova -se mais rápido, ou fazer se mover mais rápido	causa para se mover mais rápido.
Forneça alimentos prontos para comer, como para festas e banquetes.	fornecer comida pronta para comer; Para festas e banquetes.
expressar protesto ou dissidência, levantar uma objeção	expressar ou levantar uma objeção ou protesto ou crítica ou expressar dissidência.
Muco limpo da garganta de um	Limpo do muco ou comida da garganta de um.
passar para um estado ou condição	passar em um estado ou condição especificada.
Adicionar enfeites (aos manuscritos medievais)	Adicione enfeites e pinturas a (manuscritos medievais).
fazer ou ficar espesso	Faça grosso ou mais espesso.
mover ou executar muito rapidamente ou apressadamente	Corra ou mova -se muito rapidamente ou apressadamente.
Machucar, sentir dor física	sentir dor física.
contar ou espalhar rumores; dizer	Conte ou espalhe rumores.
jogue com força ou imprudência; náufrago	Jogue com força ou imprudência.
retornar ao pensamento ou discurso	retornar em pensamento ou discurso a algo.
Tente curar por cuidados ou tratamento especial, de uma doença ou lesão; tratar com cuidado.	Tente curar cuidados especiais do tratamento, de uma doença ou lesão.
um corte abrangente com um instrumento nítido	Um forte corte feito com um instrumento nítido.
Qualquer endereço em que se habita mais do que temporariamente.	Qualquer endereço no qual você habita mais do que temporariamente.
BOTANY - O órgão geralmente subterrâneo de uma planta que carece de brotos, folhas ou nós, que absorve água e sais minerais; Geralmente ancora a planta no chão.	(botânica) o órgão geralmente subterrâneo que não possui brotos, folhas ou nós; absorve água e sais minerais; Geralmente ancora a planta no chão.
reproduzir ou fazer uma cópia exata de; Faça, faça ou execute novamente.	reproduzir ou fazer uma cópia exata de.
passe (um fio) através ou para dentro ou para dentro ou como se estivesse em uma string	Freque ou como se estivesse em uma string.
gravar por meio de pontos.	gravar por meio de pontos e filmes.
tem um forte desejo de fazer algo	Tenha um forte desejo ou desejo de fazer alguma coisa.
ser relevante ou pertinente	ser pertinente ou relevante ou aplicável.
indicar desprezo respirando ruidosamente e com força através das notícias	Indique desprezo respirando ruidosamente e com força pelo nariz.
Torne -se ciente dos sentidos	tomar consciência através dos sentidos.
causa para estar alerta ou enérgico	causa para estar alerta e enérgico.
Remova apagando ou cruzando, como se desenhando uma linha.	Remova apagando ou cruzando ou como se desenhando uma linha.
cozinhe lentamente por um longo tempo em líquido	Cozinhe lentamente e por um longo tempo em líquido.
a temperatura em que um líquido ferve, bolhas	A temperatura na qual um líquido ferve ao nível do mar.
fazer um mapa de; mostrar ou estabelecer os recursos ou detalhes de; Explore ou pesquise com o objetivo de fazer um mapa.	fazer um mapa de; mostre ou estabeleça os recursos dos detalhes de.
A força social que liga alguém aos cursos de ação exigidos por essa força.	A força social que o liga aos cursos de ação exigidos por essa força.
Evite ou tente evitar o cumprimento, resposta ou execução.	Evite ou tente evitar o cumprimento, resposta ou execução (deveres, perguntas ou problemas).
liderar alguém na direção errada (fisicamente); Dê direções espaciais erradas.	Lidere alguém na direção errada ou dê direções erradas a alguém.
manter, afirmar ou reivindicar	manter ou afirmar.
Melhore restaurando uma condição anterior ou melhor.	restaurar a uma condição anterior ou melhor.
tornar acessível a alguma ação, influência ou condição	expor ou tornar acessível a alguma ação ou influência.
Aborde um limite à medida que o número de termos aumenta sem limite; especificamente um termo matemático.	Aborde um limite à medida que o número de termos aumenta sem limite.
A estichista que forma a borda de um sapato ou bota.	A costura que forma a borda de um sapato ou bota.
colocar sob o controle do governo federal	colocar sob o controle e autoridade de um governo federal.
Estimulação manual para a área genital para o prazer sexual.	Estimulação manual da área genital para o prazer sexual.
Equipe com um fusível	Equipe com um fusível; fornecer um fusível.
Fim da Revolução Americana	O final bem -sucedido da Revolução Americana.
(Matemática) O menor número inteiro ou um numeral representando esse número.	o menor número inteiro ou um numeral representando esse número.
fatores estimulantes ou exigentes de uma situação	uma situação exigente ou estimulante.
uma parte física de todo ou parte de um objeto natural coletado e preservado como um exemplo de sua classe ou total.	Todo ou parte de um objeto natural coletado e preservado como um exemplo de sua classe.
Amplifique uma corrente de elétrons, causando parte da energia no circuito de saída para atuar no circuito de entrada.	Amplifique (uma corrente de elétrons), causando parte da energia no circuito de saída para atuar no circuito de entrada.
Um humano pronuncia palavras em voz alta e com força.	Palavras absolutas em voz alta e com força.
opor -se com igual peso ou força	contraste com o mesmo peso ou força.
(causa para) atingir o ar em vôo.	Ataca o ar em voo.
preservar em uma lata ou jarra.	preservar em uma lata ou lata.
Uma cadeia de átomos em uma molécula formando um loop fechado	(Química) Uma cadeia de átomos em uma molécula que forma um loop fechado.
Faça o nível da superfície ou suave	faça a superfície do nível ou suave.
impressionar ou afetar profundamente (emocionalmente).	impressionar ou afetar profundamente.
Forneça um fluxo constante de algum líquido, com o objetivo de resfriar, limpar ou desinfetar.	Forneça com um fluxo ou pitada constante de algum líquido, com o objetivo de resfriar, limpar ou desinfetar.
Aplique um revestimento fino de tinta / metal	Aplique um revestimento fino de tinta, metal, etc. , para .
desconsiderar, não atende a	não conseguir atender.
faça um som curto e nítido	faça um som nítido.
conectar ou prender em uma corrente ligando	Conecte ou organize em uma corrente ligando.
venceu completamente em uma competição ou luta	venceu minuciosamente e conclusivamente em uma competição ou luta.
Procure um livro ou algum outro material escrito (para obter informações).	Olhe através de um livro ou outro material escrito.
estado de ser ativo	o estado de estar ativo.
(Teologia) O ato de delinear do pecado ou salvar do mal.	(Teologia) O ato de libertar do pecado ou salvar do mal.
declarar ou tornar impróprio ou inadequado	tornar inadequado ou inadequado.
cozinhe em uma superfície quente usando gordura; cozinhe em óleo.	Cozinhe em uma superfície quente usando gordura.
melhorar por poda ou polimento	melhorar ou perfeito por poda ou polimento.
uma área central em alguma região maior.	uma área que é aproximadamente central em alguma região maior.
Comece de repente, como se de medo	Comece de repente, como de medo.
Seja maior em número, quantidade, poder, status ou importância, sem ter pessoalmente o poder soberano.	ser maior em número, quantidade, potência, status ou importância.
Dê -se inteiramente a uma pessoa, atividade ou causa específica.	Dê inteiramente a uma pessoa, atividade ou causa específica.
o dedo ao lado do polegar, indicador	O dedo ao lado do polegar.
Apoie com algo ou alguém (desagradável)	Aumente algo ou alguém desagradável.
papel ou função do chefe de um departamento do governo	o papel do chefe de um departamento do governo.
Considere novamente, geralmente com o objetivo de mudar	considere novamente; dar uma nova consideração a; geralmente com o objetivo de mudar.
dirigir a uma velocidade excessiva ou ilegal	viajar a uma velocidade excessiva ou ilegal.
uma unidade militar da Força Aérea, menor que um esquadrão	uma unidade da Força Aérea menor que um esquadrão.
o ato de dar um emprego a alguém, contratando alguém	o ato de dar um emprego a alguém.
o ato de irritar alguém ou algo	o ato de incomodar ou irritante alguém.
cair, afundar ou se acalmar ou como se fosse por pressão ou perda de tautura; Torne -se menos intenso.	cair, afundar ou se acalmar ou como se fosse por pressão ou perda de tautura.
citar como uma autoridade; recorrer a (como em uma discussão).	citar como uma autoridade; recorrer a.
alocar ou dedicar; Separe ou separe para uma finalidade ou uso específico.	Separe ou separe para uma finalidade ou uso específico.
faça com que os componentes (de maneira improvisada)	Faça com os componentes (geralmente de maneira improvisada).
ensaiar, aprender por repetição	Aprenda por repetição.
pretende algo para avançar em direção a um certo objetivo	pretende (algo) avançar em direção a um certo objetivo.
Registre -se formalmente como participante	Registre -se formalmente como participante ou membro.
Escreva como se estivesse com impressão, não em cursivo	Escreva como se com impressão; não cursivo.
Abaixe os pássaros	Atirar, de pássaros.
Nomear para postagens clericais	Nomear para postagens de escritório.
(Química) passam por sequestro, formando um composto estável com um íon.	sofre sequestro formando um composto estável com um íon.
Forneça uma abertura para permitir que o ar circule ou a Gase escape.	Forneça uma abertura para permitir que o ar circule ou o gás escape.
Fique com os braços ou perna dianteiras levantadas, como ameaçador.	Fique com os braços ou pernas dianteiras levantadas, como se estivesse ameaçador.
Período contábil de 12 meses	Qualquer período contábil de 12 meses.
Converta a informação genética em uma fita de DNA em um fio de RNA.	Converta a informação genética em (uma fita de DNA) em um fio de RNA, especialmente o RNA mensageiro.
Dê uma surra para, vencer	dê uma surra para; bater duro.
mergulhe ou imerido em um líquido fervente, para fins de cozimento ou processamento.	mergulhe ou imerido em um líquido fervente, geralmente para fins de cozimento.
Forneça água para culturas, como nos canais, valas ou córregos.	Forneça com água, como com canais ou valas ou riachos.
O período durante o qual um contrato de leasing está em vigor.	O período de tempo durante o qual um contrato transmite propriedade a uma pessoa está em vigor.
proteger ou fortalecer com sacos de areia.	proteger ou fortalecer com sacos de areia; pare.
viagem ; Faça um tour por um lugar	Faça um tour por um determinado lugar.
o chefe político do governo da cidade	o chefe de um governo da cidade.
Passe a língua, aceite a língua	aceitar a língua.
Uma cidade no rio Tamisa em Bershire, sul da Inglaterra	Uma cidade no rio Tamisa em Berkshire, no sul da Inglaterra.
um gráfico ou mapa mostrando as dimensões, movimentos ou progresso de algo	um gráfico ou mapa mostrando os movimentos ou progresso de um objeto.
Tire uma parte vital ou essencial de algo.	Tire uma parte vital ou essencial de.
uma imperfeição; a qualidade de ser inadequado ou aquém.	A qualidade de ser inadequada ou aquém da perfeição.
Pate ou aperte, especialmente sob o queixo.	Dê um tapinha ou aperte com carinho ou de brincadeira, especialmente sob o queixo.
inventar algo fictício ou falso	inventar algo artificial ou falso.
o ato de engolir líquido	o ato de engolir.
Faça sexo ilegal com uma prostituta	Faça sexo ilegal com uma prostituta.
reverter o enrolamento ou torção de; separar os emaranhados de.	reverte o enrolamento ou torção de.
reembolsar ou compensar (alguém), como por uma perda ou sacrifício.	reembolsar ou compensar (alguém), como por uma perda.
Afie uma navalha com uma alça	Afie com uma alça.
o sinal telegráfico mais longo do código morse	os mais longos dos dois sinais telegráficos usados ​​no código MORSE.
A parte do corpo entre o pescoço e o braço ou qualquer uma de suas subpartes.	A parte do corpo entre o pescoço e o braço.
chuva, granizo ou neve com força e fique muito vento, muitas vezes com trovões e raios; soprar com força.	Chuva, grave ou neve com força e fique muito vento, muitas vezes com trovões ou raios.
Preencha com alto estado	preencha com alto estado; Preencha com otimismo.
A liberação de pressão acumulada durante uma parada consoante.	A liberação forçada de pressão do terminal acumulada durante a fase oclusiva de uma consoante parada.
(causa para) cair em gotas	Deixe ou causar cair em gotas.
o status de ser campeão.	O status de ser um campeão.
tirar vantagens de; Aproveite.	desenhe vantagens de.