medir a profundidade de um corpo de água	qualquer grande corpo profundo de água.
alguém que desempenha um papel principal	um ator que desempenha um papel principal.
(causa para) passar para descansar em uma superfície	alcance ou fique para descansar.
o ato de defender ou promover algo	o ato de escolher ou selecionar.
Sequência alfanumérica usada para identificação	um numeral ou string de números que são usados ​​para identificação.
um estado de ser elevado ou elevado	o evento de algo sendo levantado para cima.
o ato de levantar algo	o ato de escalar algo.
vincular ou unir (como se) com cimento.	brilhar intensamente, como se estivesse com calor.
(finalmente) faça algo ou esteja em algum lugar	causar algo para passar ou liderar em algum lugar.
um ponto, como a parte OP de uma flecha de bússola	Uma marca em forma de V em uma extremidade de um ponteiro de seta.
o ato de preservar ou proteger algo	o ato de diminuir ou reduzir algo.
coagir por violência, preencha com terror	coagir pela violência ou com ameaças.
causa para se mover, porque para ser movido	deixar de operar ou fazer com que a operação.
a área superior da região de algo	o ato de diminuir ou reduzir algo.
a principal parte de algo	tem sabor; gosto de algo.
se comportar ou se mover de uma certa maneira	se comportar de uma certa maneira.
uma reprodução ou representação física de algo	uma representação visual de algo.
um tipo de subdivisão de uma composição literária maior	uma divisão especializada de uma grande organização.
a pessoa que é designada para uma posição não eletiva	uma pessoa que é nomeada para um emprego ou posição.
avançar ; contribuir para o progresso ou crescimento de.	contribuir para o progresso ou crescimento de.
um canal estreito ou extensão de um mar ou oceano	Um canal estreito do mar se juntando a dois corpos maiores de água.
o ato de preservar ou proteger algo	o ato de quebrar algo.
Corte, possivelmente criando algo novo.	o ato de quebrar algo.
o ato de escolher entre alternativas	O ato de mudar uma coisa para outra coisa.
o ato de testar algo.	o ato de quebrar alguma coisa.
o estado de estar em contato	o estado de estar conectado.
dando uma referência ou citação de algo	Mude a natureza, propósito ou função de algo.
Venda algo ou obtenha algo por atividade secreta.	Venda algo ou obtenha algo por atividade enérgica e especialmente secreta.
o ato de determinar ou descobrir a posição de um objeto	uma parte da superfície da parte externa de um objeto.
um sentimento ou estado de contentamento, alívio	um estado de estar relaxado e não sentir dor.
estender ou se espalhar fisicamente para fora de um centro ou foco ou para dentro em direção a um centro; espalhe fisicamente do ponto de partida.	Estenda ou se espalhe para fora de um centro ou foco ou para dentro em direção a um centro.
coloque no chão para crescer	Coloque ou coloque no chão.
uma quantidade aproximada de algo	uma representação visual de algo.
estimular sexualmente; obter gratificação sexual através da auto-estimulação	Obtenha gratificação sexual através da auto-estimulação.
o ato de reconhecer a verdade de algo	o ato de se projetar de alguma coisa.
expresse audivelmente; sons absolutos (não necessariamente palavras); indicar.	expresse audivelmente; sons absolutos (não necessariamente palavras).
o estado de ser suspeito.	o estado de ser excluído.
o ato de fornecer aprovação e apoio.	o ato de ter e controlar a propriedade.
aliviar alguém do trabalho, dando uma volta; revezam -se funcionando.	alivie (alguém) do trabalho, dando uma volta.
um lado ou superfície de algo	uma breve experiência de algo.
total de uma certa maneira	aparecer de uma certa maneira.
o ato de girar, girar um objeto	girando ou torcendo (no lugar).
(causa para) aumentar na extensão ou intensidade.	aumento da extensão ou intensidade.
o estado legal de dinheiro	o ato verbal de oferecer.
entenda, dê sentido a	entenda; atribua um significado a.
o ato de começar algo novo.	o ato de contratar algo ou alguém.
Versão impressa de dados eletrônicos de um computador	(Ciência da Computação) Matéria mantida em um computador e é digitada ou impressa em papel.
limite em quantidade ou qualidade.	limite de qualidade ou quantidade.
Pesquise (como o fundo de um corpo de água) por algo	Pesquise (como o fundo de um corpo de água) por algo valioso ou perdido.
o ato de se render ou perder algo de valor	o ato de diminuir ou reduzir algo.
o ato físico de seguir em um esforço para ultrapassar ou capturar.	o ato de buscar em um esforço para ultrapassar ou capturar.
expulsar ou ejetar (saliva, fleuma, escarro ou vômito) da boca.	expulsar ou ejetar (saliva ou fleuma ou escarro) da boca.
a progressão natural ou desenvolvimento de algo	o ato ou meio de se livrar de algo.
o ato de levantar algo	o ato de descrever algo.
uma explicação ou álibi para algo	uma opinião formada por julgar algo.
recuperar, retornar ao antigo estado	retornar a uma condição anterior.
Aja sem permissão ou com muita confiança.	Tome liberdades ou aja com muita confiança.
O ato de preparar uma preparação em algo.	o ato de testar algo.
Torne -se o proprietário ou posess de algo	Faça um filme ou fotografia de algo.
o ato de se mover, girando algo	o ato de rejeitar algo.
o ato de confinar, prevenir ou bloquear algo	o ato de testar algo.
O ato de preparar uma preparação em algo.	o ato de diminuir ou reduzir algo.
o ato ou meio de se livrar de algo.	a posição física de algo.
a forma de uma onda em um determinado período de tempo	O gosto popular em um determinado momento.
um estilo de roupa distinto	uma compreensão intuitiva de algo.
causa para ter um odor	causa para ficar vivo novamente.
cair ou fazer cair	Deixe ou causar cair em gotas.
o ato de permitir, conceder algo	o ato de testar algo.
não ser visto ou percebido por outros	segure; não ser percebido por outros.
um documento autorizando outro a votar em nome de um	Um documento de procuração dado pelos acionistas de uma corporação que autoriza uma votação específica em seu nome em uma assembléia corporativa.
o ato de levantar algo	o ato de reter algo.
o ato de combinar, misturar, integrar	o ato de lascar algo.
cheiro inalando através do nariz	perceber inalando através do nariz.
a conclusão de uma comunicação	o significado pretendido de uma comunicação.
(causa para) adotar um sistema, valor ou ponto de vista diferente	causa para adotar uma fé nova ou diferente.
(causa para) tornar -se menos intenso ou rigoroso	causa para ficar violento ou zangado.
o ato de escolher ou selecionar	o ato de perder alguém ou algo.
narrativa ou conta, destinada a relatórios factuais	Um breve relato das notícias.
gravar por meio de pontos.	gravar por meio de pontos e filmes.
o ato de afastar algo	o ato de levantar algo.
Decida o valor a ser pago em uma reivindicação de seguro	Decida quanto deve ser pago em uma reivindicação de seguro.
Faça barulho como um motor ruim	Faça um barulho típico de um motor sem lubrificantes.
estar em contato físico direto com	estar em contato físico direto com; faça contato.
a qualidade de ser confiável	a qualidade de ser de uso prático.
Organize um programa para um indivíduo, grupo ou entidade.	Organize um programa de ou para.
expressar uma certa idéia ao renderizar uma peça ou música	dê uma interpretação ou versão de.
a qualidade de ser confiável	o ato de morar em um lugar.
uma loja ou suprimento de algo	uma loja ou suprimento de algo (especialmente de comida, roupas ou braços).
sugerir ou prescrever uma solução	sugerir a necessidade de uma intervenção; em medicina.
pessoa que gerencia dinheiro em jogos de tabuleiro	uma pessoa que está no comando.
o ato de esfregar uma superfície	o ato de arrastar (puxar com força).
o ato de dividir ou desconectar.	o ato de expulsar ou projetar ou ejetar.
o ato de validar a autenticidade de algo	O ato de ocultar a identidade de algo modificando sua aparência.
O ato de preparar uma preparação em algo.	o ato de forçar alguém ou algo.
o ato de preservar ou proteger algo	o ato de enrolamento ou torcer.
opor ou abordagem, como em hostilidade ou competição	Opor, como em hostilidade ou competição.
viajar (como se) pela água.	Mova -se como se através de uma peneira.
administrar ou conceder como porções	Administre ou conceda, como em pequenas porções.
formar uma espiral ou mover -se em um curso em espiral.	para enrolar ou se mover em um curso em espiral.
induzir em ação usando o charme de um; provocar para fazer algo.	induzir em ação usando o charme de um.
túneis subterrâneos conectados usados ​​por coelhos	Uma série de túneis subterrâneos conectados ocupados por coelhos.
Segure ou abraça em um aperto apertado	Segure em uma compreensão apertada.
a forma de uma onda em um determinado período de tempo	A forma de uma onda ilustrada gráficamente plotando os valores da quantidade de período em relação ao tempo.
a principal parte de algo	a parte inferior de qualquer coisa.
o ato de controlar restringindo alguém ou algo.	o ato de libertar alguém ou algo.
o ato de planejar ou deliberar	a ação de colocar algo em operação.
estar localizado no ou em cima de algo	causar (alguém) passar por algo.
o perfume ou odor de algo	o ato de diminuir ou reduzir algo.
(causa para) emitir um som de estalido seco, possivelmente misturando.	Faça um som de crepitação seco.
Encha, prenda, conserte com ou como se com goma	Cubra, encha, conserte ou mancha com ou como se com gengiva.
O ato de falar sobre as características de algo.	o ato de compartilhar as atividades de um grupo.
o ato de fornecer ajuda ou ajuda a alguém	o ato de aplicar tinta a uma superfície.
um crescimento natural de plantas, geralmente árvores	um crescimento de plantas semelhantes (geralmente árvores) em uma área específica.
o ato de planejar ou deliberar	o ato de quebrar algo.
a extensão física do universo	a posição física de algo.
uma área de fronteira ou borda de algo	um limite marcando as extremidades de algo.
alcançar um destino ou objetivo	chegar a um destino; chegar por movimento ou progresso.
o ato de preservar ou proteger algo	o ato de expulsar ou projetar ou ejetar.
argumentar ou implorar a favor de	discutir ou falar em defesa de.
apoiar, sustentar, suportar ou ser responsável por	porque acontecer ou ser responsável.
levar ou capturar por força ou autoridade	para largar pela força ou autoridade.
(causa para) prolongar ou esticar no espaço	causa para marchar ou ir em um ritmo marchando.
o ato de render, rasgar, rasgar	o ato de reduzir a quantidade ou número.
Equipe com veículos a motor armados e blindados (como de um exército).	Equipe com veículos a motor armados e blindados.
(o conteúdo de) uma comunicação.	a última seção de uma comunicação.
o ato de mudar de curso ou torcer a si mesmo.	o ato de indicar ou apontar pelo nome.
o ato de pressionar firmemente	o ato de perturbar a mente ou o corpo.
o estado ou condição de sentimento ou ser apressado.	a condição de ser motivado.
mova para uma posição mais baixa, encerrar algo	Abaixe o tom de (notas musicais).
o ato de puxar uma carga	o ato de fazer uma proposta.
(causa para) aparecer de repente ou brevemente	Quebre ou se separem repentinamente e com força.
o ato humano de fazer algo novo.	o ato de fala de tornar algo evidente.
tornar ou tornar -se mais agudo ou intenso	prepare -se para ação ou uso.
a atividade de quebrar ou lança algo	o ato de quebrar alguma coisa.
o ponto final extremo de algo	Obtenha o significado de algo.
execute uma ação com a intenção de enganar.	Faça uma cópia com a intenção de enganar.
qualquer causa ou fonte de grande sofrimento	Qualquer aflição que cause grande sofrimento.
o ato de se mover, girando algo	o ato de desenhar ou transportar algo.
permanecer emocionalmente ou intelectualmente apegado sem o contato físico necessário.	permanecer emocionalmente ou intelectualmente ligado.
o estado de estar satisfeito com a vida.	o estado de ser rejeitado.
a altura da superfície do mar	A parte sólida da superfície da Terra.
o ato de testar algo.	o ato de começar algo.
cubra com uma base de primer	cubra com uma cartilha; aplique um primer a.
descobrir uma conexão lógica ou causal; associado	faça uma conexão lógica ou causal.
reescrever em um script diferente.	estender em uma direção diferente.
o ato de raciocínio, cogitação	o ato de começar algo novo.
o ato de fazer um discurso	o ato de dar uma aparência falsa.
estar localizado no ou em cima de algo	Observe ou plote o caminho em movimento de algo.
o ato de girar, girar um objeto	o ato de quebrar alguma coisa.
o perfume ou odor de algo	Tenha um desacordo sobre algo.
Dê um incentivo ou motivo de ação.	Dê um incentivo à ação.
o contexto ou cenário em que algo ocorre	o ato de cortar algo em partes.
tolerar; aceita ou assumir como responsabilidade.	dar uma garantia ou assumir responsabilidade.
mover de um local para outro	Mova de um lugar para outro.
o ato de testar algo.	o ato de deixar algo.
Dê uma afetação performativa a (algo).	faça uma performance (de alguma coisa).
um participante que é iniciante em alguma atividade	qualquer novo participante de alguma atividade.
gire a raquete ou remo.	gire a raquete; em canoagem.
a atividade de examinar ou avaliar algo	o ato de desenhar ou transportar algo.
a conclusão de uma comunicação	a última seção de uma comunicação.
Um objeto prejudica a respiração de alguém ou algo.	a relação de compreender algo.
ser uma razão, causa ou justificativa de	Sirva como uma razão, causa ou justificativa de.
recuar ou mover de uma posição, realocar	Retire de uma posição ou escritório.
o ato humano de fazer algo novo.	o ato de iniciar algo pela primeira vez; apresentando algo novo.
Uma instância de interromper algum movimento	o ato de começar algo.
(causa para) gradualmente se tornar fraco	causa para se tornar amplamente conhecido.
uma deficiência, estado de decepção, não atendimento	Um evento que não cumpre o objetivo pretendido.
o ato de desistir de uma reivindicação, cargo ou posse.	o ato de desistir (uma reivindicação ou escritório ou posse etc.).
a área superior da região de algo	controle exclusivo ou posse de algo.
Tire algo ou alguém para longe de algum lugar	Pegue algo ou alguém consigo mesmo em algum lugar.
energia na forma de movimento molecular	dinheiro na forma de contas ou moedas.
um estado de exposição ao dano	um estado de extrema pobreza.
O ato de preparar uma preparação em algo.	o ato de anexar ou afixar algo.
o ato de testar algo.	o ato de rejeitar algo.
tem um forte desejo de fazer algo	tem um desejo ou desejo de saber de algo.
Assumir (mental ou fisicamente)	Tome (gás, luz ou calor) em uma solução.
o ato de omitir intencionalmente algo	o ato de rasgar, rasgar ou dividir alguma coisa.
pronuncie com um toque nasal	pronuncie com um sibilante inicial.
uma inclinação para cima ou inclinação	uma inclinação ou nota ascendente (como em uma estrada).
uma lote ou porcentagem de algo	um pedaço de algo estreito relativamente longo.
murchar, murchar ou madurar imperfeitamente, como de uma flor.	murchar ou murchar ou madurar imperfeitamente.
Identificar, estabelecer localização ou identidade	reconhecer como ser; Estabeleça a identidade de alguém ou algo.
o ato de afastar algo	o ato de começar algo.
uma explicação ou álibi para algo	uma obrigação de pagar ou fazer algo.
inclinar de uma posição vertical	para inclinar ou dobrar de uma posição vertical.
preservar em uma lata ou jarra.	preservar em uma lata ou lata.
se comportar ou se mover de uma certa maneira	Vista -se de uma certa maneira.
o ato de testar algo.	o ato de levantar algo.
dar uma explicação enganosa para; cobrir	Dê uma explicação ou desculpa enganosa para.
A principal atividade que se faz para ganhar dinheiro.	A principal atividade em sua vida que você faz para ganhar dinheiro.
o ato de dividir ou desconectar.	o ato de desenhar ou transportar algo.
o ato de planejar ou deliberar	o ato de se tornar mais distante.
o ato de testar algo.	o ato de reter algo.
12º mês do ano civil	O último (12º) mês do ano.
a atividade de examinar ou avaliar algo	a atividade de proteger alguém ou algo.
o ato de girar, girar um objeto	o ato de incomodar ou irritante alguém.
uma empresa que fornece commodities de serviço público	uma empresa que executa um serviço público; sujeito à regulamentação do governo.
envolver -se com ou misturado	envolver-se ou confusos com.
diminuição gradual na força de um sinal	um declínio gradual (em tamanho ou força ou poder ou número).
uma taxa ou ocorrência rápida de algo	uma breve experiência de algo.
o ato de levantar algo	o ato de lascar algo.
(causa para) tornar -se par ou nivelado	fazer uniforme ou mais uniforme.
declarar inválido; Tire a força legal de ou tornar ineficaz.	Tire a força legal de ou tornar ineficaz.
Dê um incentivo ou motivo de ação.	dê uma interpretação ou versão de.
acertar ou retornar antes de tocar o chão	Bata antes de tocar o chão.
o ato ou meio de se livrar de algo.	o estado de não ter certeza de algo.
o ato de acusar alguém ou algo por ser culpado	a ação de colocar algo em operação.
Corrija ou defina um objeto físico com segurança ou dependa	Corrija ou defina de forma segura ou profundamente.
uma história; O plano, esquema ou história principal de um trabalho literário ou dramático, verdadeiro ou fictício.	a história que é contada em um romance ou peça ou filme etc.
a atividade de quebrar ou lança algo	o ato de rasgar, rasgar ou dividir alguma coisa.
uma loja de varejo com mercadoria à venda	Um estabelecimento mercantil para a venda de mercadorias ou serviços no varejo.
torcer uma parte do corpo repentinamente para entrar em torno	torça repentinamente para torcer.
resistir a tecido ou órgão imunologicamente estranho	Resista imunologicamente, a introdução de algum tecido ou órgão estranho.
ser um fator ou desempenhar um papel em algo	o ato de parar de algo.
O preço de negociação entre vendedores e compradores em um mercado aberto	O preço pelo qual compradores e vendedores negociam o item em um mercado aberto.
solicitar ou exigir algo de alguém	o ato de danificar algo ou alguém.
o ato de confinar, prevenir ou bloquear algo	o ato de formar ou estabelecer algo.
andar nos ombros ou de volta de alguém; suporte nas costas ou ombros.	suporte nas costas e ombros.
opor -se com igual peso ou força	contraste com o mesmo peso ou força.
a qualidade de agir com vigor e vitalidade	a qualidade de não ser útil ou conveniente.
a qualidade de ser importante, digna de atenção	A qualidade de ser importante e digna de nota.
apego, restrição ou manilha entre entidades físicas	Uma restrição que limita ou restringe a liberdade (especialmente algo usado para amarrar ou restringir um prisioneiro).
a redução da extensão de algo, por exemplo, seu tamanho, importância ou quantidade	Mudar em direção a algo menor ou menor.
uma caracterização visual de algo	uma chance de fazer algo.
Coloque em um determinado local ou local abstrato	causa para estar em um local, estado ou relação apropriada.
a ação de se estender para fora	a característica de desperdiçar recursos.
a conseqüência ou conseqüência de algo	tem sabor; gosto de algo.
(causa para) aumentar a ansiedade.	causa para correr em pânico.
a atividade de examinar ou avaliar algo	o ato de diminuir ou reduzir algo.
o ato de preservar ou proteger algo	o ato de formar ou estabelecer algo.
Ligue um eixo; rodar	causa para ligar um eixo ou centro.
Jogue sem ofado em oposição ou rivalidade	Situado em oposição ou rivalidade.
o processamento ou operação de algo	a posição física de algo.
o ato de puxar uma carga	o ato de ouvir atentamente.
o ato de explicar ou defender algo	o ato de designar ou identificar algo.
Venha, atace ou pegue alguém ou algo inconsciente	o ato de libertar alguém ou algo.
o ato de girar, girar um objeto	o ato de deixar algo.
queda social ou econômica de alguém ou grupo	falha que resulta em perda de posição ou reputação.
o componente principal de uma comunicação	a última seção de uma comunicação.
o processo de se tornar menos ou menor	processo ou resultado de se tornar menor ou menor.
a seção final de uma comunicação	a última seção de uma comunicação.
Reduza para pequenos pedaços batendo ou moendo.	Reduza para pequenos pedaços ou partículas batendo ou abrasando.
o ato ou capacidade de ver	a gama de juros ou atividades que podem ser antecipadas.
o ato de acusar alguém ou algo por ser culpado	o ato de danificar algo ou alguém.
dar uma interpretação específica para	torça e gire para dar uma interpretação pretendida.
o estado de ser suspeito.	o estado de ser rejeitado.
O processo de cultivar a terra, possivelmente como um modo de vida.	Agricultura considerada como uma ocupação ou modo de vida.
uma aeronave militar que abre a ordenança	Uma aeronave militar que abre bombas durante o voo.
o ato de acusar alguém ou algo por ser culpado	o ato de libertar alguém ou algo.
aceitar, aclimatir ou se adaptar a um contexto, situação	adaptar ou se conformar a condições novas ou diferentes.
a temperatura em que um líquido ferve, bolhas	A temperatura na qual um líquido ferve ao nível do mar.
o ato humano de fazer algo novo.	o ato de quebrar algo.
Bata ou bata (como se) com um chicote.	Mantenha com ou como se com uma aposta.
o ato de levantar algo	o ato de parar de algo.
Reinicie em um cavalo para perder uma corrida	Reinicie para não vencer uma corrida.
(causa para) passar para descansar em uma superfície	Causa para sair em um esguicho.
fornecer ou suprir com água	cubra ou pântano com água.
quantidade que pode ser contida	a quantidade que pode ser contida.
conter ou ter uma redação ou informação específica	ter ou conter uma certa redação ou formulário.
Um canal de comunicação social	Um canal de comunicação entre grupos.
causar ou durar mais, estender -se em duração ou espaço.	prolongar ou estender em duração ou espaço.
uma classificação ou posição em relação a outros	Pegue ou tenha uma posição em relação a outros.
a área superior da região de algo	o ato de deixar algo.
a aparente condição ou estado de algo	o ato de perder alguém ou algo.
queimar um pouco para afetar a cor	Queime um pouco e superficialmente para afetar a cor.
uma característica geral ou característica de algo	Dê certas propriedades a algo.
posição no futebol jogado por um membro do time	(Futebol americano) Uma posição na linha de scrimmage.
o ato de organizar elementos juntos.	o ato de prender as coisas juntas.
causar uma dor nítida ou ardente	causar uma dor nítida ou picante ou desconforto.
o ato de escolher ou selecionar	o ato de deixar algo.
incitar ações, causar um evento	servir como a causa incitada de.
surgir, a partir de líquido ou gás	Venha, como de um líquido.
(causa para) tornar -se menos tenso; Descanse ou pegue uma facilidade.	Torne -se menos tenso, descanse ou tenha uma facilidade.
adaptar -se a uma medição ou proporção especificada	adaptar -se a uma medição especificada.
forma anatômica do corpo de um ser, físico	nomes alternativos para o corpo de um ser humano.
causar ação romântica; afastar -se da conduta adequada	atrair ou se afastar do dever, princípios ou conduta adequada.
inventar algo fictício ou falso	inventar algo artificial ou falso.
Remova para ou para um lugar ou situação	quebrar de uma reunião ou reunião.
o ato de levantar algo	o ato de acabar com algo.
um acontecimento ou incidente de significado humano	um conjunto especial de circunstâncias.
proteger com ou como se com um escudo	Proteja, esconda ou oculte o perigo ou o dano.
Unidade monetária básica do Quirguistão	A unidade básica de dinheiro no Quirguistão.
o ato de levantar algo	o ato de quebrar algo.
(causa) mover -se suavemente para frente e para trás	causa para se mover para frente e para trás.
o estado de estar em contato	o estado de estar ativo.
o ato de testar algo.	o ato de diminuir ou reduzir algo.
o ato de explicar ou defender algo	o ato de expulsar ou projetar ou ejetar.
Entenda o significado de algo.	Obtenha o significado de algo.
correr um risco ou adivinhar na esperança de um resultado favorável	correr um risco na esperança de um resultado favorável.
o ato de irritar alguém ou algo	o ato de aplicar força para impulsionar algo.
mudança (dramaticamente) entre valores altos e baixos	Alterne dramaticamente entre valores altos e baixos.
a atividade de examinar ou avaliar algo	o ato de designar ou identificar algo.
(causa) ficar ansioso ou preocupado	causa para ser equilibrado ou suspenso.
design para um propósito específico	Planeje algo para um papel ou propósito específico ou efeito.
para combater ou se opor a alguém ou algo	o ato de forçar alguém ou algo.
(causa para) formar um cluster no espaço abstrato ou físico.	causar, no sentido abstrato ou no sentido físico.
uma compreensão mental ou compreensão de algo	compreensão da natureza ou significado ou qualidade ou magnitude de algo.
fazer algo considerado abaixo de um Diginty	Faça algo que se considere estar abaixo da dignidade de um.
(jogo) Uma divisão durante a qual se pode jogar (talvez como ofensa).	(Esportes) Uma divisão durante a qual uma equipe está na ofensiva.
o ato de cortar o comprimento, saindo	o ato de recorte ou correr.
um regime soberano e sua assembléia	o soberano e seus conselheiros que são o poder de governo de um estado.
o ato de irritar alguém ou algo	o ato de levantar algo.
o ponto final extremo de algo	o ato ou meio de se livrar de algo.
ser ou ter uma qualidade de ser	a qualidade de ser significativa.
melhorar por poda ou polimento	melhorar ou perfeito por poda ou polimento.
o ato de preservar ou proteger algo	o ato de aplicar força para impulsionar algo.
Registre -se formalmente como participante	Registre -se formalmente como participante ou membro.
uma alavanca que ativa um mecanismo de disparo, especialmente com uma arma de fogo	alavanca que ativa o mecanismo de disparo de uma arma.
o ato de começar algo novo.	o ato de acabar com algo.
o ato de irritar alguém ou algo	o ato de libertar alguém ou algo.
Corte, possivelmente criando algo novo.	uma razão para querer algo feito.
um jogo casual de jogar uma bola para frente e para trás	Um jogo cooperativo no qual uma bola é passada.
surgir, a partir de líquido ou gás	aceitar, até dívidas ou pagamentos.
porque ficar imerso em	porque estar pendurado ou suspenso.
o ato de substituir uma coisa por outra	O ato de mudar uma coisa para outra coisa.
o ato de testar algo.	uma maneira ou meio para alcançar algo.
o ato de validar a autenticidade de algo	o ato de libertar alguém ou algo.
quantidade de tempo em que algo é adiado	tempo durante o qual alguma ação é aguardada.
reverte uma direção, atitude ou curso de ação, talvez perceptivamente.	reverso (uma direção, atitude ou curso de ação).
um direito estabelecido ou reconhecido, formal ou informal.	um direito estabelecido ou reconhecido.
o ato de omitir intencionalmente algo	o ato de formar ou estabelecer algo.
os ocupantes que habitam em um nível de edifício	os ocupantes de um piso.
um método para resolver um problema	a ação bem -sucedida de resolver um problema.
causa para se mover com um filme ou como se com um filme	Cubra com flocos ou como se com flocos.
um observador de um processo ou atividade	um membro de uma força policial.
um endereço usado para comunicação postal	o endereço onde uma pessoa ou organização pode ser comunicada.
Encontre, desencadeie ou ridicularize por aplausos e gritos.	esporá ou incentive especialmente por aplausos e gritos.
sobressalente em qualidade ou quantidade	limite de qualidade ou quantidade.
o ato de afastar algo	o ato de contratar algo ou alguém.
a aparente condição ou estado de algo	O evento que consiste no início de algo.
gravar, formar ou cortar, afastando -se na superfície	gravar ou cortar chipando em uma superfície.
algo considerado banal, mas divertido	algo lembrado à mente.
o ato de levantar algo	o ato de construir algo.
promulgação concreta de uma ideia ou conceito	uma representação concreta de um conceito nebuloso.
levantar ou transportar como se com um mecanismo	afetar com ou como se com uma cãibra.
(causa) mudar de um sólido para um líquido.	Torne -se líquido ou fluido quando aquecido.
(o ato de fazer) uma medição de algo.	O ato de decidir sobre algo.
uma duplicata de algo, servindo como um backup	algo adicional do mesmo tipo.
(o ato de fazer) uma medição de algo.	o ato de remover ou se livrar de algo.
reagir ou responder a uma chamada, comando ou estímulo	reaja a um estímulo ou comando.
clube ou associação de pessoas com um interesse compartilhado	uma associação formal de pessoas com interesses semelhantes.
livre de obrigações, serviço ou confinamento	livre de obrigações ou deveres.
o grau ou quantidade de algo	o ato de deixar algo.
o ato de chegar a um determinado lugar	o ato de colocar algo em um determinado lugar.
meio de troca cunhado por um governo	A moeda oficial emitida por um governo ou banco nacional.
avançar ou avançar no tribunal	avançar ou estabelecer no tribunal.
fazer uma nota por escrito de algo	fazer uma nota por escrito de.
o ato de explicar ou defender algo	o lote de alguma quantia dividindo algo.
um cidadão do antigo troy	um nativo do antigo Troy.
o ato de testar algo.	o ato de rasgar, rasgar ou dividir alguma coisa.
o ato de girar, girar um objeto	o ato de encerrar uma vida.
o ato de se mover de maneira apressada.	O ato de se mover apressadamente e de maneira descuidada.
o ato de recorte, corte	o ato de descrever algo.
levantar fisicamente de uma posição mais baixa.	elevar de uma posição mais baixa a mais alta.
o ato de girar, girar um objeto	o ato de reter algo.
um aumento de tamanho conforme medido por unidade de tempo	A taxa de aumento do tamanho por unidade de tempo.
Aviso antecipado ou notificação de algo	a primeira parte ou seção de algo.
o ato de defender ou promover algo	o ato de construir algo.
Forneça água para culturas, como nos canais, valas ou córregos.	Forneça com água, como com canais ou valas ou riachos.
sufocar, suportar ou diminuir algo	o ato de testar algo.
porque ficar imerso em	causa para se interessar ou curioso.
o ato humano de fazer algo novo.	o ato de fazer ou promulgar leis.
o significado pretendido de uma instância de comunicação.	o significado pretendido de uma comunicação.
ser dado a, entre na posse de	entrar na posse de.
total de uma certa maneira	reagir de uma certa maneira.
ter ou ser coberto com cerdas	o estado de estar coberto de coisas impuras.
o ato de planejar ou deliberar	o ato de escolher ou selecionar.
estar localizado no ou em cima de algo	Faça um filme ou fotografia de algo.
estar dentro ou estabelecer comunicação com	mover ou estabelecer em um novo local.
adaptar -se a condições novas ou diferentes.	adaptar ou se conformar a condições novas ou diferentes.
estar localizado no ou em cima de algo	uma obrigação de pagar ou fazer algo.
uma coleção de algo, geralmente uma grande quantidade	Uma coleção de coisas compartilhando um atributo comum.
chicote com ou como se com um batedor	Peça com ou como se estivesse com um aguilhão.
disfunção ou doença do coração	uma doença do coração.
decore um manuscrito com vermelho	Decore (manuscritos) com letras pintadas de vermelho.
o ato de dedicar tempo e energia a algo	o ato de libertar alguém ou algo.
Verifique algo comparando -se a um padrão	Verifique ou regular (um experimento científico) realizando um experimento paralelo ou comparando com outro padrão.
parte, cessar ou quebrar associação com (alguma coisa).	papel ; cessar ou quebrar a associação com.
Coloque os saltos em um sapato	Coloque um novo salto.
o ato de preservar ou proteger algo	o ato de levantar algo.
Faça imagens ou sons menos nítidos	Faça (imagens ou sons) nítidos ou mais nítidos.
Expelir ou ejetar saliva, escarro ou um objeto da boca.	expulsar ou ejetar (saliva ou fleuma ou escarro) da boca.
medir a profundidade de um corpo de água	Meça a profundidade de (um corpo de água) com uma linha de som.
dar um relato detalhado de	narrar ou dar um relato detalhado de.
um tema ou padrão artístico recorrente	Um tema que é repetido ou elaborado em uma peça musical.
o ato de escolher ou selecionar	o ato de olhar ou ver ou observar.
tem um forte desejo de fazer algo	Tenha um forte desejo ou desejo de fazer alguma coisa.
a atividade de olhar bem para encontrar algo ou alguém.	o ato de remover ou se livrar de algo.
pessoa que é um companheiro social	um amigo que está frequentemente na companhia de outro.
Segure ou local em equilíbrio	Segure ou carregue em equilíbrio.
o ato de acusar alguém ou algo por ser culpado	o gerenciamento de alguém ou algo.
Trabalhe como um tinker (fixos e panelas)	Trabalhe como um Tinker ou Tinker.
o ato de permitir, conceder algo	o ato de formar ou estabelecer algo.
o término, final de uma reunião	o término de uma reunião.
arranhão ou raspe com garras ou unhas	ataque como se com garras.
uma ocasião social, muitas vezes oficial ou formal	uma reunião ou cerimônia social formal ou oficial.
inferir ou acreditar ser o caso	Acredite ser o caso.
mover de forma a evitar	Faça um movimento repentino em uma nova direção para evitar.
o estado de estar ausente.	o ato de escalar algo.
Remova beliscando ou cortando	Reduza ou remova beliscando ou rolando.
(causa para) tornar -se um pó ou como poeira.	causa para se tornar amplamente conhecido.
Prepare, organize; criar ou organizar para um determinado propósito	Qualquer área reservada para uma finalidade específica.
o ato de pessoas fazendo sexo	o ato de escalar algo.
Para dar palestras formalmente para um público	acusar formalmente um crime.
o ato de criar um trabalho artístico	o ato de criar trabalhos escritos.
o estado de estar em contato	o estado de ser excluído.
coletar material descartado, recusado ou danificado	coletar material descartado ou recusado.
uma empresa ou empresa que publica o Newsprint	uma empresa de negócios que publica jornais.
o ato de incentivar alguém	o ato de motivar; fornecendo incentivo.
a atividade de examinar ou avaliar algo	o ato de examinar as semelhanças.
faça marcas na superfície de.	Faça pequenas marcas na superfície de.
Faça uma cópia com a intenção de enganar.	aceitar a língua.
o ato de escolher ou selecionar	o ato de recorte ou correr.
sobressalente em qualidade ou quantidade	ser igual a em qualidade ou habilidade.
retornar ao pensamento ou discurso	retornar em pensamento ou discurso a algo.
o ato de testar algo.	o ato de escalar algo.
maneira de manusear, gerenciar alguém ou algo	o gerenciamento de alguém ou algo.
o ato de selecionar ou escolher algo	o ato de diminuir ou reduzir algo.
Deite-se-supere um fim para um estado ou atividade	Coloque um fim a um estado ou atividade.
Mova o corpo para trás e para baixo para uma posição de descanso confortável	Mova -se ou organize -se em uma posição confortável e aconchegante.
brilhar intensamente; Emite uma luz constante e uniforme de uma fonte.	Emite uma luz uniforme e estável sem chamas.
o ato de comprar de volta algo vendido anteriormente.	o ato de começar algo.
alcance ou causa para alcançar o ponto mais alto, melhor algo	um ato (ou falha em agir) que decepciona alguém.
um tipo de aeronave militar	uma unidade de aeronave militar.
O ato de preparar uma preparação em algo.	o estado de apreciar ou circundar.
uma pessoa que planta ou detona explosivos	uma pessoa que planta bombas.
Faça a forma para um propósito específico	traje para um propósito especial.
ataque com horror, surpresa, nojo	ataque com horror ou terror.
tenha o mesmo valor, seja ou se torne equivalente a outra coisa	Estabeleça algo como sendo anteriormente em relação a outra coisa.
um estado de confusão ou desordem.	Jogue em grande confusão ou desordem.
um recinto público para animais, como cães	Um gabinete público para cães perdidos ou não licenciados.
um sistema pelo qual uma moeda é trocada por outra, permitindo transações internacionais	o sistema pelo qual uma moeda é trocada por outra; Permite que as transações internacionais ocorram.
a progressão natural ou desenvolvimento de algo	O processo natural de estabelecer um depósito de algo.
o ato de puxar um objeto	o ato de escolher ou selecionar.
uma distinção perceptiva baseada em cor ou sombreamento.	O efeito perceptivo da justaposição de cores muito diferentes.
o ato de comprar de volta algo vendido anteriormente.	o ato de reter algo.
Cozinhe em creme ou usando creme.	Adicione o creme ao café de um, por exemplo.
um aspecto negativo ou indesejável de algo	Considere como parte de algo.
enquadre ou desenvolva algo para um propósito específico	traje para um propósito especial.
identificar ou escolher alguém ou algo	o ato de perder alguém ou algo.
um estado de estar cercado	o estado de ser esgotado.
Leia ou esteja em conformidade com o padrão métrico de	estar em conformidade com um padrão métrico.
um ramo importante de uma árvore	um pequeno galho fino de uma árvore.
o ato de levantar algo	o ato de começar algo.
(causa para) tornar -se um fluido, como quando aquecido.	Faça (uma substância sólida) líquido, como por aquecimento.
formulários de esquemas de maneira insuficiente	formar intrigas (para) de maneira insuficiente.
identificar ou escolher alguém ou algo	o ato de forçar alguém ou algo.
o ato de aplicar tortura no pé e perna	Uma forma de tortura nos pés na qual os pés são envoltos em ferro e lentamente esmagados.
Mova -se como se não puder controlar a maneira ou a direção do movimento de alguém.	Caminhe como se não puder controlar os movimentos de alguém.
acordo para o gerenciamento de ativos em nome de um beneficiário	Algo (como propriedade) mantido por uma parte (o administrador) para o benefício de outra (o beneficiário).
Faça a forma para um propósito específico	fornecer com (algo) geralmente para um propósito específico.
o ato de levantar algo	o ato de enrolamento ou torcer.
causa para se mover, porque para ser movido	causa para inclinar -se para o lado.
uma indicação de algo, evidência	uma indicação de alguma atividade oculta.
o estado de estar ausente.	o estado de ser suspeito.
(causa) quebrar ou deixar de funcionar	Pare de funcionar ou coerir como uma unidade.
a seleção de um vencedor da loteria	a última seção de uma comunicação.
estar em um estado ou condição protegida	estar em algum estado ou condição especificada.
o ato de escapar, fugindo	o ato de escapar fisicamente.
construir, fazer combinar materiais ou peças	Faça combinar materiais e peças.
Crie um revestimento para algo.	faça uma performance (de alguma coisa).
Crie um revestimento para algo.	o ato de se projetar de alguma coisa.
restringir ou limitar o intervalo de	Limite o intervalo ou extensão de.
o ato de irritar alguém ou algo	o ato de deixar algo.
o ato de reconhecer a verdade de algo	o ato de perceber o odor de algo.
o ato de incentivar alguém	o ato de contratar algo ou alguém.
um argumento que dá motivos ou justificativa para uma posição	A justificativa para algum ato ou crença.
Apresentação de um tema musical	(música) A apresentação de um tema musical.
causar ou permitir cair no chão	Deixe ou causar cair em gotas.
mover ou influenciar de maneira sinuosa	mover -se ou fazer se mover em um curso sinuoso, espiral ou circular.
vender ou transportar um item ou ideia para o exterior	causa para se espalhar em outra parte do mundo.
o ato de levar uma oferta	o ato de fazer uma proposta.
um grupo de pessoas nomeadas para um comitê	um comitê nomeado para julgar uma competição.
intuições, um palpite ou sentimento	manter (uma teoria, pensamentos ou sentimentos).
situar, posicionar, venha descansar	estabelecer -se em uma posição, geralmente em uma superfície ou solo.
separe ou remova beliscando ou brigando; tendem cortando.	Reduza ou remova beliscando ou rolando.
o ato de levantar algo	o ato de danificar algo ou alguém.
colocar limites; formar o limite ou ser contíguo a.	formar o limite de; ser contíguo a.
o valor da conversão de uma moeda para outra moeda	a cobrança de trocar moeda de um país por moeda de outro.
o arco graduado de um instrumento usado para medir os ângulos	O arco graduado que é anexado a um instrumento para medir ângulos.
o ato de levantar algo	o ato de testar algo.
o ato de escapar, fugindo	o ato de reter algo.
pessoas que estão empobrecidas, sem posses básicas	Duas pessoas que são casadas umas com as outras.
O ato de preparar uma preparação em algo.	Dê certas propriedades a algo.
o ato de explicar ou defender algo	a atividade de fornecer ou fornecer algo.
o ato de levantar algo	o ato de levantar algo.
confinar ou como se estivesse em uma prisão	incluir em ou como se estivesse em um quadro.
Faça uma cópia com a intenção de enganar.	Faça de conta com a intenção de enganar.
o ato de classificar as coisas em categorias	O ato de distribuir coisas em classes ou categorias do mesmo tipo.
voar para dentro ou em um plano de planador	voe para dentro ou como se estivesse em um plano de planador.
o ato de escolher ou selecionar	o ato de testar algo.
Aberto a membros de todas as raças e grupos étnicos	aberto (um local) para membros de todas as raças e grupos étnicos.
Vá depois com a intenção de seguir ou pegar.	Vá depois com a intenção de pegar.
a região central de um objeto	o centro de um objeto.
uma quantidade aproximada de algo	uma avaliação do valor de algo.
cubra completamente; formar uma cobertura; expandir.	formar uma tampa semelhante a um tapete (acima).
sala onde trabalho ou reparos são feitos	quarto onde o trabalho é feito.
o ato de afastar algo	o ato de testar algo.
Tome posse de autoridade legal (por segurança).	Tome posse temporária de segurança, por autoridade legal.
entregar ou colocar	Consulte o julgamento ou consideração.
causa para passar de um curso ou usar para outro	Envie de uma pessoa ou lugar para outra.
o ato de puxar uma carga	o ato de morar em um lugar.
o ato de irritar alguém ou algo	o ato de se projetar de alguma coisa.
O ato de falar sobre as características de algo.	o ato de se projetar de alguma coisa.
Vire de uma posição vertical / normal	causa para cair de uma posição vertical ou normal.
o ato de levantar algo	o ato de deixar algo.
a identificação ou a realização de algo	o fim ou a conclusão de algo.
o ato de ocultar ou disfarçar	o ato de se projetar de alguma coisa.
um documento que concede um direito ou privilégio, quanto a um inventor.	um documento que concedeu um inventor exclusivo direitos a uma invenção.
a área central de um objeto	o centro de um objeto.
o ato de levantar algo	o ato de colidir com algo.
o ato de levantar algo	o ato de diminuir ou reduzir algo.
O ato de preparar uma preparação em algo.	o ato de parar de algo.
o ato de defender ou promover algo	o ato de rasgar, rasgar ou dividir alguma coisa.
Tenha um sabor distinto ou característico, perceptível por um experimentador.	tem um sabor distinto ou característico.
ser um sinal ou indicação de; tem como significado.	ser um sinal ou indicação de.
a impressão geral ou aparência de algo	A aparência geral externa de algo.
saber, perceber e compreender o significado	conhecer e compreender a natureza ou o significado de.
Faça ou crie algo para uma função específica.	Faça algo, geralmente para uma função específica.
Livre -se como se com água (metafórica)	Livre -se como se estivesse submerso.
o ato de reconhecer a verdade de algo	o ato de escolher ou selecionar.
Mudar ou conforme se encaixar em condições novas ou diferentes	adaptar ou se conformar a condições novas ou diferentes.
o ato de incentivar alguém	o ato de incomodar ou irritante alguém.
um relógio com uma tampa articulada para proteger o rosto	Um relógio com uma tampa de metal articulada para proteger o cristal.
apoiar, sustentar, suportar ou ser responsável por	organizar ou ser responsável por.
lute contra outro ou outros para atingir um objetivo	competir por alguma coisa; se envolver em um concurso; medir -se contra os outros.
o ato de testar algo.	o ato de quebrar algo.
Reúna ou remova (de um local) para uso.	Retire de uma posição ou escritório.
o ato de direcionar a atenção, recursos para algo	o ato de colidir com algo.
andar nos ombros ou de volta de alguém; suporte nas costas ou ombros.	andar nos ombros ou de volta de alguém.
o ato de combinar, misturar, integrar	o ato de se misturar.
um objeto 3D sólido com lados retangulares	um pedaço sólido de algo (geralmente com lados retangulares planos).
a tradução de uma obra de um idioma para outro	O ato de se mudar de um lugar para outro.
o ato de irritar alguém ou algo	o ato de admitir alguém para entrar.
Escreva de maneira diferente ou altere uma peça ou escrita, talvez para se adequar a um propósito diferente.	Reescreva para se adequar a se adequar a um objetivo novo ou diferente.
uma celebridade ou artista que atrai um grande público	um artista que atrai grandes públicos.
descarte algo como inútil e velho; destruir fisicamente.	descarte (algo inútil ou antigo).
o estado de estar ausente.	o estado de ser excomungado.
subir à superfície; Torne -se visível ou conhecido	aparecer ou se tornar visível; faça uma exibição.
superar com surpresa ou descrença	correto por punição ou disciplina.
diminuir em força ou efeito, restringir, enfraquecer	diminuir em força ou efeito.
o ato de omitir intencionalmente algo	o ato de escalar algo.
o ato de defender ou promover algo	o ato de afirmar, afirmar ou declarar alguma coisa.
Uma lista de itens a serem consultados e marcados	uma lista de itens (nomes ou tarefas etc.) Para serem verificados ou consultados.
o ato de testar algo.	o ato de parar de algo.
o ato de danificar algo, causando quebra	o ato de danificar algo ou alguém.
Coloque em um determinado local ou local abstrato	Coloque em um determinado local ou localização abstrata.
o ato de perceber um perfume	o ato de perceber o odor de algo.
o ato de prestar assistência, dando ajuda	o ato de administrar medicamentos.
diminuir em vigor, impacto ou efeito	diminuir em força ou efeito.
cubra com tábuas de madeira; seguro	embarque em (trens, ônibus, navios, aeronaves, etc.).
o ato de explicar ou defender algo	o ato de remover ou se livrar de algo.
uma tampa ou topo de um recipiente	cobrindo um orifício (especialmente um orifício na parte superior de um recipiente).
(causa) separar ou mover em direções diferentes	causar separar e seguir direções diferentes.
causa para vibrar em um padrão diferente	causa para vibrar em um padrão definido.
o ato de dividir ou desconectar.	o ato de adicionar uma coisa a outra.
decidir ou consertar definitivamente / especificar	decidir ou consertar definitivamente.
fornecer um assento ou base para	Forneça um banquete ou banquete para.
o ato de explicar ou defender algo	o ato de rasgar, rasgar ou dividir alguma coisa.
um observador de um processo ou atividade	uma reunião dedicada a uma atividade específica.
deixar afastado; dar (nova) vida ou energia para	Dê uma nova vida ou energia a.