Existem vários eventos possíveis diferentes que podem acontecer no futuro. Na maioria dos casos, há um agente envolvido que deve considerar qual dos eventos possíveis ocorrerá ou deve ocorrer. Uma entidade saliente _ que está profundamente envolvida no evento também pode ser mencionada.	fazer como alguém agrada ou escolhe;
Esse quadro contians lus, como os do quadro de conveniência, exceto o avaliado incorpora o parâmetro "associado a um local percurado em uma herança social" para todas as lus. Os LUS não se restringem a implicações positivas ou negativas.	sendo ou característico ou apropriado à linguagem cotidiana;
Um destinatário começa sem o tema em sua posse e depois o possui. Embora a fonte da qual o tema veio seja logicamente necessário, o destinatário e sua mudança de relacionamento com o tema são perfilados.	Ganhe algo através dos esforços de um;
Esse quadro diz respeito a um subconjunto específico de instâncias de um tipo que são avaliadas em termos de sua semelhança com um protótipo conceitual do tipo. O julgamento da exemplaridade pode ser feito ao longo de um determinado domínio.	um exemplo padrão ou típico;
Esse quadro contém palavras que descrevem a posição estática de um item em uma escala em relação a alguma variável de propriedade.	falta de recursos, qualidades ou substâncias específicas;
Esses quadros descrevem um observador que não consegue acompanhar um tema. O foco desse quadro é o observador, que aparece na posição do sujeito. Esse quadro contrasta com a perspectiva oposta ao perder _ faixa _ de _ Perceptor, onde o observador é o objeto e o tema é o assunto.	local (algo) onde não se pode encontrá -lo novamente;
Uma pessoa se afasta de sua atividade de rotina (como trabalho ou escola) por um período de tempo. A duração pode ter um período de tempo, desde que a ausência seja temporária.	Falha em estar presente
Um gatilho provoca uma resposta. A resposta pode ser algum tipo de ação destinada a abordar o evento de gatilho ou um julgamento expresso do evento de gatilho.	encontre -se por design; estar presente na chegada de;
Um texto é uma entidade que contém informações linguísticas e simbólicas sobre um tópico, criado por um autor no momento _ da criação. Pode ser uma entidade física feita de um determinado material etc. Pode ser construído para um homenageado.	Um relato da série de eventos que compõem a vida de uma pessoa
Um oferta indica que ele ou ela é capaz e disposto a dar um tema a um potencial _ destinatário. Na ausência de mais qualificações, é frequentemente entendido que o potencial _ destinatário aceita o tema.	fornecer (geralmente, mas não necessariamente alimento);
Esse quadro abrange palavras que nomeiam os locais definidos politicamente ou administrativamente.	território sobre qual regra ou controle é exercido;
Um agente ativamente (mas nem sempre com sucesso) tenta impedir que um evento ocorra. Este evento é (geralmente) um desejo que incentiva a ação que o agente deseja impedir.	abster -se de fazer; sempre usado com um negativo;
Lus nesse quadro denota um cenário no qual um cliente organiza reter os serviços de uma organização posteriormente.	se envolver para uma performance;
As palavras nesse quadro descrevem um período de tempo, em oposição a um ponto no tempo.	o período durante o qual algo é funcional (como entre nascimento e morte);
Um agente tentou atingir uma meta, e o resultado real da ação do agente foi resolvido, para que ela corresponda especificamente à intenção do agente (por exemplo, sucesso) ou não corresponde a ele (por exemplo, falha).	tendo conseguido ou ser marcado por um resultado favorável;
Um Conclantor tem um julgamento de um avaliado, expressando o quão alta ou baixa é sua consideração pelo avaliação.	Venha acreditar com base em emoções, intuições ou motivos indefinidos;
Uma entidade controladora _ está sob controle consciente sobre uma entidade dependente _, situação dependente _ ou variável dependente _.	disciplina em atividades pessoais e sociais;
Este é o quadro primário evocado pelos números do Cardeal.	um conceito de quantidade envolvendo zero e unidades;
Esse quadro tem a ver com pessoas (os residentes) residentes em locais, às vezes com um co-residente.	habitar ou viver em; ser um habitante de;
Um orador percebe um sinal, geralmente linguístico, em alguma realização formal. A realização formal _ pode ser descrita como correta ou incorreta em uma expressão de julgamento, ou pode ser parcialmente indicada como parte _ de _ form. maneira pode ser usada como uma indicação mais geral da realização formal _	(fonética) Uma unidade de fala individual sem preocupação se é ou não um fonema de algum idioma
Uma entidade viva pretende uma ferramenta para poder cumprir um objetivo genérico. O material a partir do qual a ferramenta é criada pode ser algo natural ou algo feito pelo homem, incluindo outra ferramenta.	para que algo é usado;
Esse quadro descreve um sofredor que experimenta a perda de alguém através da morte. As lus nesse quadro implicam uma forte conexão emocional entre o sofredor e o falecido.	sofrer a perda de uma pessoa através da morte ou remoção;
Esse quadro contém substantivos (transparentes) que são unidades de medição para o tempo. Os elementos da estrutura são contagem, unidade e processo. Nesse quadro, não anotaremos os usos detíticos e calendários de substantivos como semana, mês etc. como em "Na próxima semana, este mês, no século XXI".	um período de tempo considerado como um recurso sob seu controle e suficiente para realizar algo;
Enquanto em movimento, um impacto torna o contato repentino e forçado com o impacto, ou dois impactadores se movem, fazendo contato mutuamente forçado.	acertar contra; entre em contato repentino com;
Um cliente solicita uma entidade de um fornecedor. O cliente pode pedir a entidade ou através de um meio.	um pedido de que algo seja feito, fornecido ou servido;
Esse quadro diz respeito às pessoas em um estado mental alterado que é induzido por um intoxicante.	ligeiramente e agradavelmente intoxicado de álcool ou droga (especialmente maconha)
Nesse quadro, um grupo de indivíduos intencionalmente se reúne para formar um grupo. Como alternativa, uma parte gramaticamente mais proeminente _ 1 se reúne com uma parte _ 2, expressa como uma frase oblíqua. Se esse construto assimétrico for escolhido, o objetivo se relaciona apenas com a parte _ 1.	satisfazer uma condição ou restrição;
Esse quadro contém substantivos que denotam agregados de indivíduos. Os agregados podem ser descritos por uma property agregate.	um grupo de pessoas (geralmente temporárias) com um propósito comum;
Há uma quantidade graduada de luz em um local específico. Em alguns casos, a fonte da luz pode ser indicada em vez da localização. As lus negetivas nesse quadro podem ser usadas metaforicamente para descrever períodos de tempo que podem ser caracterizados como ruins ou carentes de consciência, como mostrado nos exemplos a seguir	desprovido de ou deficiente em luz ou brilho; sombreado ou preto;
Um cliente solicita uma entidade de um fornecedor. O cliente pode pedir a entidade ou através de um meio.	um documento comercial usado para solicitar a alguém que forneça algo em troca de pagamento e fornecimento de especificações e quantidades;
Uma sequência registrada de eventos está associada a um determinado tópico.	o continuum de eventos que ocorrem em sucessão que levam do passado até o presente e até para o futuro;
Uma entidade está em um estado especificado. Quando não é especificado explicitamente, o Estado geralmente diz respeito à saúde da entidade, reparo do funcionamento. O estado também é frequentemente avaliado com uma avaliação e pode ser especificado para aplicar apenas a um parâmetro específico da entidade.	A maneira como algo é em relação aos seus principais atributos;
Esse quadro contém palavras que descrevem o quão potente é um produto químico.	ter um forte efeito fisiológico ou químico;
Esse quadro descreve grupos sociais humanos intencionalmente formados (aqui denominados organizações) com alguma estrutura e membros definidos. Eles podem ser relativamente informais, consistindo apenas em um grupo de indivíduos que estão cientes de quem é e que não é um membro, ou podem ser complexos e duradouros, como a Igreja Católica Romana ou o Partido Conservador.	um comitê com poderes de supervisão;
Esse quadro contém palavras que descrevem a posição estática de um item em uma escala em relação a alguma variável de propriedade.	maior que o normal em grau ou intensidade ou quantidade;
Um benfeitor confere uma situação benéfica para um beneficiário. Ao contrário do cenário do comércio, o destinatário não é necessariamente obrigado a pagar pelo bem ou serviço que recebe. Portanto, o elemento de benevolência é perfilado. Anotação de camada Fe dupla	assistência financeira em tempo de necessidade
Uma entidade é considerada digna de menção por sua capacidade ou influência entre algum tipo de entidades semelhantes. A entidade não precisa ser bem conhecida ou famosa, embora, se for, pode ser declarada apenas por seu nome. Seu valor pode ser restrito a um tempo ou lugar.	de grande significado ou importância;
Essas são palavras referentes ao controle por um líder sobre uma entidade específica (a governada) ou uma atividade. O quadro contém ambos os substantivos referentes a um título ou posição (por exemplo, diretor, rei, presidente) e verbos que descrevem a ação da liderança (por exemplo, regra, reinado). Com os verbos, é possível mencionar o papel desempenhado pelo líder (geralmente um nome de uma posição de liderança, por exemplo, rei)	exercer autoridade sobre; A partir das nações;
Um tema de objeto se move na direção de um objetivo. O objetivo pode ser expresso ou pode ser entendido a partir do contexto, mas está sempre implícito pelo próprio verbo.	consegue alcançar; chegar a;
Esse quadro contém palavras que descrevem um conjunto de indivíduos que possuem alguma semelhança, geralmente um atributo comum.	pertencente ou participado por uma comunidade como um todo; público;
Um funcionário tem uma posição trabalhando em um campo específico ou trabalhando em uma tarefa específica, para a qual um empregador dá uma compensação ao funcionário.	a ocupação pela qual você é pago;
Uma instância atual de um determinado tipo está em discussão. Esta instância é avaliada como sendo a mesma instância ou uma instância diferente de uma instância anterior encontrada em um contexto anterior.	Ao contrário da natureza ou qualidade, forma ou grau;
Esse quadro contém palavras que denotam as relações de parentesco. Ao anotar os usos direcionais dessas palavras, usamos os termos padrão da antropologia, ego e alter. Matilde é o primo de Gilberto uma vez removido	uma unidade social vivendo juntos;
A entidade interage com o tema com o efeito da mudança do tema.	(fisiologia) regulação ou manutenção de uma função ou ação ou reflexo etc;
Um tema atravessa uma trajetória. Essa trajetória consiste em uma fonte, caminho e objetivo. Se o tema for senciente, a trajetória prevista geralmente será equivalente à trajetória planejada. Se o tema não for mensagens, a trajetória antecipada geralmente será o resultado de várias forças agindo sobre o tema.	uma linha que leva a um lugar ou ponto;
Esse quadro contém verbos e substantivos que comunicam o ato de um orador para abordar uma mensagem a algum destinatário usando o idioma. Várias palavras podem ser usadas de forma performativa, como declarar e insistir.	Faça uma proposta, declare um plano para alguma coisa;
Uma entidade muda de um estado anterior para um estado de postagem em uma sequência que leva à melhoria.	um processo em que algo passa por um estágio diferente (especialmente um estágio mais avançado ou maduro);
Um experimentador atualiza um certo padrão de comportamento, um estilo de vida, que persiste por um período significativo de tempo na vida do Experente e é reconhecido como parte de seu caráter ou rotina normal. O estilo de vida não é necessariamente realizado intencionalmente e pode ser apenas o resultado da circunstância.	levar um certo tipo de vida; viver em um certo estilo;
Uma certa idiossincrasia pertence a uma entidade que a distingue de outras entidades.	único ou específico para uma pessoa ou coisa ou categoria;
Esse quadro descreve uma instância específica de um evento.	uma instância ou única ocasião para algum evento;
Uma entidade tem uma temperatura caracterizada pelo alvo. A temperatura é um valor do atributo de temperatura. Observe que, nesse quadro, a entidade não experimenta a temperatura, mas é apenas descrita como estando em um determinado estado verificável externamente. não está em quadro, mas em temperatura subjetiva _	ter ou produzir um grau de calor confortável e agradável ou transmitir ou manter calor;
Esse quadro contém substantivos que denotam agregados de indivíduos. Os agregados podem ser descritos por uma property agregate.	uma coleção de coisas compartilhando um atributo comum;
Um agente ocupa um papel em alguma instituição. Esse papel é (geralmente) temporário e pode ser ocupado por outras entidades em diferentes períodos de tempo. É comum a duração do papel a ser mencionado.	fazer dever ou manter escritórios; servir em uma função específica;
Uma figura está localizada em relação a um local de solo. A localização da figura pode ser mais especificada por sua distância de um local de referência (geralmente, o centro detictic) e a direção em que a figura está de um local de referência (geralmente, o centro detictic).	ser adjacente ou se junte;
Este quadros descreve um evento social em que pode ou não haver um relacionamento permanente ou semi-permanente entre os participantes. Além disso, os participantes desse quadro são expressos em um representante FE, participantes. Observe a diferença entre esse quadro e os indivíduos _ _ _, onde os participantes são gramaticalmente separados.	um participante de uma data;
Esse quadro contém itens que, quando manipulados, alteram a função de algum dispositivo, interno ou externo.	um mecanismo que controla a operação de uma máquina;
Esse quadro descreve uma situação geral na qual um proprietário aumenta ou diminui sua quantidade de posse. O aumento ou diminuição pode ser físico ou metafórico.	não manter ou manter; deixar de ter, fisicamente ou em sentido abstrato;
Uma entidade é integrada a um veículo como parte de um todo (possivelmente não pressionado), que pode se referir a todo o veículo ou apenas a uma subparte do veículo.	uma abertura transparente em um veículo que permita a visão nas laterais ou nas costas; geralmente é capaz de ser aberto
Esse quadro contém palavras que descrevem aspectos específicos de uma cor. o grau em que a cor discutida se desvia do protótipo pode ser marcada. A descrição também pode atingir um aspecto específico da cor.	(usado de cor) com um tom escuro;
um registro que contém uma conta permanente de dados. Esse registro pode ser mantido por um gravador para uma certa entidade.	um registro em que as contas comerciais são registradas;
Esse quadro abrange palavras para o corpo _ Partes (S) (BP) pertencentes a um (POSS), que pode ser caracterizado por um descritor (DEC). A localização da BP pode ser identificada em termos de anexo ou localização de orientação _. Uma sub -região de uma BP também pode ser indicada.	a frente da cabeça humana da testa ao queixo e orelha a orelha;
Um agente executa uma ação de resposta em conseqüência de um evento de gatilho. Em muitos casos, uma entidade que responde não agiva causa a resposta após a ocorrência do gatilho.	lutar contra um oponente em um esporte, jogo ou batalha;
Um protagonista está no estado dinâmico e mantido de estar vivo ou saiu desse estado.	a condição de viver ou o estado de estar vivo;
Um agente age para ser a força mais forte, ou fator causal mais importante em alguma situação, com exclusão de outros atores concorrentes.	ser maior em número, quantidade, potência, status ou importância;
Uma entidade ajuda na conclusão bem -sucedida de um propósito. Seu grau de utilidade também pode ser expresso. Algumas das unidades lexicais nesse quadro (por exemplo, ótimas, boas) podem expressar apenas estados permanentes e genéricos da entidade.	de boa qualidade e condição; solidamente construído;
Um agente faz com que um impactor faça contato repentino e forçado com um impacto ou manipula dois (ou mais) impactadores, para que eles façam contato forçado mútuo.	Dirija algo violentamente em um local;
Um experimentador sente diferentes graus de calor que podem ou não estar relacionados à temperatura ambiente. O nível de calor é geralmente comparado com o padrão subjetivo de conforto do Experience.	ter ou produzir um grau de calor confortável e agradável ou transmitir ou manter calor;
Um protagonista está no estado dinâmico e mantido de estar vivo ou saiu desse estado.	Tenha vida, esteja vivo;
Um prisioneiro é punido por cometer um crime por ser confinado a uma prisão por um período especificado.	passar um tempo na prisão ou em um campo de trabalho;
Nesse quadro, um alto -falante pede a um destinatário algo ou para executar alguma ação.	Dê instruções ou direcione alguém a fazer algo com autoridade;
A temperatura em um determinado ambiente, determinada por tempo e local, é especificada.	ter ou produzir um grau de calor confortável e agradável ou transmitir ou manter calor;
Um estado _ de assuntos é avaliado como bom (ou ruim), contra uma suposição de fundo de que anteriormente, o estado _ de assuntos era improvável que ocorra. O estado _ de _ assuntos mantém para um protagonista específico.	merecedor ou incitando pena;
Um agente faz uso de um meio (uma ação ou um (sistema de) entidades que se destacam na ação) para alcançar um objetivo. (Esse quadro pode ser ampliado para incluir ações intermediárias não agentadas.)	Como um resultado é obtido ou um fim é alcançado;
Um desenvolvedor desenvolve um produto, em alguns casos para uma empresa.	ato de melhorar expandindo ou ampliando ou refinando;
Um texto é uma entidade que contém informações linguísticas e simbólicas sobre um tópico, criado por um autor no momento _ da criação. Pode ser uma entidade física feita de um determinado material etc. Pode ser construído para um homenageado.	um registro ou descrição narrativa de eventos anteriores;
Uma variável de influência _, uma situação de influência _ ou uma entidade influenciadora _ influencia uma entidade dependente, variável dependente _ ou uma situação dependente. Compare com a influência subjetiva. Palavras no objetivo _ A influência são usadas para fazer reivindicações sobre correlações no mundo, onde as palavras na influência subjetiva são usadas para explicar os impactos emocionais causados ​​aos cockizers.	o efeito de uma coisa (ou pessoa) em outra;
Uma entidade é capaz de exercer uma força da magnitude especificada pelo alvo.	tendo pouco impacto;
Esse quadro está preocupado com substantivos transparentes que denotam um pedaço de substância. Também está presente a peça _ Prop, que é uma propriedade da peça, por exemplo relacionado ao seu tamanho.	Um circuito impresso que pode ser inserido em slots de expansão em um computador para aumentar os recursos do computador
Um orador aborda um público em um tópico específico. O público é geralmente passivo, embora, para muitos tipos de endereço (incluindo palestras acadêmicas e coletivas de imprensa), uma discussão ou período de perguntas e respostas seja praticamente sempre necessária.	narrar ou dar um relato detalhado de;
as palavras nesse quadro detalham um momento específico.	o dia especificado do mês;
Esse quadro está preocupado com os substantivos que denotam uma parte ou parte de uma entidade inteira. A peça não é definida em relação à orientação, centro ou borda do todo e não é ordenada. Também anotamos as propriedades da peça, p. relacionado ao seu tamanho.	(música) A seção de uma composição ou movimento (especialmente na forma sonata) onde os principais temas musicais são desenvolvidos e elaborados
Uma entidade é projetada para ou existe para desempenhar uma atividade ou cumprir uma função.	servir a um propósito, função ou função;
um local definido por um proprietário.	a terra em que imóveis está localizada;
Uma lei regula atividades ou estados de coisas dentro de uma jurisdição, ditando o que os Estados necessários devem ser o caso e o que os estados proibidos não deveriam. Freqüentemente, também indica consequências negativas para os indivíduos que o violam, e essas consequências negativas são geralmente aplicadas por alguma autoridade oficial. Eles podem ou não ser criados por algum órgão legislativo oficial.	um corpo de regras seguido de uma assembléia
As autoridades colocaram um prisioneiro na prisão como punição por uma ofensa.	O período de tempo em que um prisioneiro é preso;
Condições ambientais de temperatura, precipitação, vento e sol pertencem em um determinado local e horário. Especificações adicionais das condições que pertencem também podem ser indicadas.	livre de nuvens ou chuva;
Um indivíduo ou grupo (praticante) ou parte de sua vida profissional (trabalho) é definido profissionalmente pela atividade em que normalmente se envolve. Alternativamente, a atividade pode ser indicada por uma entidade saliente convencionalmente associada a ela.	a disciplina que registra e interpreta eventos passados ​​envolvendo seres humanos;
Uma informação específica é avaliada quanto à sua precisão. O grau de correção também pode ser expresso. A fonte de informação também pode ser metonimicamente defendendo as informações.	consistente com o fato ou a realidade; não falso;
Esse quadro contém adjetivos e substantivos que descrevem a verdade ou sinceridade da comunicação. Essas palavras, análogas para que se comportem em palavras, podem se aplicar aos alto-falantes ou às mensagens que eles produzem. Eles podem ocorrer com o tópico expressando sobre cerca de ppps.	digno de ser dependente;
Esse quadro é para objetos, físicos ou não, que são usados ​​para conceder acesso a algum local ou função.	uma sequência de números ou letras que abre uma trava combinada;
Uma entidade tem a capacidade de conter um tema.	ser usado por; a partir de uma utilidade;
Esse quadro contém palavras que denotam as relações de parentesco. Ao anotar os usos direcionais dessas palavras, usamos os termos padrão da antropologia, ego e alter. Matilde é o primo de Gilberto uma vez removido	família baseada em ascendência masculina;
Dois indivíduos, o subordinado e o superior têm um relacionamento de modo que o subordinado geralmente segue ordens dadas pelo superior e tem os melhores interesses do superior em mente.	trabalhar ou ser um servo para;
Lus nesse quadro indicam um período de tempo em que uma ação habilitada se torna possível. A duração desse período pode ser exata e inexata. Um agente que executa a ação habilitado também pode ser mencionado.	o período que é considerado melhor para iniciar ou terminar algo;
Esse quadro se preocupa com palavras que descrevem uma pessoa com base em uma parte saliente de seu corpo.	(usado de cabelo ou pele) pálido ou de cor clara; ;
in this frame , there is a part of a whole in which the part is defined with respect to the canonical or inherent orientation of the whole. in cases where the target is an adjective , it has a special relationship with the noun that it modifies such that a phrase which is a syntactic argument of the noun is semantically available to fill the argument structure of the adjective , as in	the striking or working surface of an implement
Um evento acontece em um lugar e horário.	um evento recente que tem alguma relevância para a situação atual;
there is a certain physical distance within which some other entity can participate in an event ( typically perception or manipulation ) with the participant. alternatively , the event may be indicated metonymically by a instrument . [ note the connection with * distance , sufficiency , and capability. words in this frame can generally be paraphrased " close enough to be able to " . ]	a range of mental vision ;
in this frame a part is part of a larger whole comprised of parts that are ordered. the parts can be ordered temporally ( first to last and vice versa ) or vertically ( down to up and vice versa ) . the part can be modified by the part _ prop or the number of the part can be given by ordinality .	a major division of a long written composition ;
a competitor claims a prize as a result of the outcome of their participation in a competition .	be the winner in a contest or competition ; be victorious ;
Uma entidade é capaz de exercer uma força da magnitude especificada pelo alvo.	tendo força ou poder maior que a média ou esperado;
an artifact is deliberately made or modified by an intelligent entity to be put to a certain kind of use. various properties of the artifact may be specified , such as its creator , time _ of _ creation , name , type , and the material of which it is composed. the artifact may or may not be a physical entity .	a stout length of sawn timber ; made in a wide variety of sizes and used for many purposes
a helper benefits a benefited _ party by enabling the culmination of a goal that the benefited _ party has. a focal _ entity that is involved in reaching the goal may stand in for it .	give help or assistance ; be of service ;
a speaker realizes a sign , usually a linguistic one , in some formal _ realization. the formal _ realization may be described as correct or incorrect in a judgment expression , or it may be partially indicated as a part _ of _ form. manner may be used as a more general indication of the formal _ realization	speak , pronounce , or utter in a certain way ;
this frame covers words that name locations as defined politically , or administratively .	the territory occupied by a nation ;
the support , a phenomenon or fact , lends support to a claim or proposed course of action , the proposition , where the domain _ of _ relevance may also be expressed. some of the words in this frame ( e.g. argue ) are communication words used in a non-communicative , epistemic sense .	establish the validity of something , as by an example , explanation or experiment ;
the authorities put a prisoner in prison as punishment for an offense .	a prison term lasting as long as the prisoner lives ;
an agent manipulates an instrument in order to achieve a purpose .	put into service ; make work or employ for a particular purpose or for its inherent or natural purpose ;
this frame concerns a cognizer 's certainty about the correctness of beliefs or expectations. it only includes uses where a cognizer is expressed .	be aware of the truth of something ; have a belief or faith in something ; regard as true beyond any doubt ;
the words in this frame describe situations in which an agent or a cause injures a victim. the body _ part of the victim which is most directly affected may also be mentioned in the place of the victim. in such cases , the victim is often indicated as a genitive modifier of the body _ part , in which case the victim fe is indicated on a second fe layer .	deliver a sharp blow , as with the hand , fist , or weapon ;
a useful _ location is accessible to some ( possibly generic ) theme despite a potential barrier , or is not accessible because of the barrier .	having skin rich in melanin pigments ;
in a text , a source _ of _ information is given that provides a reader of the text with further information relevant to the text. in this frame the author and reader are completely deprofiled , with the source _ of _ information made salient .	seek information from ;
a speaker interprets a written text and speaks the contents , usually to an addressee. the contents may be the text verbatim or a representation of the text .	look at , interpret , and say out loud something that is written or printed ;
words in this frame have to do with a cognizer being aware ( or not being aware ) of the difference between two phenomena , which may be expressed jointly or disjointly .	be able to distinguish , recognize as being different ;
the support , a phenomenon or fact , lends support to a claim or proposed course of action , the proposition , where the domain _ of _ relevance may also be expressed. some of the words in this frame ( e.g. argue ) are communication words used in a non-communicative , epistemic sense .	imply as a possibility ;
this frame describes intentionally formed human social groups ( here termed organizations ) with some definite structure and members. they may be relatively informal , consisting only of a group of individuals who are aware of who is and who is not a fellow member , or they may be complex and long-lasting , such as the roman catholic church or the conservative party .	a formal association of people with similar interests ;
in this frame an evaluee is described by a ( usually implicit ) judge with respect to the morality or rightness of his or her behavior .	stemming from evil characteristics or forces ; wicked or dishonorable ; -thomas hardy
an author creates a text , either written , such as a letter , or spoken , such as a speech , that contains meaningful linguistic tokens , and may have a particular addressee in mind. the text may include information about its topic , although the latter is not an fe in this frame .	recite or repeat a fixed text ;
a controlling _ entity , controlling _ situation , or controlling _ variable control a dependent _ entity , dependent _ situation , or dependent _ variable. the latter , dependent , element or some aspect of it is not just influenced , but determined by the controlling element .	power to direct or determine ;
this frame describes a situation in which an owner loses his or her possession. the owner may have failed to keep ownership of their possession ( i.e. robbery or gambling ) or may have unintentionally misplaced their possession .	fail to keep or to maintain ; cease to have , either physically or in an abstract sense ;
these adjectives describe the degree of strictness or tolerance of an agent , usually with regard to another person ( the controllee ) and often with regard to a particular issue. the strictness / lenience with respect to the issue may be manifested in ( expressed by ) an agent or by some medium ( e.g. , laws ) , or by some behavior of the agent , i.e. , the controlling _ act .	unsparing and uncompromising in discipline or judgment ;
some stimulus causes a cognizer to think of a prior phenomenon due to its perceived similarity .	suggest the necessity of an intervention ; in medicine ;
an artifact is deliberately made or modified by an intelligent entity to be put to a certain kind of use. various properties of the artifact may be specified , such as its creator , time _ of _ creation , name , type , and the material of which it is composed. the artifact may or may not be a physical entity .	a flat portable surface ( usually rectangular ) designed for board games ;
authorities charge a suspect , who is under suspicion of having committed a crime ( the charges ) , and take him / her into custody.the police arrested harry on charges of manslaughter .	record a charge in a police register ;
the reader attends to a text to process its information. sometimes a particular kind of phenomenon is sought in the text .	interpret something that is written or printed ;
this frame contains nouns denoting a rank or level within an established hierarchy .	( usually plural ) the status or rank or office of a christian clergyman in an ecclesiastical hierarchy ;
a text is an entity that contains linguistic , symbolic information on a topic , created by an author at the time _ of _ creation. it may be a physical entity that is made of a certain material etc. it may be constructed for an honoree .	a written work or composition that has been published ( printed on pages bound together ) ;
an insulator is judged for its potential to increase the body temperature of an experiencer. the activity that the experiencer engages in to experience the heat and the circumstances in which the insulator is judged may also be provided .	having or producing a comfortable and agreeable degree of heat or imparting or maintaining heat ;
an entity exists at a particular location , at a particular time , as observed by an implicit observer. a depictive and / or duration phrase is often found. this frame differs from existence in that the location is profiled as a ground where an observer is conceived of as confirming the entity 's existence. in some cases , the location may be recoverable from phrases that primarily express peripheral information	the state of being absent ;
an entity undergoes some change ( the event ) that is ( or is construed as ) punctual . ( this frame exists mainly to allow common fes to be inherited . )	affect or afflict suddenly , usually adversely ;
the locale is a geographical location as defined by shape. this frame includes natural geographic features , including land / ice forms and bodies of water .	a narrow channel of the sea joining two larger bodies of water
an entity is judged to be sensually pleasing or intellectually interesting to a ( generally implicit ) judge .	very pleasing to the eye ;
the words in this frame describe a period of time , as opposed to a point in time .	an indefinite period ( usually marked by specific attributes or activities ) ;
an agent or entity becomes sufficient enough to meet a standard. alternatively , an action or occurrence can be thought of as event that fulfills a standard. in this frame , the agent , entity , or event can be conceptualized as being on a scale where a change of value or circumstances brings it in line with the position of the standard on the scale .	fill or meet a want or need
an entity stands out perceptually in comparison to other members of its type .	characterized by an absence or near absence of agitation or activity ;
the answer to one open question , the outcome , is dictated ( partially or completely ) by the answer to another open question , the determinant , i.e. if the answer to the determinant is known , the answer to the outcome can be predicted. the degree of predictive power and the circumstances under which the dependency holds can also be expressed .	a relation such that one thing is dependent on another ;
this frame describes the attributes of a thermodynamic phase of matter .	( chemistry ) the three traditional states of matter are solids ( fixed shape and volume ) and liquids ( fixed volume and shaped by the container ) and gases ( filling the container ) ;
these words describe the size of message that a speaker is judged by a ( usually unexpressed ) judge to give , either in a specific occasion or topic or in general. as in other communication frames , medium may also be expressed .	free of noise or uproar ; or making little if any sound ;
an entity is presented as having been seen or experienced by a ( typically generic and backgrounded ) cognizer on a certain number of occasions , causing the entity to have a certain degree of recognizability for the cognizer .	be familiar or acquainted with a person or an object ;
words in this frame describe the status of an action with respect to a code of laws or rules. an object may also be in violation or compliance of the code by virtue of its existence , location or possession .	( of a baseball ) hit between the foul lines ;
these words refer to parts merging to form a whole . ( the parts may also be encoded as part _ 1 and part _ 2 . ) there is a symmetrical relationship between the components that undergo the process , and afterwards the parts are consumed and are no longer distinct entities that are easily discernable or separable in the whole .	a collection of things that have been combined ; an assemblage of separate parts or qualities
a man-made artifact , digital or physical , which is used to display information presented via the object .	a vertical surface on which information can be displayed to public view
words in this frame have to do with a cognizer believing that some phenomenon will take place in the future. some words in the frame ( e.g. foresee.v ) indicate that the phenomenon is asserted also to be true , while others do not .	look forward to the probable occurrence of ;
a helper benefits a benefited _ party by enabling the culmination of a goal that the benefited _ party has. a focal _ entity that is involved in reaching the goal may stand in for it .	help to some food ; help with food or drink ;
an entity is integrated into a building as a part of a ( possibly unexpressed ) whole which may refer to the whole building or merely to a sub-part of the building .	a pane of glass in a window ;
the words in this frame refer to facial expressions and the possessors of those expressions .	the feelings expressed on a person 's face ;
geography as defined by its use .	a district that has been developed to serve some purpose ;
a phenomenon is portrayed with respect to the degree of likelihood that it will be perceived and known , given the ( usually implicit ) evidence , perceiver , and the circumstances in which it is considered. for several of the lus , such as visible , audible , etc . , the type of the evidence is fixed by the targets themselves being a perceptual experience .	be or become visible or noticeable ;
this frame concerns a specific subset of instances of a type which are evaluated in terms of their similarity to a conceptual prototype of the type. the judgment of exemplariness may be made along a certain domain .	devoted ( sometimes fanatically ) to a cause or concept or truth ;
an entity can bear a great outer force so as to resist destruction and damage .	immune to attack ; incapable of being tampered with ;
lus in this frame modify a gradable attribute and describe intensities at the extreme positions on a scale .	surpassing what is common or usual or expected ;
an authority with the power to make decisions hands down a finding over a question presented in a formal or informal case .	decide with authority ;
this frame covers words that name locations as defined politically , or administratively .	the territory occupied by one of the constituent administrative districts of a nation ;
a speaker characterizes the intensity of an attribute of an entity by a degree .	intensely or extremely bad or unpleasant in degree or quality ;
an agent expends effort towards achieving a goal. alternatively , a salient _ entity involved in the goal can be expressed in place of a goal expression .	activity directed toward making or doing something ;
this frame has to do with scientific taxonomy. the lexical units in this frame include the seven major classifications in which organisms are grouped based on common biological characteristics. these classifications are labeled rank in this frame. the members or subtype of the rank is often expressed with the use of the target-denoting noun .	( biology ) taxonomic group containing one or more families
this frame contains words referring to items of food .	a particular day specified as the time something happens ;
a person or institution is being described in terms of their wealthiness , in other words the amount of money in their possession .	having little money or few possessions ;
an experimenter conducts an experiment based on a hypothesis. this experiment contains a control _ group or controlled _ individual which is compared with a treatment _ group or treated _ individual in order to determine the result .	a standard against which other conditions can be compared in a scientific experiment ;
a speaker characterizes the intensity of an attribute of an entity by a degree .	not faint or feeble ;
this lus in this frame refer to biological entities labeled by the fe organism. an organism is described as something that can be alive , or have naturally occuring biological processes and functions , however the concept of life is often used metaphorically for non-organic entities which resemble or act as if they have organic life .	living things collectively ;
this frame contains nouns denoting aggregates of individuals. the aggregates may be described by an aggregateproperty .	a number of sheets ( ticket or stamps etc . ) bound together on one edge ;
this frame has to do with the repetition ( and especially the frequency of repetition ) of an event. many of the adjectives and adverbs in this frame are based on nouns in the calendric _ unit frame .	having no special distinction or quality ; widely known or commonly encountered ; average or ordinary or usual ;
this frame contains transparent nouns ( and some adjectives ) denoting quantities of a mass or of individuals. as opposed to aggregate words such as group , set , these quantity do not have a status as wholes on their own. initially , at least , we annotate both quantity of masses and of individuals in this frame , though we may split the frame along these lines later on .	not excessive or extreme ;
the size of an entity is assessed in terms of the degree by which it deviates from the norm. the size refers to the amount of three-dimensional space that is occupied by the entity .	relatively large in size or number or extent ; larger than others of its kind ;
an agent or cause makes a new _ member part of group. the group may be represented by an individual existing _ member if it implies the existence of a set of members .	make an addition ( to ) ; join or combine or unite with others ; increase the quality , quantity , size or scope of ;
lus in this frame denote that the instance of a type is contextually notable. this frame typically requires dual fe layer annotation ; see below .	separate and distinct from others of the same group or category ;
in this frame , which is a part of the trial sequence , a judge gives a finding with respect to the charges against the defendant in a particular case .	decide on and make a declaration about ;
this frame concerns entities conventionally being referred to by particular names .	a language unit by which a person or thing is known ;
the lexical units in this frame have to do with an entity being in a state of order or disorder. often the entity is unexpressed in this frame and is , therefore , marked as a null instantiation .	established customary state ( especially of society ) ;
the lexical units in this frame are descriptions of a cognizer 's attitude about or outlook on a state _ of _ affairs. the state _ of _ affairs can be expressed without a cognizer in many cases , as shown in the following	showing a brooding ill humor ;
a salient subevent has a pattern of recurrence within a larger process .	rhythm as given by division into parts of equal duration
a cognizer introduces a new _ idea into society .	make a discovery , make a new finding ;
an experiencer actualizes a certain pattern of behavior , a lifestyle , which persists for a significant period of time in the experiencer 's life and is recognized as part of his character or normal routine. the lifestyle is not necessarily realized intentionally , and may just be the result of circumstance .	a characteristic state or mode of living ;
a person has a particular mental state and the ability to engage in an activity with enthusiasm , energy , and positivity .	animation and energy in action or expression ;
this frame contains lus that express the form which a piece of artwork represents. the form may also represent the entire body of an artist 's work. the form may be further characterized by the time of some artwork 's creation or other descriptors .	( architecture ) one of original three styles of greek architecture distinguished by the type of column and entablature used or a style developed from the original three by the romans
geography as defined by its use .	a place where work is done ;
an entity meets the pre-conditions for participating in an event. a degree modifier may be included to indicate by how much the entity exceeds or falls short of the minimum requirements .	( usually followed by `to ' ) having the necessary means or skill or know-how or authority to do something ;
a person ( the cognizer ) comes to believe something ( the content ) , sometimes after a process of reasoning. this change in belief is usually initiated by a person or piece of evidence. occasionally words in this domain are accompanied by phrases expressing topic , i.e. that which the mental content is about .	establish after a calculation , investigation , experiment , survey , or study ;
this frame contains verbs and nouns that communicate the act of a speaker to address a message to some addressee using language. a number of the words can be used performatively , such as declare and insist .	state or say further ;
this frame is concerned with the likelihood of a hypothetical _ event occurring. the hypothetical _ event is its only core frame element. notice that in the case where a noun phrase is the subject of the support verb , that np is also tagged as hypothetical _ event .	involving substantial risk ;
in this frame an ingestor takes a substance into his or her body. the delivery _ device can appear as a direct object .	take or consume ( regularly or habitually ) ;
the hearer receives a message or communication on a particular topic. words in this frame denote events of verbal communication , but express the hearer rather than the speaker as an external argument .	to hear and understand ;
the locale is a geographical location as defined by shape. this frame includes natural geographic features , including land / ice forms and bodies of water .	material in the top layer of the surface of the earth in which plants can grow ( especially with reference to its quality or use ) ;
this frame has to do with scientific taxonomy. the lexical units in this frame include the seven major classifications in which organisms are grouped based on common biological characteristics. these classifications are labeled rank in this frame. the members or subtype of the rank is often expressed with the use of the target-denoting noun .	( biology ) a taxonomic group containing one or more genera ;
a perceiver determines the location of a sought _ entity within a ground .	come upon after searching ; find the location of something that was missed or lost ;
in this frame a speaker asks an addressee for something , or to carry out some action .	( often plural ) a command given by a superior ( e.g. , a military or law enforcement officer ) that must be obeyed ;
a piece of evidence indicates that an event occured , or metonymically , entity had formerly existed , in a location .	an indication that something has been present ;
a competition comes to an end , with a competitor tying , winning , or losing against an opponent ( or opponents ) according to their score . ( in the symmetrical situation of a tie , the competitor and opponent may be jointly mentioned as competitors . ) according to the score that the competitor and opponent have achieved , they may receive a rank or a prize. the margin may also be mentioned .	finish third or better in a horse or dog race ;