traficante Lorde capturado por fuzileiros navais no México	Suspeito traficante Lord conhecido como 'El Taliban' realizado no México
SC descarta o pedido de revisão de Govt no caso tributário da Vodafone	SC descarta a petição de revisão do Govt sobre o veredicto de imposto sobre a Vodafone
Explosão atinge o oleoduto no Homs da Síria	Explosão atinge o pipeline como Assad Ataca as cidades
soldado da OTAN morto no ataque afegão	soldado da OTAN morto em s. Afeganistão
Castro comemora o 86º aniversário de segunda -feira	Fidel Castro comemora o 86º aniversário
Israel ex-spy alerta contra a guerra 'messiânica' do Irã	Chefe israelense ex-esppinho: sem confiança na liderança sobre o Irã-vídeo
Opulsor dos olhos: as regras da Suprema Corte sobre a Lei de Imigração do Arizona	nós. Emissões da Suprema Corte dividir a decisão sobre a lei de imigração do Arizona
OTAN rastreia o caminho do Afeganistão	Líderes da OTAN se comprometem com a transição do Afeganistão
Síria diz que o bombardeiro suicídio mata 10 em Damasco	O 'bombardeio suicida' de Damasco mata 10
Sachin Tendulkar diz que eu não sou Deus, eu sou Sachin	Sachin Tendulkar pontua o primeiro século 100 do Cricket
A tempestade tropical segue para passar pela costa de Honduras	Avisões de tempestades tropicais para a costa sudeste
O primeiro -ministro australiano Gillard definido para ganhar um desafio de liderança	PM australiano desafiador sob pressão sobre a liderança
Obama apóia as Filipinas sobre o Mar da China Meridional	Obama diz regras claras necessárias para acalmar o Mar da China Meridional
Adolescente na China mata 8, feridas 5 em ataque de faca	Adolescente mata 8 em ataque de faca
Os rebeldes sírios movem o comando da Turquia para a Síria	O exército sírio gratuito se move a sede da Turquia para a Síria
Knesset Orador: Reeleção de Obama Bad para Israel	7 estados processarem a regra de controle de natalidade do governo Obama
Netanyahu definido para ligar para votação antecipada	Netanyahu, de Israel
BROCAMENTO DE TENHADA GRUECE A maior reestruturação da dívida na história	A Grécia assegura o maior acordo de dívida na história
Putin 'ganha eleição presidencial russa'	Pesquisas abertas nas eleições presidenciais russas
Bomber suicida mata 12 na Igreja da Nigéria	Bomber suicida mata 21 no Paquistão NW
O ministro das Finanças da Índia sai para concorrer à presidência	Julian Assange planeja concorrer ao Senado Australiano
Jerry Sandusky considerou culpado em julgamento por abuso sexual infantil	Sandusky considerou culpado em julgamento por abuso sexual infantil
Três tibetanos se autoimolarem no oeste da China: relatório	7 tibetanos se auto-imolam na China
Casa Branca em Controle de Dano sobre Obama observações da Suprema Corte	Verificação de fatos: observações da Suprema Corte de Obama
Annan alerta as conversas sobre os riscos da Síria	Putin, Annan se encontra na crise da Síria
O quarteto chama israelenses, palestinos para acabar com os irritantes	ocupação para confiscar 30 dunums de terra palestina em Deir Estia
sauditas para permitir que as mulheres competam nas Olimpíadas	Mulheres sauditas autorizadas a competir nas Olimpíadas
Missa da Universidade da Nigéria atacada por pistoleiros	Nigéria: Universidade bombardeada no norte
EUA dizem prontos para ajudar o ativista chinês cego	nós. Pronto para ajudar o ativista chinês: oficial
O gabinete da China promete aumentar a economia	Wen da China promete a criação de empregos
Annan, chefe da ONU, chama o Conselho de Segurança para agir na Síria	Rússia, China Veto ONU Resolução do Conselho de Segurança na Síria
Lanterna verde a ser reintroduzida como gay por DC Comics	Lanterna verde para ser relançado como super -herói gay
Crashos de avião militar no sul da França: autoridades	Plano militar cai no sudeste da Turquia, 1 morto
A tempestade tropical Isaac aumenta as reivindicações de desemprego	A tempestade tropical Joyce se forma, permanece no Atlântico aberto
Gazans disparam 2 foguetes em Israel; Sem ferimentos	2 Rockets de Gaza atingiram Israel; Sem ferimentos
Freddie Starr preso na sonda de abuso Savile	Terceiro homem preso em sonda de abuso sexual savile
Romney anuncia Paul Ryan como companheiro de chapa	Romney nomeia Ryan como companheiro de corrida
As ações aumentam cedo após o acordo grego e depois achatam	as ações aumentam após o acordo de dívida grega
SUICIDE BOMING ROCKS ELITE IEMEN CAMP	Bombeiros suicidas atacam postos militares do Iêmen
OTAN: 2 tropas internacionais mortas no Afeganistão	Três tropas da OTAN mortas em um dia no Afeganistão
Os manifestantes de Moscou exigem a renúncia de Vladimir Putin	Moscou protesto contra Vladimir Putin menor e mais silencioso
A explosão de caminhão a gás saudita mata pelo menos 22	A explosão da Igreja da Nigéria mata pelo menos 12
participação nas eleições francesas mais alto do que o esperado	Eleição presidencial francesa: Primeira rodada - atualizações ao vivo
Austrália para estabelecer a maior reserva marinha do mundo	Austrália cria as maiores reservas marinhas do mundo
dois EUA Soldados baleados, mortos por soldado afegão	Dois soldados britânicos mortos por policial afegão
Soldados da Itália morrem no Afeganistão	Dois soldados do Reino Unido mortos no Afeganistão
Abbas para liderar o governo da unidade palestina	Abbas propôs como PM no governo interino da unidade
A igreja copta do Egito nomeia o novo papa	A igreja copta do Egito se prepara para escolher o papa
Malawi confirma oficialmente a morte do presidente	Malawi confirma a morte do presidente Mutharika
Os rebeldes do Mali declaram independência	Os rebeldes do Mali declaram 'Azawad' independente
Lance Armstrong despojado de títulos Tour de France	Lance Armstrong Plots Strategy após perda de títulos
Egito votos no último dia de eleição presidencial	Pesquisas abertas na França para eleição presidencial
Berri diz pronto para ajudar a lançar o governo da unidade nacional	A percepção da Espanha mudou dramaticamente com este governo
Madeleine McCann ainda está vivo?	Reabrir o caso Madeleine, a polícia inside
13 mortos em ataques de bomba no Iraque	16 mortos nos ataques do Norte do Iraque
Os surfistas australianos encontram requerentes de asilo atingidos	Mayday: medos para requerentes de asilo
ISAF: 4 tropas da coalizão mortas em ataques envolvendo a polícia afegã	A OTAN diz que quatro tropas mortas no ataque "insider" em South Afghan
Coty lança uma oferta de US $ 10 bilhões para a rival Avon	Coty oferece US $ 10 bilhões para a Avon
Votação unânime do Conselho de Segurança da ONU na Síria	Conselho de Segurança da ONU para votar em até 300 monitores da Síria
Gunman mata 6 em tiro no templo de Wisconsin Sikh	Gunman mata seis em tiro no templo Sikh em Wisconsin
Audi para comprar o fabricante de motocicletas Ducati	Sonda no mercado de seguro automóvel
O furacão Isaac se move para o interior após o aterrissagem	Bateria do furacão Isaac nos EUA perto de Nova Orleans
Agência de notícias da China: ainda espero para a Paz da Síria	Agência de Notícias do Estado da China: ainda há esperança de paz na Síria
22 mortos em ataque suicida na Academia de Polícia do Iêmen	As forças da UA intensificam o ataque aos rebeldes somalis
Coréia do Sul ordena desligamento imediato de 2 reatores nucleares	Coréia do Sul para aumentar a energia nuclear?
Nigéria lamenta mais de 193 pessoas mortas em acidente de avião	Nigéria abre a investigação em um acidente aéreo mortal
EUA, aliados para estabelecer demandas por negociações nucleares do Irã	'O Irã não aceitará as pré-condições para as negociações nucleares'
AOL diz para vender 800 patentes para a Microsoft por US $ 1,0 bilhão	AOL para vender 800 patentes para a Microsoft por US $ 1 bilhão
milhares de tropas para marchar para o Jubileu	Milhares de votos de bloqueio para Amsterdã para o dia da rainha
Oriente Médio: Israel: Líder do Hamas condenado	Oriente Médio: Iraque: 17 prisioneiros escapam em Kirkuk
Jato da Marinha colide com o prédio de apartamentos	O jato da marinha dos EUA colide com o bloco de apartamentos
Mulher morre após a recusa do aborto	Mulher morre depois que Cliff cai em Dorset
Votos da Grécia nas eleições cruciais	A Grécia parece definida para a eleição repetida
nós. e a Turquia pesam zonas de exclusão para a Síria	nós. e Turquia aperta a coordenação na Síria
O número de mortos aumenta para 236 após as explosões de Brazzaville	Rep. do Congo: 236 mortos após as armas depot explosões
Eu tenho outro aposentado para estudar	Eu terei outra vitória Preakness
Os jornalistas de jornalistas da Síria falham	Jornalistas contrabandeados de Homs
Nova reivindicação de sexo atinge o Serviço Secreto	Novas regras para o Serviço Secreto dos EUA
O Irã avisa as negociações nucleares de Moscou	Os iranianos "confessam" a assassinatos de cientistas nucleares
Mohamed Morsi jurou como presidente eygptano	Mohamed Morsi jurou como presidente do Egito
Rimsha Masih libertada sob fiança	Mandela libertado do hospital
1 pessoa morta em confrontos sectários no Líbano	180 mortos no terremoto do Irã
Senhor de guerra congolês da ICC por 14 anos sobre crianças soldados	Senhor da guerra congolês condenado a 14 anos em caso de marco - vídeo
ganhos em ações financeiras pressionam as ações européias	Os cristãos britânicos levam as queixas ao Tribunal Europeu
A Turquia desperta alarme sobre os refugiados sírios	A Turquia procura realocar alguns refugiados sírios
1 pessoa morta em confrontos sectários no Líbano	Nove mortos em confrontos ligados à síria no Líbano
Suspeito financiador da Al-Qaeda preso na França	Três suspeitos da Al Qaeda presos na Espanha
Sem danos, tsunami após 6,6 Quake atinge a Sumatra da Indonésia	5.9 Quake atinge a Sumatra da Indonésia: USGS
IAF Strike Gaza Terror Hubs	A IAF ataca a célula terrorista de Gaza; 1 morto
Os ataques aéreos israelenses matam 16 em Gaza	Os ataques aéreos de Israel matam 4 em Gaza; Toll de morte agora aos 38
18 mortos, 108 feridos em onda de atentados no Iraque	9 mortos, 31 feridos em bombas de carro no Kirkuk do Iraque
Prisioneiro palestino terminando a greve de fome após o acordo	Israel para libertar atacante de fome palestina
O Hezbollah confirma que enviou um drone sobre Israel	O Hezbollah diz que enviou drone sobre Israel
Soldados sírios 'Capture' Capture 'Capture' rebeldes	O exército sírio livre captura oficiais sírios
O suspeito de tiro no Colorado estava sob os cuidados do psiquiatra	médico que tratava Aurora Shooting suspeito teve repreensão médica
6.6 Quake Rocks Indonésia Papua: USGS	6.6 Quake Rocks Indonésia Papua: US Geological Survey
Os senadores dos EUA penalizam o Paquistão por prender Doctor Who Ajudou a CIA	EUA diminuem o destino do médico do Paquistão
A que horas é Andy Murray / Roger Federer na final dos homens de Wimbledon? Tudo que você precisa saber sobre o grande jogo	A que horas é a cerimônia de abertura paraolímpica? Tudo o que você precisa saber sobre o grande Raiser
Bans da escola de Nova Jersey abraçando	Us Bans Bans Hugging
Irã (República Islâmica de): o Irã aumenta os esforços de alívio depois que os terremotos matam 227	O Irã aumenta os esforços de alívio depois que os terremotos matam 227
Aviso de tsunami emitido para o sul do Alasca	Aviso de tsunami após o terremoto do Canadá
'sem evidências' no caso do massacre do Afeganistão	US Toll no Afeganistão atinge 2.000
Apple rica em dinheiro para pagar dividendos, recompra ações	Apple para pagar US $ 2,65 / dividendo de compartilhamento, compre $ 10 bilhões de ações
7 soldados mortos, 56 feridos em ataque de PKK no leste da Turquia	3 mortos, 14 feridos em ataques no Iraque
Dois relatados mortos em tiro no Empire State Building em NY	2 mortos em tiro fora do Empire State Building
desemprego australiano até 5,1 %	A taxa de desemprego francesa sobe para 10 %
As ações se movem mais alto na Wall Street	Sandy se fortalece como perto da costa; Wall Street fechado
A renda do Halliburton 1Q aumenta 23 PCT	Os lucros do primeiro trimestre do Halliburton aumentam em fortes vendas da América do Norte
Enviado sírio para os defeitos de Chipre para o Catar	A Síria implanta mais tropas, apesar do acordo de paz
4 mortos em bombardeio de santuário no noroeste do Paquistão	12 mortos nos EUA Drone Strike no NW Paquistão
Estoques de China Fechar Misto na sexta -feira	Estoques da China abrem na sexta -feira inferior
A Índia proíbe textos em massa após tumultos	Tunísia levanta o toque de recolher após tumultos
Monitores da ONU ainda para chegar ao local do 'massacre' sírio - vídeo	Monitores da ONU disparados no caminho para o local do massacre sírio
Soldado de Yorkshire morto na explosão de bomba afegã	Soldado morto no Afeganistão explosão
Islâmicos radicais no Mali alistam novas milícias	A milícia local reforça militantes islâmicos no Mali
Cerimônia de abertura das Olimpíadas um sucesso em torno do globo	Cerimônia de abertura dá às Olimpíadas um começo de balanço
Aeroporto de Schiphol parcialmente evacuado após ameaça de bomba	Aeroporto de Schiphol evacuado devido à ameaça de bomba
Homem morto em ataque terrorista francês	O homem morre na 'operação antiterror' francesa
Pintura Dali roubada da Galeria	Pintura de Salvador Dali arrebatada da Galeria de Nova York
Capello sai como gerente da Inglaterra	Capello renuncia como gerente da Inglaterra
um morto no tiroteio na escola de Ohio	1 morto, 4 feridos em tiroteio na escola de Ohio
2 palestinos mortos em ataques aéreos israelenses	Quatro palestinos mortos na greve da IAF
Paquistão condena os EUA golpes de drone	O comboio do Paquistão se dirige para protestar contra greves de drones nos EUA
O enorme furacão Sandy Bears nos EUA Costa Leste	O furacão Sandy ganha velocidade, derrota a costa leste dos EUA
Sarkozy para registrar reclamação na reivindicação de financiamento de Gadhafi	Sarkozy para processar depois que a reclamação em dinheiro de Gaddafi explode em campanha
A nota deve ler para quarta -feira, 4 de julho de 2012	As leituras obrigatórias da nota para quarta-feira, 30 de maio de 2012
'Irã vai atacar Tel Aviv se Israel atacar'	Clérigo sênior: o Irã atacará Tel Aviv se Israel ataques
Annan pede que o final da violência da Síria, ministro defeitos	Annan pede que o final da violência síria
Gusmao consolida poder nas eleições de Timor Leste	Possibilidades da Suprema Corte se Romney vencer a eleição
Pena Nieto ganha voto presidencial do México: Pesquisas de saída	Enquete: Putin para ganhar o voto presidencial da Rússia
A Síria diz à Rússia que algumas tropas saíram de Homs	A Síria diz que as tropas começaram a ser retirada - vídeo
Crash para o avião da Nigéria: sem sobreviventes	4 chinês entre as vítimas de acidentes de avião da Nigéria
previsão de crescimento do Mier UPS 2012 para 4,2pc	CMIE corta previsão de crescimento de 2012-13 para 6,3 %
Explosão na Refinaria da Venezuela mata pelo menos 39	Venezuela lamenta mortes na refinaria de petróleo
Forte terremoto atinge o México	Forte um terremoto atingido perto de Acapulco
Rússia, China Veto ONU Resolução sobre assassinatos na Síria	Rússia, China em duplo veto da resolução da ONU Síria
O suspeito de tiro no Colorado estava em terapia	Advogados: Colo. Tirar suspeito está doente mental
Bomber Suicide mata 4 perto da sede afegã da OTAN	O bombardeiro suicida mata 23 no casamento afegão
O avião paquistanês cai com 127 a bordo	O avião paquistanês cai com 130 pessoas a bordo
On Security Council ordena sanções globais contra a rede Haqqani no Afeganistão	ONU ordena sanções globais contra a rede Haqqani
Erdogan e Putin conversaram com voz elevada	Militantes estrangeiros mortos na Somália em greve no carro
A Arábia Saudita prisões suspeitas de militantes com links da Al-Qaeda	A Arábia Saudita prisões suspeitas de militantes, relatórios de mídia estatal
O furacão Sandy se fecha na costa leste dos EUA	O furacão Sandy mira na costa leste dos EUA
Os professores de Chicago greve: férias para os alunos, para o bem ou doente	O professor de Chicago apresenta testes para sindicatos
Panetta diz que o papel do Afeganistão a mudar do combate em 2013	Panetta: Afeganistão Tops tópicos da Conferência da OTAN
Quatro homens admitem a Londres Bols Exchange Bomb Plot	Quatro homens admitem a Londres bombas
PM em Teerã, pede a Nam para tomar uma posição clara na Síria	Manmohan em Teerã, pede a Nam para se posicionar na Síria
Israel ameaça a ação contra o navio de ajuda de Gaza	Israel ataques na faixa de Gaza após fogueira
corpos encontrados no acidente de jato russo na Indonésia	12 corpos encontrados no acidente de jato russo na Indonésia
Os senadores podem voltar aos playoffs com a vitória	Messi marca 4 para enviar Guardiola com a vitória
Síria pede aos refugiados que retornem	A trégua tênue da Síria se apaixona
Soldado dos EUA mata até 16 civis no Afeganistão	Soldado dos EUA mata até 16 civis afegãos em uma onda de tiro
Rupert Murdoch: Eu fui vítima de um encobrimento	Rupert Murdoch pronto para o segundo dia de grelhar
Os guarda -costas de Barack Obama enviados de volta para nós após o escândalo de prostituição	Barclays Boss Falls para classificar o escândalo de fixação
O Yuan da China sobe para o novo alto contra o USD quarta -feira	O Yuan da China avança para 6.3103 contra o USD quarta -feira
Crash de trem da África do Sul mata pelo menos 19	Crash de trem da África do Sul mata 26
Nissan para vender carros de boi	Nissan para oferecer sistemas de direção por fio em alguns carros infiniti
O monge tibetano morre depois de incendiar -se em protesto contra o domínio chinês	O monge tibetano adolescente morre depois de se incendiar na China
Mumbai é a segunda cidade indiana mais cara para morar	Capital Tech Bangalore mais caro City Indian para morar: Pesquisa
Hom	O homem interrogou sobre o assassinato de Megan-Leigh
Israel mata o comandante do Hamas, Bombs Gaza Alvos	Os ataques aéreos de Israel matam o comandante do Hamas, 5 outros
Civis suportam o peso de ataques afegãos	Lançamento do Taliban coordenou ataques afegãos
Gusmao consolida poder nas eleições de Timor Leste	Gusmao Powers in East Timor
Monitores da ONU ainda para chegar ao local do 'massacre' sírio - vídeo	Monitores da ONU, incapazes de chegar ao local dos assassinatos da Síria
Rússia, China veto a resolução da Síria endossando	Rússia, China Veto ONU. Projeto de plano árabe de apoio para a Síria (Reuters)
A OTAN condena a derivação da Síria do jato militar turco	A OTAN condena fortemente a derivação da Síria do jato turco
Ativistas: tropas sírias Storm Damasco subúrbio	Ativista diz que o cidadão sírio cinemerado morto em Homs
Rebeldos da Síria atacam o posto libanês perto de fronteira: exército	Exercícios do exército turco Exercícios de tanque perto da fronteira da Síria
Cinco mortos na China colapso do edifício	Pelo menos 20 mortos na Síria no sábado
As forças sírias lançam novos ataques	Forças da Síria lançam ataque de Aleppo
Os sírios comem culpa por explosões	aparelhos de Israel para protestos árabes
Gazans disparam 2 foguetes em Israel; Sem ferimentos	Gazans disparam 89 foguetes; Gabinete aprova a chamada de reserva
ex -guarda da morte nazista Demjanjuk morto aos 91	John Demjanjuk, condenado Guarda de Campo de Morte nazistas, morre com 91 anos
Boris Johnson reeleito o prefeito de Londres	Johnson reeleiu o prefeito de Londres
Breivik diminui a saudação de extrema direita no tribunal	Breivik recebe sentença de 21 anos
Segundo adolescente acusado de assassinato	Irmão da atriz EastEnders Gemma McCluskie é acusada de seu assassinato
Francês temem o novo serial killer depois de assassinatos	Jersey assassinato julgamento: assassino 'audição de vozes'
EUA: Madoff irmão de se declarar culpado em NY em fraude	O irmão de Madoff para se declarar culpado de fraude
Hollande derrota Sarkozy na votação da presidência francesa	Pesquisas abertas em toda a França nas eleições presidenciais
O governo da Líbia retém o aeroporto de Trípoli	Milícia da Líbia assume o controle do aeroporto de Trípoli
Clinton adverte o Quênia sobre o custo da violência eleitoral	Clinton adverte o Quênia sobre o custo da agitação eleitoral
A Suprema Corte do Arkansas derruba a lei de execução	Os juízes do Arkansas diminuem a pena de morte
s. O ex -presidente da África, Mandela, foi descarregado do hospital	Mandela descarregou do hospital
ONU enviado na Turquia para negociações sobre a Síria	Nova Zelândia para aumentar as exportações para a China
Morsi islâmico ganha a eleição presidencial do Egito	Al-Shater para concorrer nas eleições presidenciais no Egito
Donna Summer, a rainha da disco	Donna Summer, rainha da discoteca, morre aos 63
Os muçulmanos de Bangladesh tocam santuários budistas, dizem a polícia	muçulmanos tocam templos budistas
nós. drone mata cinco militantes no Paquistão	Seis policiais mortos em ataques no Dagestão
Mali Future Interim Presidente prepara para assumir o cargo	Pope rasga os padres dissidentes no celibato
9 mortos, 168 feridos nos últimos confrontos do Cairo	10 mortos, 12 feridos em e. explosão de suicídio do aeroporto afegão
Teerã: as sanções da UE forçaram o Irã em negociações nucleares	Baixas expectativas para as negociações nucleares do Irã
Drownings de Portugal: Garota e avô do Reino Unido nomeados	Menina Britânica e Grandad se afogam em Portugal
Romney ganha caucuses republicanos do Maine	Romney, em retorno, tem uma vitória estreita do Maine Caucus
Tribunal em Bahrein rejeita os médicos do último recurso de manifestação	Bahrein rejeita o apelo dos ativistas
Hurricane Sandy Powers em direção à costa leste	O furacão Sandy se move em nossa direção
Clinton pede para os amigos da Síria se unirem	Artista plástico pede maior apoio a novos talentos
JK Rowling lança seu primeiro romance adulto	A Síria lança ataque de terra em Aleppo
Os partidos do governo da Argélia dominam as eleições	A participação nacional da Argélia da votação parlamentar atinge 44,38 PCT
Oficial de segurança morto no Iêmen	Pessoal de segurança morto no ataque do Paquistão
Os estoques dos EUA caem à medida que as negociações gregas falam; Apple Falls	As ações dos EUA escorregam em Wall Street enquanto as conversas gregas se arrastam
Romney escolhe Ryan como vice -presidencial companheiro: fonte	Romney para tocar em Ryan como vice -presidencial companheiro
A OTAN adere ao roteiro de transição no Afeganistão: Rasmussen	O helicóptero da OTAN faz pouso duro em e. Afeganistão
Mubarak enfrenta veredicto no julgamento de assassinato	Os filhos de Mubarak enfrentam novas acusações de negociação de informações privilegiadas
Sem blocos para investimento	A Índia permite o investimento do Paquistão
Blast mata 11 no noroeste do Paquistão	A bomba mata 19 no noroeste do Paquistão
5 trabalhadores humanitários libertados em operação no Afeganistão	Bomber suicida mata 37 na mesquita no Afeganistão
Dois soldados da Otan mortos no Afeganistão	Soldado da Otan morto na explosão afegã
Nadal cai na final do Aberto da França	Nadal até a sétima final do Aberto da França
Relatórios de TV russos frustraram a tentativa de Putin	Rússia, Ucrânia frustrou a trama para matar Putin, diz o relatório
Putin reivindica a vitória na eleição presidencial da Rússia	Putin vence a eleição presidencial russa
O líder israelense adia despedaçando os colonos da Hebron House	O exército israelense ordena os colonos da Hebron House
O governo promete ação nas filas de Heathrow	Ministro das Finanças não promete novos impostos
restos de 167 corpos encontrados na caverna mexicana	restos de 167 pessoas encontradas na caverna do México
Garota de massacre de Alpes órfãos retorna ao Reino Unido	Ataque Alpes: menina retorna ao Reino Unido
A equipe de Obama gera estacas de debate	Obama se ofende contra Romney em debate
Dois ministros quenianos entre 6 mortos em acidente de avião	Polônia Honors Presidente morto em 2010 acidente de avião
Irã, poderes preparados para negociações nucleares de alto risco	nós. , Irã se prepara para as negociações nucleares de Istambul
milhares se reúnem para o novo comício russo anti-putin	milhares se reúnem em Moscou para comícios rivais
Forças sírias matam adolescentes em protestos de Aleppo	As forças sírias matam 3 manifestantes em ativistas de Damasco
Google nomeia o novo CEO da Motorola Mobility	O Google nomeia Dennis Woodside para executar a Motorola Mobility
O enorme furacão Sandy Bears nos EUA Costa Leste	O furacão Sandy mira na costa leste dos EUA
Presidente egípcio se muda para o antigo escritório de Mubarak	O presidente eleito do Egito, Morsi, começa a formar o governo
Outro foguete bate em Eshkol; Sem ferimentos	2 foguetes atingem Eshkol; nenhum ferido
O Japão fica em silêncio para marcar 311 tragédia	Japão obrigado Taiwan pela ajuda do Quake
Milhares de refugiados sírios fogem para a Turquia durante a noite	8.000 refugiados sírios fogem para a Turquia durante a noite
ASSANGE APELAÇÕES EXTRADIÇÃO PARA A TRIBUNAL DE TELHA DE UK	Assange para recorrer da extradição para o Tribunal de Principais do Reino Unido
Quake forte sacode a maioria das partes do Paquistão	Quake forte atinge o leste da Indonésia
pistoleiros libaneses colidem com a crise da Síria	Sírios mantêm solução para a crise da Síria
Tropas sírias matam 35 no subúrbio de Damasco	Ativistas: tropas sírias matam dezenas perto de Damasco
mob mata o homem para o Alcorão queimado	A multidão paquistanesa mata o homem 'por queimar o Alcorão'
A Greve dos Drones dos EUA mata quatro no Waziristão do Norte	nós. Drone Strike mata 10 no noroeste do Paquistão: funcionários
Pintura de Salvador Dali arrebatada da Galeria de Nova York	Pintura de Salvador Dali arrebatada em Nova York
Putin reivindica a vitória na eleição presidencial da Rússia	A vitória das eleições de Putin na Rússia será recebida com protestos?
Sarkozy anuncia a oferta de reeleição	Nicolas Sarkozy, da França, torna sua oferta de reeleição oficial
EUA, Reino Unido em Pacto para liberar estoques de petróleo de emergência	EUA, Reino
Objeto suspeito encontrado em Tel Aviv não dispositivo explosivo	A polícia trata o objeto suspeito na estação de ônibus de Tel Aviv
O desemprego da zona do euro permanece no recorde de 11 %	desemprego da zona do euro em recorde em junho
Partido Socialista Francês ganha a vitória do Parlamento	Socialistas franceses ganham a maioria absoluta do Parlamento
Islâmicos Salafi, Coloque policial em Tunis - Testemunhas	Segundo atacante de fome islâmica morre em uma prisão da Tunísia
Strauss-Kahn investigado em anel de prostituição francês	Dominique Strauss-Kahn enfrenta perguntas sobre o anel de prostituição francesa
Romney ganha a Primária Republicana da Flórida	Romney Olhe -nos EUA Republican Primary Endgame
A Greve dos Drones dos EUA mata quatro no Waziristão do Norte	Suspeito de Drone Strike mata 4 no Paquistão
Pelo menos 15 mortos no ataque da Igreja da Nigéria	Pelo menos 12 mortos na Igreja da Nigéria bombardeio
2 acidentes de trânsito deixam 47 mortos na China	3 acidentes de trânsito deixam 56 mortos na China
Chefe da CIA renuncia ao caso	Hall da fama acena para Capriati
Strauss-Kahn, da França, acusado de envolvimento no vice-anel da prostituição	Strauss-Kahn acusado de vice-anel de prostituição
Sony Reports Registre perda anual	A Sony prevê uma perda anual registrada de US $ 6,4 bilhões
12 mortos em Gaza em ataques aéreos israelenses	ICTU, IBEC em movimento no ataque da companhia aérea
9 mortos em ataques após o dia mortal do Iraque	19 mortos no Iraque ataques antes do fim do Ramadã
Barclays atingidos por novos EUA investigações	Barclays atingidos por Fresh US Sonda
nós fecha a embaixada na Síria (AP)	estradas fechadas na Armênia
Jaguar para criar 1.100 empregos no Reino Unido	Royal Mail para criar 1.000 empregos
UE leva novas sanções à Síria	UE impõe novas sanções ao regime sírio
A greve dos drones dos EUA mata 8 militantes	A Greve dos Drones dos EUA mata quatro na NWA: funcionários
Os russos se reúnem contra a regra de Putin	Dezenas de milhares se reúnem contra a regra de Putin (AP)
Grande Prêmio do Bahrain em andamento em meio a protestos	A raça do Bahrein vai em frente em meio a inquietação
Estoques da China abrem na segunda -feira	Estoques chineses abrem quarta -feira mista
Sheryl Crow diz ter tumor cerebral benigno	Sheryl Crow tem um tumor cerebral benigno
Obama endossa o casamento entre pessoas do mesmo sexo	A delicada dança de Obama no casamento entre pessoas do mesmo sexo
O Iraque pesquisa o avião do Irã da Síria: funcionários	O Iraque pesquisa o avião iraniano ligado à Síria
O parlamento afegão aprova o pacto de segurança EUA-Afehano	O parlamento afegão aprova os EUA parceria
Dois turistas alemães, dois pilotos mortos no acidente aéreo do Quênia	Senador Reid envolvido no acidente de carro em Las Vegas: CNN
Israel, os negociadores palestinos se reúnem silenciosamente	Israel, os negociadores palestinos se reúnem na Jordânia
Astonauta dos EUA Neil Armstrong morto aos 82	O astronauta dos EUA Neil Armstrong morre
Anistia: Rebeldes da Síria também cometendo abusos	Investigador de Anistia: Rebeldes da Síria também cometendo abusos
Mitt Romney ganha a Primária Republicana em Indiana	Romney ganha a Primária Republicana da Flórida
O ativista dos direitos da Alemanha Oriental, Gaick, eleito presidente	Joachim Gauck eleito como presidente alemão
África do Sul começa a investigar a violência na minas	A África do Sul hospeda as 'negociações de paz' ​​no impasse por minas
A Síria lutando contra a Rússia pede a repensar ocidental	Síria lutando contra a Rússia, a Rússia pressionou
3 mortos, 27 feridos no acidente da China SW	35 mortos e 165 ausentes na Índia acidente de barco
O Partido de Erdogan envia um plano para a presidência turca	O Partido de Erdogan pretende a presidência turca
Santorum brincando para a vitória de Minnesota	Santorum ganha caucuses do Kansas
Jordan abre o primeiro acampamento para refugiados sírios	Jordan abre o primeiro campo de refugiados para sírios
A lenda do espaço Neil Armstrong morre	Primeiro homem na lua Neil Armstrong morre aos 82
nós. e a Turquia pesam zonas de exclusão para a Síria	Turquia, nós pesam zonas de exclusão para a Síria
homem preso por duplo assassinato	WA Man preso em ataque de drogas policiais
Os condados da Flórida estendem a votação antecipada	Fla. Os democratas querem horários prolongados de votação antecipada
navio de guerra põe vela para as Malvinas	British Warship define navegar para as Malvinas
Newcastle 2-0 Liverpool: Relatório de correspondência, fotos e destaques de vídeo	QPR 1-2 West Ham: Relatório de correspondência, fotos e destaques em vídeo
Prisioneiros palestinos para acabar com a greve de fome	Progresso relatado nas palestras de fome de prisioneiros palestinos
Polícia: Quatro mortos no incidente de reféns alemães	Palestinos: 12 mortos em greve de IDF em Northern Strip
O Egito permite que Mubarak PM de volta à corrida presidencial	O Egito confirma o PM de Mubarak na corrida de presidência
Jornalistas sírios mortos em capital	nós fuzileiros navais mortos no ataque base
O candidato do Partido Republicano Romney para ligar para armar rebeldes sírios	nós ajudando os armas para os rebeldes da Síria
un. Observador Patrulha chega ao local do massacre da Síria	Observadores da ONU chegam à vila de massacre da Síria
Editor absolvido em caso de privacidade	A PBS publica novas diretrizes sobre imparcialidade
American Airlines and Pilots concorda com um novo contrato	Romney se compromete a 'ficar com Israel' na ameaça do Irã
PM grego para anunciar novas eleições	PM grego pede para 6 de maio eleição geral
O governo do Canadá apóia as mulheres Montréal liderando mudanças	O governo do Canadá apóia a segurança das mulheres em Regina
Não há problema se Mulayam formar a terceira frente: Congresso	Não há problema se Mulayam formar a terceira frente: Digvijay
Bradley triunfa em Firestone quando Furyk desaparece	O Tribunal do Bahrein defende sentenças contra líderes de revolta
Samsung ultrapassa a Nokia em telefones	acusações por ataque de cães à polícia
Crash de avião em Gana mata pelo menos 10	acidente de avião no Gana: como a mídia internacional relatou
O julgamento de assassinato de Gu Kailai termina na China	O julgamento de assassinato de Gu Kailai termina na China
A zona do euro apoia o resgate grego	A zona do euro concorda com resgate da Grécia
Seis tropas americanas mortas no ataque de bomba afegão	6 tropas da OTAN mortas no Afeganistão
Forças da Síria lançam ataque de Aleppo	As forças sírias matam 54 à frente de Annan Peace Mission
Romney, Obama luta por Edge no Medicare	Obama, Romney competindo por indecisos, Base Stoke
Duas explosões atingem a capital da Síria	Duas explosões da capital síria rochosa
O diretor geral da BBC renuncia ao 'jornalismo de má qualidade'	O diretor geral da BBC renuncia em meio a escândalos de notícias
Rick Santorum ganha caucuses do Kansas	Rick Santorum entra uma vitória em caucuses do Kansas
No Egito liderado islâmico, a igreja copta nomeia o novo papa	Os cristãos egípcios escolhem o novo papa
Prometem a reconstrução dos EUA não sendo cumpridos	Prometem a reconstrução dos EUA não sendo cumpridos
As ações chinesas fecham na quinta -feira	Estoques chineses abrem quarta -feira mista
Grécia para votar no orçamento de 2013; Os manifestantes se reúnem	Grécia para votar no orçamento de 2013
não 'escondendo a bola' na Rússia: Obama	Obama diz que não está 'escondendo a bola' na Rússia
nós. , UE, cautelosamente, bem -vindo a proposta do Irã de reiniciar as negociações nucleares	nós. , a UE recebe a oferta do Irã para reiniciar as negociações nucleares
A evolução pessoal de Barack Obama no casamento entre pessoas do mesmo sexo	Obama apóia o casamento entre pessoas do mesmo sexo
Clinton adverte o Quênia sobre o custo da violência eleitoral	Clinton adverte o Quênia na repetição do caos de votos de 2007
Capitão da Inglaterra Andrew Strauss se aposenta do críquete profissional	Capitão da Inglaterra Strauss se aposenta do críquete
protestos antiamericanos sobre o cinema expandem para quase 20 países	Fúria antiamericana varre o Oriente Médio sobre o filme
Jornalistas Haille London Olympics Aberting	Marchas de delegação israelense no jogo das Olimpíadas de 2012
Os estoques de Aust abrem mais baixo	Os estoques de Tóquio abrem mais baixo
WikiLeaks começa a publicar dois milhões de e -mails na Síria	WikiLeaks liberando documentos da Síria
Palestinos: 2 militantes de Gaza mortos em Israeli Airstrike na Strip Coastal	Funcionários: Gaza Man morto em Israeli Airstrike (AP)
Presidente do Mali mãos em demissão	O presidente do Mali renuncia formalmente
A China apóia o Sri Lanka na resolução da ONU	Crimes de guerra: a China apoia o Lanka na resolução da ONU
Três mortos na Nigéria Bombardeiros Bombons Ataque	60 mortos no ataque do mercado de gado de gado da Nigéria
Desenvolvimentos de segurança de fatbox no Iraque, 1 de fevereiro	Desenvolvimentos de segurança de fatbox no Paquistão, 13 de março
HRW: Jordânia tendenciosa contra palestinos da Síria	Jordânia tendenciosa sobre os palestinos da Síria
Israel entre os principais exportadores de armas do mundo: relatório	Israel entre exportadores e importadores de armas superiores
egípcios para votar em novo presidente	MPs somalis para eleger um novo presidente
Federer vence o 7º título de Wimbledon	Federer captura o 7º título de Wimbledon
O líder da Qaeda exige seqüestro de ocidentais no Egito	O líder da Al Qaeda pede a seqüestro de ocidentais
Estoques de China Fechar Misto na sexta -feira	As ações chinesas fecham o meio -dia mais alto de sexta -feira
Ton Up: Tendulkar atinge 100º cem internacional	Sachin Tendulkar atinge 100 séculos - em fotos
A polícia dispersa protesto no Sudão Oriental - testemunhas	Polícia dispersa manifestantes de plantas químicas da China Oriental
43 mortos no acidente de ônibus	15 mortos em acidente na Índia
Putin jurou como presidente russo	Putin jurou como presidente da Rússia por 6 anos
Retornos comerciais da China ao excedente em março	Retornos calmos tensos para South Tel Aviv
Destaques do debate vice -presidencial	Cinco coisas para assistir no debate presidencial
2 ativistas pró-palestinos presos no aeroporto B-G	dezenas de ativistas 'FlyTilla' protestam no aeroporto de Paris
Episódio completo: Nightline 6/29: Katie Holmes, Tom Cruise para se divorciar	Custódia, imagens em jogo no divórcio de cruzeiros
O regime sírio nega o papel no massacre de Houla	Síria culpa os rebeldes pelo massacre de Houla de mais de 100
Sudão do Sul acusa o Sudão de atentados à frente das negociações	s. Sudão acusa o Sudão de bombardeio em golpes
Conspiração contra mim - Lance	O dia começa em meio ao pânico
A taxa de desemprego espanhola sobe de 25 %	Taxa de desemprego nos EUA visto subindo, oferecendo a Obama sem alívio
Nove mortos em ataques de armas no Paquistão	Cinco milhões de cidadãos recebem salário não oficial na Ucrânia
Demandas da Síria garantem, os rebeldes dizem que o Plano de Paz condenado	Síria exige garantia por escrito para recuperação de tropas
Minn. terminal reabre após evacuação	Minn. Terminal reabre após a bolsa causar evacuação
Golfe: Westwood lidera no Dubai Desert Classic	Westwood na frente um clássico do deserto de Dubai
Sudão bloqueia o filme do YouTube sobre o filme anti-islâmico	O PM Ordens do Paquistão Parde do YouTube Part Over Anti-Islam Film
Pesquisas abertas nas eleições presidenciais russas	Pesquisas fechadas na eleição presidencial do Senegal
Chavez sai novamente para Cuba para radioterapia	Chavez preparado para mais radioterapia em Cuba
Presidente Romeno declarou vitória	Presidente chinês conclui a visita de estado à Dinamarca
Os russos assumem o apoio à Igreja Ortodoxa sobre a controvérsia de puss -tumulto	A Igreja Ortodoxa russa se unirá fiel após as críticas
Clinton pousa na Índia para respirar a vida em gravatas	Clinton adverte contra minar o Banco Grameen
O líder interino do Mali assume o cargo	O presidente interino do Mali jurou no cargo
Putin declara a vitória na votação presidencial russa	Putin 'ganha' a eleição presidencial da Rússia
Al renova condenação sobre a violência da Síria	nós. fecha a embaixada em Damasco devido à violência da Síria
UE dá um tapa em sanções sobre a família Assad	A esposa de Sanções da UE Assad; Argamassas atingem Homs
O instrutor da Força Aérea enfrenta a sentença para estupro	As mulheres testemunham na sentença do instrutor da Força Aérea
Mais de 30 mineiros de ataque mortos	Mais de 30 mineiros de greve mortos na África do Sul
PM israelense faz o caso no Irã para os eleitores dos EUA	Israel culpa o Irã por ataques a seus diplomatas
A indústria da música presta homenagem a Whitney Houston	A indústria da música lamenta Whitney Houston
Iron Dome Intercepta 17 foguetes	Iron Dome intercepta dois foguetes disparados contra Berheba
Islamitas do Mali destruindo 'mais santuários timbuktu'	Os islâmicos do Mali destroem mais sites sagrados timbuktu
As ações da China terminam mais no PMI ao meio -dia	As ações chinesas abrem na quinta -feira superior
Os cientistas ressuscitam flores de sementes pré -históricas	Nintendo apara a tinta vermelha, abaixa a previsão para o ano
Homem condenado no caso de vazamentos do Vaticano	Butler a ser julgado no caso "Vatileaks"
Romney, Paul Vie para a vitória do Maine Caucus	Romney tem vitória estreita do Maine Caucus
Chega sectário da cidade libanesa de Trípoli	Casa sectária de rock Libanese City, 3 mortos
Repsol explode a Argentina sobre a nacionalização de YPF	Repsol explode a Argentina sobre a nacionalização do petróleo
Vários mortos, 550 feridos no acidente de trem da Argentina	49 temido morto em Buenos Aires Train Crash
Aung San Suu Kyi para se dirigir aos deputados britânicos	Aung San Suu Kyi, da Birmânia, para abordar o Parlamento na visita de junho
Xerife: O homem recupera o carro roubado 42 anos depois	US HOM
O CEO do Google diz Android importante, não crítico	Larry Page diz que o Android é importante, não crítico
Mursi faz juramento de cargo, torna -se presidente egípcio	Morsi para prestar juramento como Primeiro Presidente Civil do Egito
O Irã pode cortar as exportações de petróleo para mais estados da UE	Os parlamentares do Irã dizem prontos para proibir as exportações de petróleo para alguns estados da UE
Incêndios de fábrica matam pelo menos 260 no Paquistão	Pelo menos seis mortos no tiroteio no Paquistão
Australiano entre os quatro no avião desaparecido na Indonésia	Painter iraniano Mansoureh Hosseini morre
Romney promete restaurar a 'Promessa da América'	Romney promete 'restaurar a América'
A filha de 3 anos de Santorum, hospitalizada	Diretor 'Kony 2012' hospitalizado
A oposição síria implora por ação do tribunal criminal	O líder da oposição síria critica os EUA.
Mandela libertado do hospital	Presidente israelense libertado do hospital
Sunderland 2-2 Bolton: Davies Double recebe um ponto, mas eles ficam nos três inferiores	Sunderland 2-2 Bolton: Davies no duplo
Jaya Prada tudo pronto para se juntar ao BJP	Jaya Prada provavelmente se juntará ao BJP, Amar Singh para decidir por ela
cinco mortos no Paquistão Blast	Mais de 120 mortos na fábrica do Paquistão Blaze
O Nasrallah do Hezbollah nos avisa sobre o filme anti-islâmico	O Hezbollah pede mais protestos cinematográficos anti-islâmicos
Forças sírias Cidades de conchas, colidem com rebeldes	Forças e rebeldes sírios se chocam na província costeira
Nadal tops Djokovic para o 7º título aberto francês	Tênis: Nadal derrota Djokovic para o título de Monte Carlo
Os custos com creche aumentam quase 6 %	Cuidados de crianças 'custando £ 15.000 por ano'
Obama pede ação decisiva na crise da dívida da Europa	Obama pede que a Europa age rapidamente em crise
Mix de hambúrguer de carne lembrava as preocupações de Salmonella	Choc Powder recordado sobre preocupações com Salmonella
Obama, Romney se prepara para o primeiro debate	Obama, Romney se prepara para debater
O primeiro gás significativo encontrou o Quênia Offshore	Raiders matam 38 em últimos conflitos de terras no Quênia
Trabalhador da Cruz Vermelha morta no Paquistão	Trabalhador assinado no Reino Unido sequestrado morto no Paquistão
Na CPAC, Mitt Romney enfatiza as credenciais conservadoras	CPAC 2012: Mitt Romney luta para se conectar com a base conservadora
8 foguetes disparados de Gaza no sul de Israel; nenhum doeu	dez foguetes de Gaza Land, no sul de Israel; nenhum doeu
Glorious Triple-Gold Night para a Grã-Bretanha	Grã -Bretanha Savors Golden Night na pista
Manifestantes do Bahrein e a polícia se chocam após o funeral	manifestantes gregos, colisão da polícia como acordo de resgate no limbo
nós. soldado morto no incidente de tiro em s. Afeganistão	Cinco soldados da Otan mortos no Afeganistão
Pesquisas fechadas nas eleições presidenciais egípcias	Com comunicados de imprensa: eleição presidencial iemenita
A polícia 'não vinculou' reivindicações Savile	A BBC enfrenta perguntas para puxar o estojo Savile
O desemprego da zona do euro permanece no recorde de 11 %	O desemprego da zona do euro atinge o recorde
James Murdoch sai bskyb	James Murdoch desiste do papel no BSKYB
O icônico escritor de ficção científica Ray Bradbury morre às 91	lenda da ficção científica Ray Bradbury morto aos 91
Eleição presidencial do Egito de 23 a 24 de maio	Eleição presidencial dos EUA 2012
Quatro soldados franceses mortos na explosão de suicídio afegão	Quatro soldados estrangeiros mortos no East Afghan
Observadores da ONU encontram vestígios de massacre sírio	A equipe da ONU investiga o massacre sírio
Enquete de AP: a maioria nos EUA prejudicou os negros	Enquete de AP: preconceito de majority porto contra negros
Fonte da AP: Redskins para negociar por não. 2 escolha	Redskins negocia por não. 2 escolha
A China diz que o orçamento de defesa aumentou 11,2 % em 2012	Os gastos com defesa da China para aumentar 11,2 %
A sequência de explosões do Iraque mata pelo menos 32	Forte Itália Quake mata pelo menos seis
O presidente do Equador, Correa, diz que nenhuma decisão tomou em Assange asilo	Equador ainda a decidir sobre o asilo de Assange
Apple Compra Security Firm Authentec por US $ 356 milhões	Resumo das notícias: Apple compra Authentec por US $ 356 milhões
Nós nos oferecem US $ 10 mil. Para o militante do Paquistão	EUA oferecem US $ 10 milhões para o chefe militante paquistanesa
6 tropas da OTAN mortas no Afeganistão IED ataque	6 tropas da OTAN mortas no Afeganistão
Asama Bin Laden Wives para ser preso	Filme de Osama bin Laden a ser filmado na Índia
Os egípcios votam nas eleições presidenciais marcantes	Os egípcios vão a pesquisas nas eleições históricas
piloto JetBlue que interrompeu o voo declarado insano, não culpado	piloto JetBlue que causou interrupção no vôo não culpado
Aviso de tsunami: Não há necessidade de SA entrar em pânico	Aviso de tsunami após Aceh Quake
Nós entregam a prisão de Bagram para as autoridades afegãs	nós. Transfere a prisão de Bagram para o controle afegão
Jeremy Hunt se distancia de consultor que 'ultrapassou a marca'	Jeremy Hunt se apega à medida que o SPAD desiste sobre os e -mails da News Corp
Obama elogia os laços comerciais da América dos EUA.	Agentes do Serviço Secreto de Obama enviados para casa
BlitzBokke expulso por Fiji	BlitzBokke espancado pela Nova Zelândia
Obama e Romney se concentram em estados de swing	Equipe Anna ainda para decidir sobre a contestação de pesquisas estaduais
Variedade de jornal comercial à venda	Variedade de publicação comercial de Hollywood colocada à venda
'Ataque de granada' mata um e feria pelo menos 11	ataque sexual à mulher investigada
Toulouse Siege: A polícia cercou o apartamento do 'guerreiro islâmico' suspeito de ser assassino em série	Toulouse Shooting: França estava no mais alto nível de segurança do alerta de segurança
'dezenas de corpos' encontrados na Síria	Mais oito corpos encontrados no navio
atirador acusado de assassinato de nós negros adolescentes	Pensamentos sobre relações raciais sob um presidente negro
Jonny Bairstow e Eoin Morgan brilham para a Inglaterra em Mumbai	Bairstow atinge a partida da turnê TON in India
Australianos fogem de casas em meio a inundações	O orador australiano se afasta
Como os desenvolvedores do parque eólico usam truques de câmera para fazer as turbinas parecerem menores do que realmente são '	Desenvolvedores de parques eólicos usando 'truques' para fazer as turbinas parecerem menores
O drone dos EUA mata seis militantes no Paquistão: funcionários	Os mísseis dos EUA matam 15 no Paquistão: funcionários
Wigan 3-2 lobos: Relatório de correspondência, fotos e destaques de vídeo	Arsenal 0-0 Chelsea: Relatório de correspondência, fotos e destaques de vídeo
Reino Unido gasta 3 milhões de libras em prisões estrangeiras	US gasta US $ 50 milhões em invasão de carpa
Nigéria: tropas nigerianas enxames após 40 mortos no massacre de estudantes	A polícia da Nigéria faz prisões após o massacre da faculdade
nervos se acalmar	O foco muda para a Grécia após a Espanha protege o resgate do banco
Fighting Heavy relatado no Aleppo da Síria	Combate pesado relatado em Damasco
A França diz que a Grécia deve mostrar credibilidade para a zona do euro	A França Hollande apoia a Grécia, mas pede reforma credível
Avengers define o registro de bilheteria	Os Jogos Vorazes quebram o recorde de bilheteria dos EUA
4 soldados franceses relatados mortos no Afeganistão	Soldado britânico morto no Afeganistão
Dilema de resgate espanhol fica mais agudo	Dilema espanhol fica mais agudo
Soldado da Otan morre no Afeganistão	Dois soldados de Aust feridos no Afeganistão
Estoques chineses abrem quarta -feira inferior	Estoques da China abrem na sexta -feira inferior
Liderança palestina condena a chamada israelense de fm para expulsar Abbas	A liderança palestina apóia o acordo de Fatah-Hamas Doha
Mitt Romney vence o Primário do Partido Republicano de Maryland	Romney ganha a Primária Republicana de Maryland
O homem encontra carro no eBay 42 anos depois que foi roubado	O homem do Texas encontra seu carro 42 anos depois que foi roubado
O filho de Sylvester Stallone encontrou morto em Hollywood	O filho de Sylvester Stallone, Sage Stallone, encontrado morto em Hol
OTAN: 4 trabalhadores humanitários resgatados de insurgentes afegãos	5 trabalhadores humanitários libertados em operação no Afeganistão
Russia prisão buceta tumulto protesto punks por dois anos	Tribunal Russo para governar em Pussy Riot Trial
Alemanha evita a recessão com crescimento no primeiro trimestre	A zona do euro evita a recessão no primeiro trimestre, graças à Alemanha
Israel barra grama de escritor alemão de visitar o poema	Israel barra grama do autor alemão sobre poema
As leituras obrigatórias da nota para 1 de agosto de 2012	A nota deve ler para quarta -feira, 4 de julho de 2012
Tropa dos EUA da OTAN detida sobre o tiroteio de civis afegãos	nós. diz triste por atirar em civis afegãos
Hollande ganha eleição presidencial francesa	Votos de Timor Leste nas eleições presidenciais
Lance Armstrong cai luta contra acusações de doping	Lance Armstrong chama de desistir na luta contra acusações de doping
Militar: os estoques químicos da Síria ameaçam Israel	A Rússia diz à Síria Química Ameaça de Armas é inaceitável
Fitch Atualizações Ford para Grau de Investimento	Fitch restaura o crédito Ford à nota de investimento
Plano de paz da Síria Condições "inaceitáveis", diz a oposição	A paz na Síria passou quando o prazo passa
As ações asiáticas aumentam após a votação do grego diminuir os medos	O petróleo sobe após o resultado das eleições gregas
confrontos como gregos protestam contra mais cortes	conflitos entram em erupção quando a votação grega se aproxima
9 mortos, 11 feridos, 4 desaparecidos em Mont Blanc Avalanche	6 mortos, vários desaparecidos em Mont Blanc Avalanche
O Taliban posa como 'mulheres atraentes, no Facebook para espionar	Soldados Taliban Posando como mulheres bonitas no Facebook para obter segredos de tropas
Ativista da China Chen Lands em nós	As renovas de ativistas chineses chamam para combater a injustiça
Quarto da cidade: Tiro de edifício estadual do Empire State	2 mortos em tiro fora do Empire State Building
Mohamed Morsi jurou como presidente eygptano	Mursi jurou como presidente egípcio
Soldado britânico morto no sul do Afeganistão	Dois soldados britânicos mortos no Afeganistão
ataque à base da OTAN no Afeganistão mata 15	trabalhadores humanitários libertados no Afeganistão Raid
Blasta do suicídio do Iêmen, ataque de drones matam pelo menos 30	Apaces de ataques do Iraque matam pelo menos seis
Torres seguindo em frente depois que a oferta olímpica falhar	Torres termina em 4º, perde na sexta Olimpíada
Obama em silêncio sobre a China Dissidion	Obama para visitar DMZ coreano
Paquistão começa a demolição do composto Bin Laden	O Paquistão demolia Osama bin Laden Hideout
Sudão culpa Israel pelo fogo de armas de Cartum	Sudão acusa Israel de Airstrike na fábrica de armas
O acordo com senato de casa alcançado em medida de imposto sobre folha de pagamento	Os negociadores atingem o acordo sobre a fatura de corte de impostos sobre folha de pagamento do Congresso
Prince Philip hospitalizado em Londres	O príncipe Philip da Grã -Bretanha hospitalizado, para Miss Jubilee
A tempestade tropical Isaac encharca o haiti, passa Cuba	Tempestade tropical Isaac ameaça a barragem
A atriz de 'Desperate Housewives' Kathryn Joosten morre	A atriz de 'donas de casa' Kathryn Joosten morre aos 72
Rockets de Gaza terras na área da costa de Ashkelon; nenhum doeu	Rocket disparou de Gaza danifica a casa em Sderot; nenhum doeu
Ativistas pró-palestinos estrangeiros procuram entrar na Cisjordânia	100 pró-palestinos procuram entrar em Israel em Allenby
Bomber Suicide mata 6 na capital afegão	Bomber suicida mata 37 na mesquita no Afeganistão
As ações mundiais aumentam na esperança de UE, Estímulo dos EUA	As ações aumentam na esperança de um estímulo do Fed
Gore Vidal morto aos 86 anos: Autor lendário, dramaturgo e político morre	Gore Vidal, comemorado autor, dramaturgo, morre aos 86 anos
O papa copta do Egito Shenuda III morre	O Egito se prepara para enterrar o papa copta Shenuda III
As ações mundiais caem antes do prazo de oferta da dívida grega	As ações da Ásia caem à frente do prazo de oferta de dívida grega
A polícia da África do Sul atirou em tiros 30 mineiros	A polícia da África do Sul diz que matou 30 + mineiros
Isaac encharca o Haiti, segue em direção a Cuba, Flórida	Isaac se aproxima do Haiti com a população de terremotos sem -teto
Grã -Bretanha alcança a oposição da Síria	Quem se importa com o povo sírio?
Tiro de Denver: Polícia para detonar dispositivos na casa do suspeito	Polícia para detonar os dispositivos no Colorado Shooting Suspect's Home
Obama relaxa as regras de deportação para jovens imigrantes	nós. Regras de deportação relaxadas para jovens: Napolitano
A superfície da Microsoft, uma grande aposta no futuro: analistas	O comprimido de superfície da Microsoft promissora, mas as perguntas permanecem
A namorada de 'Whitey' Bulger recebe 8 anos	A namorada de "Whitey" Bulger recebe 8 anos
Presidente da Mauritania filmado por unidade do exército	Presidente da Mauritania atirou em
Síria entrega os corpos de jornalistas	Síria TV diz que os jornalistas cativos gratuitos do Govt
Hom	Hom
nós. Drone Strike mata 10 no noroeste do Paquistão	drone dos EUA no Paquistão mata 10 militantes suspeitos
9.000 EUA fuzileiros navais para deixar Okinawa	9.000 EUA fuzileiros navais para sair de Okinawa: declaração
Toys R Us renunciam à taxa do programa de layaway	O Wal-Mart reduz a taxa para o programa de layaway de férias
UE definido para novas sanções contra o Irã	UE planeja grandes e principais sanções contra o Irã
O Irã expande as atividades de enriquecimento nuclear: Relatório da IAEA	Irã aumenta o trabalho nuclear sensível - IAEA
Donna Summer, rainha da discoteca, morre aos 63	Donna Summer, a rainha da disco
Assad se reúne com funcionários da Cruz Vermelha na Síria	Assad faz promessa da Cruz Vermelha
ataques iraquianos matam general, quatro policiais	Ataques no Iraque Kill General e 4 outros
Pelo menos 80 mortos no noroeste do Irã Quakes	180 mortos, 1.300 feridos no noroeste do Irã terremotos
O padre pop-estrela do Brasil recebe um novo palco gigantesco	O padre pop-estrela do Brasil recebe um novo palco gigantesco
Washington: Mais de 100 são cobrados na varredura de fraude do Medicare	Washington: Tribunal defende a Lei dos Direitos de Voto no caso do Alabama
Putin reivindica a vitória na eleição presidencial da Rússia	Putin reivindica a vitória na votação presidencial
Clinton pronto para lutar por Obama	Clinton um ato difícil para Obama seguir
Romney anuncia Paul Ryan como companheiro de chapa	Romney escolhe Ryan como companheiro de corrida do Partido Republicano
Os mercados europeus aumentam nas esperanças de resgate grego	Os ministros europeus estão prontos para aprovar o resgate grego
Edwards absolvido em 1 contagem, julgamento por outros	Edwards achou inocente em uma contagem; Mistrial sobre os outros
O levantador de peso ucraniano recebe proibição de doping de quatro anos	Korobka da Ucrânia recebe proibição de doping de quatro anos
O atirador pode ter filmado massacre escolar	Killer pode ter filmado o tiroteio na escola da França
As ações de Hong Kong fecham 0,28 %	As ações de Hong Kong abrem 0,62 pct mais alto
Coroner: Whitney Houston morreu na banheira	Coroner confirma que Whitney Houston encontrou na banheira
Suicide Bomber Ataca a base de segurança argelina	Bomber suicídio alvo da Igreja Nigeriana
Tailândia: os iranianos planejavam atacar israelenses	Malásia para extraditar iraniano para ataques a israelenses
Tribunal Militar Israel rejeita o apelo do atacante da fome palestina	Israel chega a lidar com os atacantes da fome palestina
O Japão sofre inundações graves - em fotos	Oklahoma Wildfires Destroy Homes - em fotos
Avengers define o registro de bilheteria	'Jogos Vorazes' define registros de bilheteria
Putin 'ganha eleição presidencial russa'	Putin 'ganha' a eleição presidencial da Rússia
Japão para deportar chinês mantido sobre o pouso na ilha	Tribunal Alemão pesa atraso na decisão do fundo do euro
Putin voa com a votação enquanto os russos votam	Putin para ganhar a eleição presidencial da Rússia
O chefe da ONU encontra sua voz, permanece cauteloso na China	Insight: ONU. Chefe encontra sua voz, mas permanece cauteloso na China
Alguma violência da Síria equivale a cruz	Alguma violência na Síria se qualifica como Cruz Red War -Red
Os líbios começam a entregar armas	Os líbios transferem armas para o exército
Arcebispo britânico de Canterbury muda a carreira para Cambridge	Arcebispo de Canterbury para renunciar em meio a brechas
O Punjab Mail descarrila perto de Rohtak, 19 feridos	O Punjab Mail descarrila perto de Rohtak em Haryana, 19 feridos
George Zimmerman 'a ser acusado' de matar Trayvon Martin	George Zimmerman a ser acusado no caso Trayvon Martin, diz o funcionário
Os rebeldes maoístas indianos oferecem palestras para reféns italianos gratuitos	Índia: rebeldes maoístas em negociações sobre liberar italianos
Dois relatados mortos em tiro no Empire State Building em NY	Quarto da cidade: Tiro de edifício estadual do Empire State
cinco mortos no Paquistão Blast	Pelo menos 63 mortos na fábrica do Paquistão Blaze
Os jogadores de futebol da Penn State reagem a sanções	O futebol da Penn State bateu com sanções da NCAA
Israel deve liberar ou experimentar o palestino em greve de fome prolongada	O ministro israelense quer a deposição do líder palestino
O relatório da ONU diz que ambos os lados nos direitos de abuso da Síria	O líder da OTAN joga com o risco de confronto da Turquia-Síria
Menina acusada de queimar o Alcorão se esconde	Menina acusada de queimar o Alcorão resgatado
Manchester United reduz o preço do IPO dos EUA	Manchester United revelou detalhes do preço das ações
Romney ganha Nevada Caucus	Romney muda o foco para Santorum à frente dos caucuses
Solstício encharcado: Stonehenge fica imerso	Solstício de verão comemorado em Stonehenge, apesar da chuva
França alerta a Síria sobre o uso de armas químicas	un. preocupado com possíveis armas químicas da Síria
tempestades do meio-oeste com risco de vida temiam	Tempestades 'com risco de vida' temiam o Midwest
A greve de professores de Chicago se aproxima do final com o acordo de 'estrutura' em vigor	Greve Geral termina: Histadut, Acordo de Alcance do Tesouro
Presidente indonésio para visitar o Reino Unido	Presidente indonésio para visitar a Austrália
O advogado da ICC detido na Líbia sobre preocupações de segurança	O advogado da ICC realizada na Líbia enfrenta detenção de 45 dias
Atrasos de tempestades Início da Convenção Republicana	tempestade lashes da Flórida, atrasando a convenção republicana
O trem de carga descarrila, pega fogo em Columbus, Ohio	descarrilamento de trem de carga, explosão solicita evacuação
Pelo menos dois da OTAN mortos no Afeganistão Crash de helicóptero: militar	Pelo menos 18 mortos em ataques de bombas afegãos: funcionários
Presidente Mills deve sair - Professor	O presidente John Evans Atta -Mills deve renunciar agora -NPP Alemanha
Miami Heat vence as finais da NBA	Miami Heat Clives NBA Championship
O Japão fecha o último reator nuclear	O Japão desliga a última usina nuclear neste fim de semana
Ryanair em nova oferta de Aer Lingus	Ryanair Chief Hails Relation Actreshings
Força Aérea Russa comemora o 100º aniversário	O 100º aniversário da Força Aérea Russa
6 tropas da OTAN mortas no Afeganistão	soldado da OTAN morto no Afeganistão
China Yuan enfraquece para 6.3282 contra USD na segunda -feira	O Yuan da China enfraquece contra o USD pelo terceiro dia
Apple iPad mini faz estréia	Apple iPad mini faz estréia na Ásia
Não é tão super terça -feira para Mitt Romney	Romney lidera Santorum nos concursos do Partido Republicano Super Terça -feira
Putin jurou quando o crescimento russo vacila	Putin jurou como presidente da Rússia por 6 anos
Arqule, Daiichi Stop Lung Cancer Trial, ações de ações	O estoque de arqule mergulha quando o estudo de câncer de pulmão arquivou
adolescente e pai mortos no acidente	Três mortos em acidente de terror são nomeados
6.1 Quake de magnitude ataca a Indonésia	6.1 Quake de magnitude atinge Papua, Indonésia-USGS
2 americanos mortos quando a agitação afegã entra no quinto dia	Dois oficiais americanos assassinados à medida que a agitação afegã continua
Breivik reclama de 'ridículo'	Breivik: prisão 'ridícula'
Funcionários: Romney para obter proteção do Serviço Secreto	Obama aborda o escândalo do Serviço Secreto
PM do Japão pede processamento de resíduos de tsunami mais rápido	O Japão marca um ano desde o desastre de Quake e Tsunami
Pilot de caça sírio defende a Jordânia	Defeitos da PM síria para a Jordânia
República Árabe da Síria (The): República Árabe da Síria: Refugiados Sírios (em 28 de junho de 2012)	República Árabe da Síria (The): Mais de 70 mortos na Síria antes do Returno de Annan
Bomber suicida mata 16 no Afeganistão	Bomber suicida mata 12 na Igreja da Nigéria
Hamas pendura três prisioneiros de Gaza	Mianmar anuncia a libertação de prisioneiros
As companhias aéreas cancelar	Os ingressos para cancelamentos de companhias aéreas do Reino Unido cancelam em objeções de Israel
Espanha pede resgate bancário	espanhol em julgamento pela morte do dissidente cubano
Votos de Timor Leste nas eleições presidenciais	Venezuelanos instados a votar nas eleições presidenciais
as águas turvas do mar da China Meridional	A paz está no mar da China Meridional
O Sri Lanka busca um renascimento de um dia contra o Paquistão	Jornalista sênior morto no Paquistão
SpaceX Docks com estação espacial internacional: a seguir, viagens públicas?	Dragão SpaceX Doca com estação espacial internacional
Romney abalou o vídeo secreto	Romney gravou na palestra secreta do doador
'Million Muppet March' para defender Obama Backing of PBS	Million Muppet March planejava defender os EUA Apoio para PBS
oposição síria em negociações de reconciliação	Conselho de Oposição Síria para estabelecer Enviado na França
Sensex Down 193 pontos no orçamento blues	Romney ganhou diferenças de orçamento voluntárias
O Facebook aumenta o tamanho do IPO por 25pc para arrecadar US $ 15 bilhões	O Facebook aumenta o tamanho do IPO em 25 %
O Parlamento do Irã questiona um Ahmadinejad desdenhoso	Perguntas do Parlamento do Irã Presidente Ahmadinejad
Ataque suicida do Iêmen mata 7 soldados: funcionários	O carro -bomba de suicídio afegão mata pelo menos sete: funcionários
A jornalista do Sunday Times, Marie Colvin, matou na Síria	Jornalista do Sunday Times, fotógrafo francês 'morto na Síria'
KL compartilha mais alto no meio da tarde	KL compartilha mais baixo no meio da manhã
Os professores de Chicago grevem em disputa de contrato amargo	Os delegados sindicais de professores de Chicago podem acabar com a greve
Voto presidencial polariza os egípcios	Esperanças presidenciais do Partido Republicano Clash em corridas do sul
Mais três soldados dos EUA mortos no Afeganistão	soldado da OTAN morto no Afeganistão
A polícia aumentou o número de mortos no acidente de ônibus para 8	Rodney King Death governou acidental
Quatro soldados estrangeiros mortos no East Afghan	2 soldados britânicos mortos no ataque de insider afegão
A zona do euro concorda em emprestar a Espanha até US $ 125 bilhões	zona do euro para emprestar a Espanha até 100 bil. Euros
Trabalhador da Cruz Vermelha morta no Paquistão	O médico da Cruz Vermelha Britânica sequestrou no Paquistão encontrado decapitado
Afeganistão, EUA Govts Sign Deal em controverso ataque noturno	Afegães, acordo de assinatura dos EUA em ataques noturnos
O acidente de mina da China mata 10	O acidente de caminhão da China mata 20
Austrália pode eclipsar a Inglaterra em Windies	PM australiano desafiador sob pressão sobre a liderança
protestos no veredicto de pussy tumulto	veredicto de pussy tumulto recebido com desafio
Serviço Secreto vê seu 'maior escândalo' sobre prostitutas	Secret Secret Service Scandal 'arrependimento'
Kuwait: ativistas tempestades a embaixada da Síria; dois feridos	Ativistas Storm Síria Embaixada no Kuwait
Detalhes da visita de Aung San Suu Kyi à Irlanda	Bata de recepção arrebatadora para a viagem histórica de Aung San Suu Kyi
Key diz que Marae visita uma oportunidade perdida	Key Wants Waitangi Marae Visita para ficar
Noruega Marks Anniversary of Massacre	Aniversário da Noruega Marks do Massacre de Breivik
O crescimento econômico sul-coreano cai para baixo ano	s. O crescimento econômico coreano cai para a baixa de quase 3 anos
Mulher morta por detritos caindo	Quando um aliado recusa
Aust compartilha 1 % após o corte da taxa de juros	RBA oferece outro corte de taxa
Alemanha alerta a Grécia: Não há mais dinheiro sem reformas	Zona do euro para a Grécia: sem resgate sem reformas
Israel para libertar atacante de fome palestina	Israel pede armas que possam ajudar o Irã
Obama para encontrar famílias de tiro vítimas	Obama para conhecer vítimas de armas do Batman
Obama aumenta a liderança sobre Romney, apesar dos dados dos empregos: pesquisa da Reuters / Ipsos	Romney lidera sobre Obama com a Convenção "Bounce": Reuters / Ipsos Poll
Rússia, China Veto ONU Resolução na Síria	Rússia, China Veto ONU Resolução sobre assassinatos na Síria
Dois mortos, 19 feridos no tiro de Toronto	Dois mortos, 7 feridos no tiroteio da Finlândia
O que o mordomo do papa viu - assessor preso por vazamentos do Vaticano	Butler do Pope prendeu em escândalo por vazamentos do Vaticano
Os manifestantes anti-Putin formam cadeia humana em Moscou	Os manifestantes anti-Putin formam cadeia humana
jurado: Sandusky parecia aceitar seu destino	Jerry Sandusky condenado por abuso sexual infantil
Atos do Congresso de Washington são vendidos por US $ 9,8 milhões	A cópia de George Washington da Constituição dos EUA é vendida por US $ 9,8 milhões
O treinador de bombeiros do Lakers, Mike Brown	Lakers dispara Mike Brown após 1-4
Os muçulmanos canadenses emitem fatwa contra 'Honor Killing'	EUA, os imãs canadenses emitem fatwa contra assassinatos de honra
un. Para assumir a resolução da Síria	Assembléia da ONU para votar na resolução da Síria
Soldado 'não pode recordar o massacre	Soldado dos EUA 'não se lembra de massacre'
Não é um bom começo: o avião de Hollande atingido por um raio a caminho de Berlim	O avião do presidente francês François Hollande atingiu por um raio a caminho de Berlim
A PM da Líbia nomeia o novo gabinete após protestos sobre o original	A Assembléia da Líbia rejeita um novo gabinete, dispensa PM
4 soldados estrangeiros mortos no East Afghan	4 soldados franceses relatados mortos no Afeganistão
Forças sírias Storm Central Town	As forças sírias bombardeiam Homs, a Rússia alerta da Guerra Civil
Pak: 20 mortos em protestos de cinema anti-islâmico	25 feridos em protesto cinematográfico anti-islâmico em Islamabad, Paquistão
Causa da morte de Whitney Houston pode levar semanas	Os investigadores buscam respostas à morte de Whitney Houston
N Coréia alerta de retaliação por broca da Coréia do Sul	North avisa de retaliação ao plano de perfuração naval de Seul
Uma história de dois passes: como os New York Giants venceram o Super Bowl	Menores de dois males triunfam no Super Bowl
um morto em novo greve israelense em Gaza	Dois mortos no novo ataque israelense a Gaza: Médicos
Alemanha que provavelmente pressionará a Rússia na crise síria	O que a Rússia está pensando na Síria? um breve guia
quatro gravemente feridos no acidente de rodovia M23	quatro feridos em acidente de rodovia
O chefe de ajuda da ONU Amos entra em Baba Amr com o Crescente Vermelho	Baba amr cercado da Síria está deserta, diz a Cruz Vermelha
Dezenas mortas em tumultos nigerianos	Dezenas mortas nos confrontos quenianos
Perfis dos principais candidatos presidenciais do Egito	Segundo dia de eleição presidencial egípcia
ator gazzara morto aos 81	O ator Ben Gazzara morre aos 81
British Gold Rush Silências Gripes sobre o custo	2 soldados britânicos mortos no ataque de insider afegão
Avalanche enterra pelo menos 100 soldados paquistaneses	Avalanche enterra mais de 100 soldados paquistaneses
A inflação cai para a baixa de 15 meses: o que os analistas dizem	A inflação cai para a baixa de 15 meses
Komen Won 'T Cut Planned Parenthood Funding	Susan G.
forex & amp; ouro 25 de agosto de 2012	Forex & Gold 19 de julho de 2012
O Parlamento afegão vota para expulsar os principais ministros	Votos do parlamento afegão para remover os principais ministros
O Irã diz que as negociações nucleares da ONU continuarão	O Irã diz negociações nucleares com a ONU 'construtiva'
Agronegócio: doença da vaca louca encontrada na Califórnia	USDA confirma o caso de doença da vaca louca na Califórnia
A BP vende alguns ativos do Golfo do México por US $ 5,55 BIL	A BP vende ativos do Golfo do México para planícies por US $ 5,55 bilhões
300 vítimas em potencial Jimmy Savile: Polícia	Reino Unido: 300 vítimas de abuso savile em potencial surgem
Romney lidera rivais, não Obama, na captação de recursos	ROMNEY: Eu deixei toda a administração de Bain em 1999
Armstrong desce do Livestrong	Armstrong de pé de Livestrong
A greve dos drones nos EUA mata 5 militantes no Paquistão	nós. Greves de drones matam 16 suspeitos de militantes no Iêmen
9/11 Réus ignoram o juiz na audiência de Guantánamo	Set. 11 Réus enfraquecem as famílias na audição
Governo sírio não vai parar de ataques	oposição síria relata 'massacre'
As ações chinesas fecham o meio -dia mais alto de sexta -feira	Ações chinesas mais altas no meio -dia de sexta -feira
Mianmar: oposição afirma que Suu Kyi Win	Os eleitores de Mianmar esperem, pois o partido de Suu Kyi reivindica a vitória
A classificação da pesquisa de Obama cai em impulso para rivais republicanos	A grande vitória hispânica de Obama preocupa os republicanos
Dois soldados de Aust feridos no Afeganistão	4 soldados estrangeiros mortos no East Afghan
atacante em uniforme afegão mata 2 tropas da OTAN	Homem em uniforme do exército afegão mata soldado da Otan
Novo chefe de oposição da Síria quer ajuda sem gordura	A oposição da Síria une como Israel disparar fotos de aviso
genéricos baratos sem panacéia para a mais pobre da Índia	Medicamentos de câncer baratos sem cura para a mais pobre da Índia
Os egípcios votam para escolher o presidente pela primeira vez	Os egípcios esperam pelos principais resultados da votação presidencial
Clash da Mina da África do Sul mata pelo menos 30	Crash de trem da África do Sul mata 26
As forças sírias bombardeiam Homs, a Rússia alerta da Guerra Civil	forças sírias bombasarem homs, Lavrov chega para negociações
Resultados das eleições presidenciais do Egito atrasadas	Resultado da eleição egípcia atrasada
O prazo passa sem novas sanções do Irã	UE se aproxima de novas sanções do Irã
preso assassino russo nega laços com puss	dezenas presas no protesto russo da torre de TV
Memorial da Noruega Honors 77 Vítimas de Massacre	Noruega Marks Anniversary of Massacre
Geral do Afeganistão dos EUA ligado ao escândalo de Petraeus	Geral sênior dos EUA ligado ao escândalo de Petraeus
'mandado de prisão' para as Maldivas ex-presidente	Tribunal das Maldivas emitem mandado de prisão para ex -presidente
Os estoques chineses caem após o corte do RRR - 14 de maio	Os estoques chineses ganham ao meio -dia de segunda -feira
HRW: Jordânia afastando refugiados palestinos da Síria	Relatório: Jordânia tendenciosa sobre os palestinos da Síria
Nkorea faz progresso "significativo" do reator nuclear - IAEA	n. A Coréia promete expandir o dissuasão nuclear
O presidente das Maldivas sai após o motim da polícia, protestos	O presidente das Maldivas sai após semanas de protesto
greve da OTAN 'mata civis' no Afeganistão	Dois soldados da Otan mortos no Afeganistão
A Al-Qaeda diz que captura 70 soldados iemenitas na batalha de Abyan	Clashes da Al Qaeda, explosões matam 35 soldados no Iêmen
Jato da Marinha colide com apartamentos dos EUA, os pilotos ejetaram	nós. Jato da Marinha colide com prédios de apartamentos da Virgínia
As ações da China abrem na quarta -feira superior	Os estoques dos EUA abrem mais alto, apesar do PIB Miss
IDF para implantar a cúpula de ferro no centro de Israel	Principais barris de tempestade de neve nas planícies centrais
4 mortos em greve de drones nos EUA no Paquistão	nós. Drone Strike mata 3 no Paquistão
Adolescente dos EUA realizada em Chicago 'Jihad' Carroba Bomba	Teen
PC David Rathband: os medos do irmão gêmeo por seu 'melhor companheiro'	David Miliband: Meu irmão e um retorno ao trabalho antigo
As forças sírias se movem para retomar Aleppo	As ofertas do regime sírio para retomar a cidade de Aleppo
A equipe de comércio parlamentar de 20 membros sai para a Índia	Secretário de Comércio para se despedir
Sly Stallone Sone Sage encontrado morto em LA	O filho de Sylvester Stallone encontrou morto em casa
Wall Street abre mais baixo	Wall Street termina misturada
Clinton: EUA, Europa deve fazer mais contra tiranos	Clinton: EUA, a Europa deve trabalhar para derrotar os tiranos
A Europa compartilha o salto à medida que mais estímulos da China vistos	Os preços do petróleo aumentam na esperança de estímulo
As forças sírias ultrapassam a fortaleza rebelde	Exército da Síria toma fortalezas rebeldes do norte
O índice de estoque futuro aponta para o início mais baixo	Índice de ações Futuros sinalizam perdas precoces
Homem acusado depois que o deputado feriu no ataque	Homem acusado de assassinato no apartamento
As ações chinesas fecham o meio -dia mais alto de sexta -feira	As ações chinesas abrem na sexta -feira inferior
Nokia pede desculpas pelo anúncio 'fingido'	Nós renunciam aos ciclistas para a Aid Pak
A greve dos drones nos EUA mata 5 militantes no Paquistão	Drone Strike mata quatro suspeitos de militantes no Paquistão
Os rebeldes da Síria deixam Homs sitiados	Rebelos sírios Retiro do distrito de Homs sitiado
nós. Ordens funcionários não essenciais para deixar o Sudão, Tunísia	EUA ordens funcionários não essenciais para deixar a Tunísia, Sudão
Mubarak do Egito	Mubarak do Egito em estado crítico
Sandy bate no nordeste; pelo menos 18 mortos, 7,4m sem energia	Leste dos EUA Tempestades deixam 2 mortos no VA. , 2 milhões sem poder
Romney, Obama Clash com impostos, economia no primeiro debate	Obama e Romney sobem o palco para o primeiro debate
Assad diz que os mercenários estão por trás da agitação da Síria	Assad nos acusa de alimentar a revolta síria
Putin declara a vitória no voto presidencial da Rússia	queixas na montagem eleitoral russa
O PM do Japão se dissolve o câmara baixa para eleição	Irã e poderes mundiais preparados para negociações nucleares
Dois mortos no novo ataque israelense a Gaza: Médicos	5 morrem em greves em Gaza, militantes barrajam Israel
Jato da Marinha colide com edifícios da Virgínia, ferindo seis	Jato da Marinha colide com apartamentos de Virginia, 9 feridos
Um soldado da OTAN morto em s. Afeganistão	Soldado britânico morto no sul do Afeganistão
A taxa de desemprego da Espanha atinge uma nova alta	As reivindicações de desemprego da Espanha atingiram a nova alta
A bomba na estrada mata 10 civis afegãos: Polícia	A bomba na estrada mata 5 policiais afegãos
Turquia luta contra jatos perto de borda	Turquia luta contra jatos para a fronteira síria
Supremo Tribunal para ouvir o caso da Lei de Direitos de Voto	Supremo Tribunal para ouvir o caso corporativo de direitos humanos
Dois morrem na violência da Síria depois que a ONU monitora a terra	Proibição de Doping de dois anos para Contador
Comentários do Presidente na Feira de Ciência da Casa Branca	o planejador presidencial - a Feira de Ciência da Casa Branca
Civil, desertor morto na Síria, diz ONG	Pistãos de pistolas na Síria matam três oficiais sírios: ONG
Malawi confirma a morte do presidente	Malawi confirma a morte do presidente Mutharika
Taiwan abalado por um forte terremoto	China balançou por terremotos gêmeos
Paul Tucker, do Banco da Inglaterra	O deputado do Banco da Inglaterra nega que a taxa de pedidos de pedidos
A Líbia adia a eleição da Assembléia para 7 de julho	A Líbia adia as eleições marcantes para 7 de julho
Red Cruz diz que a negociação parou para lutar na Síria para ajudar	CASA RED CRUZA CEASE CEASEFIR
Forças sírias atiram civis no ônibus	Forças sírias, rebeldes se chocam perto da Turquia
O Parlamento Alemão apoia esmagadoramente o acordo de resgate grego	Parlamento alemão endossa o resgate grego
atentados, confrontos continuam na Síria	atentados, confrontos como a oposição da Síria busca armas
Londres 2012 Cerimônia de abertura das Olimpíadas 'Para apresentar uma terra verde e agradável'	Londres 2012 Olimpíadas: Cerimônia de abertura para ser uma 'terra verde e agradável', diz Danny Boyle
As reformas da Birmânia trazem flexibilização dos EUA sanções	Ativistas da Birmânia dizem que vá devagar para aliviar as sanções
Usain Bolt ganha 200m - reação Steven Howard	Ganhos móveis do Facebook impulsionam o crescimento da receita: reação
Dezenas mortas no ataque do resort do Taliban	'Nome da polícia da Índia 3 iranianos no ataque da embaixada'
Rochas pesadas de luta leste da Síria antes da pesquisa	rochas pesadas de luta oriental na Síria - residentes
China Yuan enfraquece para 6.3282 contra USD na segunda -feira	China Yuan se retira para 6.2697 contra o USD Quinta -feira
7 mortos no tiroteio da escola cristã	5 feridos em tiroteio na escola de Ohio
Esquadrão anti-terror da Indonésia mata dois militantes suspeitos	Polícia da Indonésia dispara mortos suspeitos de militantes em Bali
Eleição dos EUA: Mitt Romney concede derrota quando Barack Obama vence o segundo mandato	Romney concede a eleição para Obama em telefonema
Os armênios votam nas eleições parlamentares	Vote parlamentar da Armênia Um teste para presidente
Paquistão bloqueia o Twitter sobre o material anti-islâmico	Paquistão bloqueia o Twitter sobre 'blasfêmia'
Annan para visitar refugiados sírios na Turquia na terça -feira	Annan para visitar refugiados sírios na Turquia antes do Irã
Chavez da Venezuela em Cuba para o 3º tratamento anticâncer	Líder venezuelano retornando a Cuba para tratamento
Sachin Tendulkar é jurado como senador indiano	MP Sachin Tendulkar diz não para o Govt Bungalow
Moradores perto de Gaza instruíram a ficar perto do abrigo	O ótimo dia de Best traz uma torcida nas Índias Ocidentais
Jato da Marinha colide com o prédio de apartamentos	nós. Jato da Marinha colide com prédios de apartamentos da Virgínia
Romney ganha grande na primária de Porto Rico	Romney ganha a Primária Illinois
Yahoo! Para nomear Mayer do Google como CEO: Relatório	Yahoo nomeia o Google Exec Mayer como CEO
Soldado dos EUA acusado de contratações de massacres afegãos	Soldado dos EUA acusado de matar civis afegãos identificados
6.0 Magnitude Quake atinge o norte da Itália: USGS	5.9 Quake de magnitude atinge Sunda Strait, Indonésia: USGS
Nós designa oficialmente a rede Haqqani como terroristas	nós designa a rede haqqani como terroristas
Corrida de automóvel: botão mais rápido na primeira prática da F1 do ano	O botão se possui melhor horário após o primeiro treino
Rangers votaram na Divisão Três	Rangers votaram na terceira divisão
Síria em CeaseFire Observadores chamam	O cessar -fogo sírio traz calma desconfortável
O prefeito de Newark salva o vizinho do fogo	O prefeito de Newark resgata o vizinho de Burning House
Spurs se vingam de Lakers, liderar o oeste	seqüestrar israelenses para libertar prisioneiros, dizem os líderes de Gaza
F1 protestos no Bahrein	Um dia de raiva no Bahrein
Bolsa de Valores de Nova York para reabrir quarta -feira	Dealbook: bolsas de valores preparam -se para abrir
O crescimento da CPI da China diminui para 1,8 PCT em julho	O crescimento da produção industrial da China diminui para 9,2 PCT em julho
Homs Mortar Fire mata 105	Homs ofensivo mata 200
Centenas de honra estudante morto em filmagem de Ohio	Funeral conjunto para vítima de tiro em Ohio
bombas no sul da Tailândia matam 5, ferida 50	bombas na Tailândia matam 14, ferida 340
Os legisladores dos EUA dão o próximo passo nas novas sanções do Irã	Os legisladores da Somália para votar em novo presidente
Barack Obama nos admite ter 'mais armas nucleares do que precisamos'	O atirador francês quer 'morrer com armas nas mãos'
2 foguetes atingidos na região de Eshkol; Sem ferimentos	10 foguetes em 20 minutos no Conselho Regional de Eshkol
Os trabalhadores deficientes 'traídos' protestam contra o fechamento de remação	Dia de maio marcado por protestos contra cortes de austeridade
Dr. Congo Rebels Kill Park Rangers	Os rebeldes matam dois guardas florestais do parque no leste do Congo
Nove tropas paquistanesas mortas em emboscada militante	Comércio: Paquistão, Índia concorda em dar um passo à frente
74 mortos na violência do futebol do Egito	Pelo menos 73 morrem na invasão de tom de futebol egípcio
A agitação na Nigéria tensa deixa pelo menos 95 mortos	Sudoeste da China Quakes Mate pelo menos 50
O furacão Sandy faz o solo no sudeste da Jamaica: NHC	O furacão Sandy chega à Jamaica
Os militantes de Gaza disparam 40 foguetes em Israel, 3 Hurt: Police	Gazans disparam quatro foguetes contra Israel; Sem ferimentos
Comentários com o primeiro -ministro Elkeib após a reunião	Comentários com o ministro das Relações Exteriores Koichiro Gemba
O Iraque lança suspeito de agente do Hezbollah procurado pelos EUA.	O Iraque disse para libertar o Hezbollah Operation
PM Paquistão chocado com o pessoal do exército de captura de avalanche	Avalanche do Paquistão: Resgatadores Pesquisar soldados enterrados
Barrick em conversas com a empresa da China sobre ativos africanos	O assessor de Obama mantém conversas na China depois da Síria veto