Era digital ameaça o futuro tênue dos drive-ins	Era digital ameaça o futuro dos drive-ins
Jessica Lal assassinato condenado Manu Sharma recebe liberdade condicional de 15 dias	Jessica assassinato Manu Sharma recebe liberdade condicional
ONU para manter conversas de emergência no Dr. Congo	un. Conselho para manter negociações de emergência ao Dr. Congo
Irã e IAEA retomam as negociações nucleares	Irã, IAEA retomar as negociações nucleares em Teerã
Os manifestantes tailandeses tempestadem sede do exército	Os manifestantes tailandeses assumiam a sede do Exército Real em Bangkok
40 ainda faltando no trem de petróleo do Canadá mortal ...	40 ainda faltando no acidente de trem de petróleo no Canadá mortal
Raghuram Rajan para entrar no olho da tempestade de rupias	Raghuram Rajan para entrar no olho da tempestade de rupia como rbinbspguv amanhã
Ministério das Relações Exteriores do Irã para liderar negociações nucleares	Ministro das Relações Exteriores do Irã encarregado de negociações nucleares
De Blasio jurou como prefeito de Nova York, sucedendo a Bloomberg	Bill de Blasio jurou como prefeito de Nova York, sucedendo Michael Bloomberg
EUA pressionamos o Iraque em relatórios de armas lidam com o Irã	Os Estados Unidos pressionam o Iraque em relatos de armas lidam com o Irã
Narendra Modi nomeou PM, jurando em 26 de maio	Modi nomeou PM, jurando em 26 de maio
Minn. O homem reivindica a participação de US $ 448 milhões em Powerball Jackpot	Minn. Papai reivindica o terço do jackpot de US $ 448 milhões
O motorista volta para o carrinho com o filho, afasta	O motorista de volta para a mãe, carrinho com criança e depois afasta
George Zimmerman preso após a chamada de perturbação	George Zimmerman preso na Flórida após a chamada de perturbação
Halliburton se declara culpado de destruir evidências de derramamento do Golfo	Derramamento de óleo do Golfo do México: Halliburton se declara culpado de destruir evidências
A Princesa Espanha testemunha na sonda de fraude histórica	A Princesa Espanha testemunha na sonda de fraude histórica
Mais corpos MH17 deixam a Ucrânia	Mais corpos do vôo MH17 deixam a Ucrânia
Lewis Hamilton segura Nico Rosberg no emocionante Grande Prêmio Espanhol	Lewis Hamilton detém Nico Rosberg para reivindicar o Grande Prêmio Espanhol
Acordo de alcance dos EUA-Rússia na Síria	Acordo de alcance dos EUA-Rússia sobre armas da Síria
TSA diminui o esforço para permitir pequenas facas em aviões	TSA Drops planeja permitir pequenas facas em aviões
Snowden sai do aeroporto de Moscou	Edward Snowden sai do aeroporto de Moscou
Os apoiadores de Morsi se reúnem no Egito, o exército mostra músculos	Os apoiadores de Mursi se reúnem no Egito, o exército mostra músculos
As ações dos EUA atingem relatórios econômicos positivos	As ações são mais altas após relatórios econômicos positivos
Bachelet definido para uma grande vitória no confronto da pesquisa de duas mulheres	Bachelet definido para uma grande vitória no confronto da pesquisa de 2 mulheres do Chile
Coréia do Norte propõe conversas de alto nível conosco	A Coréia do Norte oferece 'palestras de alto nível' conosco
O Senado confirma o candidato a Obama ao Tribunal de Apelações -Chave	O Senado aprova o candidato a Obama ao Tribunal de Apelações -Chave
Bangladesh sentenças britânicas, cidadãos americanos para pendurar	Bangladesh sentenças muçulmanas e cidadãos britânicos para pendurar
N Coréia lança três mísseis guiados de curto alcance	Coréia do Norte lança três mísseis de curto alcance
Obama começa a viagem na África no Senegal	Obama começa a turnê na África no Senegal
Beverly Hills exige Brunei Sultan Sell Hotel	Protestos como Beverly Hills exige Brunei Sultan Sell Hotel
A Grã -Bretanha pretende ser o primeiro país ocidental para emitir um vínculo islâmico	Grã -Bretanha para ser o primeiro país ocidental a emitir um vínculo islâmico soberano
A tia de Angelina Jolie morre de câncer de mama	A tia de Angelina Jolie morre de câncer de mama
Proprietários de colapso da fábrica de Bangladesh presos	Proprietários de fábrica de Bangladesh presos
Apple arquivos para a marca 'iwatch'	Apple arquivos para a marca registrada 'iwatch' no Japão
Palavra cruzada rápida - sexta -feira 31 de maio	Palavra cruzada clássica - sexta -feira 31 de maio
Assad diz que a Síria permitirá o acesso a locais químicos	Assad: a Síria permitirá o acesso a locais químicos
Maple Leafs Top Canadiens para a 4ª vitória consecutiva	Maple Leafs Edge Canadiens para a 4ª vitória consecutiva
Benetton, novos varejistas para assinar o Pacto de Segurança de Bangladesh	Benetton concorda em assinar o Pacto de Segurança de Bangladesh
Rolf Harris acusado de crimes sexuais infantis	Harris acusado de 13 crimes infantis-sexos
Abdullah Abdullah aumenta a liderança na votação presidencial afegã	Abdullah aumenta a liderança na pesquisa presidencial afegã
7.2 Quake atinge as Filipinas Centrais, matando 6	7.2 Quake atinge as Filipinas Centrais, matando 85
Israel 'retoma a ofensiva de Gaza'	Exército israelense retoma a ofensiva de Gaza
Berlusconi expulso do Senado italiano	Berlusconi expulso do parlamento italiano
Israel dispara pelo foguete perto da fronteira do Egito	Rocket de Israel Downs, perto da fronteira do Egito
un. O chefe de direitos pressiona o Egito na detenção de Mursi	O chefe de direitos da ONU pressiona o Egito na detenção de Morsi
'Fast & amp; A estrela furiosa Paul Walker morre em acidente de carro	'Fast & amp; A estrela furiosa morre em acidente de carro
Obama diz que está se divertindo em férias	Obama diz que está se divertindo em férias
O vazamento de amônia líquida mata 15 em Xangai	O vazamento de amônia mata 15 em Xangai
Os organizadores de manifestação de Hong Kong presos	Os organizadores de manifestação da democracia de Hong Kong presos
Ministros das Relações Exteriores da UE para discutir a violência do Egito	Ministros das Relações Exteriores da UE para discutir o Egito na quarta -feira
O Google concorda em vender Motorola para Lenovo	Google preparou para vender Motorola para Lenovo
Pontuações mortas, 1.000 feridos no terremoto da China	Dezenas mortas, 1.000 feridos no terremoto da China
O Senado dos EUA confirma Janet Yellen como chefe do Federal Reserve dos EUA	O Senado confirma Janet Yellen como o próximo Federal Reserve Presidente
Smog pesado atinge o norte da cidade da China, os vôos cancelados	Smog pesado atinge o norte da cidade da China, os vôos cancelados
bombas e batalha de armas matam pelo menos 16 na capital somali	bombas e pistolas matam pelo menos 4 na capital somali
O Conselho de Direitos da ONU lança sonda de crimes de guerra do Sri Lanka	un. O Conselho de Direitos lança sonda de crimes de guerra do Sri Lanka
Royalties de mineração do noroeste mal utilizado, diz o relatório de inquérito	Royalties de mineração do noroeste mal utilizado - Relatório
Grupos rebeldes sírios se enfrentam no norte	Grupos rebeldes sírios se enfrentam no norte
Papa Francisco para fazer a primeira visita à Terra Santa	O papa Francisco anuncia a primeira visita à Terra Santa
Chemicals Welddog OPCW ganha o Prêmio Nobel da Paz	O Watchdog de armas químicas ganha o Prêmio Nobel da Paz
Os lucros da Heineken H1 caem em volumes de vendas mais baixos	Os lucros da Heineken caem em vendas mais baixas
ONU para votar na resolução do MH17	Vote da ONU na resolução de Aust MH17
Nelson Mandela morre com 95 novos	Nelson Mandela morre aos 95 anos
Mayawati exige o governo do presidente na Caxemira	Mayawati exige que os presidentes governam em Jammu e Caxemira
Palavra cruzada do teste - sexta -feira 31 de maio	Palavra cruzada enigmática - sexta -feira 31 de maio
O Egito proíbe a Irmandade Muçulmana	Tribunal Egípcio proíbe a Irmandade Muçulmana
Tóquio ganha correr para sediar os Jogos Olímpicos de 2020	Tóquio para sediar os Jogos Olímpicos de 2020
O presidente de Uganda assina a conta anti-gay	O presidente de Uganda assina duras leis anti-gays
Manchester City Win Premier League Título	Manchester City vence o título da Premier League inglês
A tia de Angelina Jolie morre de câncer de mama	A tia de Angelina Jolie morre de câncer de mama
pedras, gás lacrimogêneo voam enquanto os protestos tailandeses esquentam	pedras, gás lacrimogêneo voam enquanto os protestos tailandeses esquentam
Suspeito de bombardeio de Boston enterrado na Virgínia	Suspeito de bomba de Boston enterrado no cemitério da Virgínia
Suspeito de bombardeio de Boston enterrado na Virgínia	Suspeito de bomba de maratona de Boston enterrado na Virgínia
Irã e contrato de assinatura da ONU sobre assistência na Síria	Irã e ONU discutem acordo sobre assistência na Síria
un. Os inspetores chegam a Damasco em busca de armas químicas	Os inspetores da ONU chegam em Damasco na investigação química
Obama cancela Moscou reunião com Putin	Obama cancelou a reunião com Putin
Seis mortos no restaurante filipino explosão	6 mortos na explosão do restaurante das Filipinas
O Egito 'congela os ativos da Irmandade Muçulmana'	Egito congela fundos da Irmandade Muçulmana
homem preso do lado de fora da casa de John Kerry em nós	Homem preso do lado de fora da casa de John Kerry na missa.
Bryan Cranston retornará como Walter White para Breaking Bad Spin Off, Relatório Reclações	Bryan Cranston para voltar como Walter White para Breaking Bad Spin Off
Seis membros do partido da oposição cambojana acusados ​​de insurreição	Seis políticos da oposição cambojana acusados ​​de insurreição
Jornal do Exército da China atinge o programa de prisma dos EUA	Jornal do Exército da China bate o Programa de Prisma dos EUA
Silvio Berlusconi expulso do parlamento da Itália	Silvio Berlusconi expulso do Parlamento
Tóquio para sediar os Jogos Olímpicos de 2020	Tóquio para hospedar 2020 jogos
Votação da Câmara Alta do Japão para estabelecer o poder do Bloc.	Votação da Câmara Alta do Japão para estabelecer o poder do Bloc.
Líderes da EDL presos durante março a Woolwich	Líderes da EDL presos a caminho de Woolwich
Grave em massa fora da Cidade do México	Sepultura em massa encontrada perto da Cidade do México
As esperanças de Snowden de deixar o aeroporto tracejadas	As esperanças de Fugitive Snowden de deixar o aeroporto de Moscou tracejadas
AirAsia X espera arrecadar até US $ 372 milhões de IPO	O chefe da AirAsia espera arrecadar até US $ 300 milhões de IPO
Obama assina Bill destinado a bloquear o enviado da ONU do Irã	Obama assina a lei que visa impedir o enviado do Irã da ONU
Toll de morte do Egito Violência Política sobe para 421	Toll de morte da violência do Egito aumenta para 525
Primeiro Ministro da Tailândia para dissolver o Parlamento	Primeiro Ministro da Tailândia dissolve o parlamento
Michael Schumacher está em uma condição estável - de acordo com sua gerente Sabine Kehm	Michael Schumacher está em uma condição estável no hospital - de acordo com seu gerente
Polícia Turca Storm Taksim Square	Polícia turca limpa Taksim Square
O líder conservador Abbott espera vencer a eleição da Austrália	O líder conservador Abbott varre o poder nas eleições australianas
Karzai diz que o Afeganistão não será uma repetição do Iraque	Karzai diz que o Afeganistão não será uma repetição do Iraque
Wing Walker Pilot Die in Crash no US Air Show	Wing Walker, Pilot Die in Biplane Crash no Ohio Air Show
Vídeos de abuso infantil serão limpos da web	imagens de abuso infantil a serem limpadas da web
Mandela colocou para descansar	Nelson Mandela colocou para descansar
Senador do Texas ainda Filibustering Abortion Bill	O senador do Texas Filibusters contra a conta do aborto
RFK Killer mudou -se para a nova prisão no aniversário do assassinato de JFK	RFK Killer Sirhan Sirhan se mudou para outra prisão - no aniversário do assassinato de JFK
Austrália retorna os requerentes de asilo ao Sri Lanka	Austrália retorna os requerentes de asilo ao Sri Lanka na transferência do mar
Capitólio dos EUA em Washington em bloqueio após tiros disparados	US CAPITOL HILL ON LOCKDOWN depois que os tiros dispararam
dois mortos na explosão do carro do Bahrein	Dois mortos na explosão do carro do Bahrein
O Watchdog de armas químicas ganha o Prêmio Nobel da Paz	Global Chemical Watchdog ganha o Prêmio Nobel da Paz
Tempestade tropical Andrea indo para o norte da Flórida	Tempestade tropical Andrea abaixando -se na Flórida
A Síria foi entregue a última das armas químicas declaradas, diz Monitor	Watchdog: Síria as mãos sobre o último de suas armas químicas declaradas
O Sisi do Egito jurou como presidente	El-Sissi, do Egito, jurou como presidente
Ref, perfurados por jogadores morre	O árbitro de futebol deu um soco pelo jogador em Utah Dies
Ucrânia diz que os insurgentes atacam guardas de fronteira	Crise da Ucrânia: os insurgentes atacam guardas de fronteira
Carros-bomba suicídicos mata 30 em Bagdá-Police, médicos	carro -bomba suicida mata 30 no café de Bagdá
Obama pressiona os republicanos a aumentar o teto da dívida, desligamento final	Obama pressiona os republicanos a aumentar o teto da dívida
Coréia do Norte para reiniciar o reator nuclear de Yongbyon	A Coréia do Norte diz para reiniciar o reator nuclear
O principal juiz Mansour jurou como presidente interino do Egito	Justiça Adly Mansour jurou como presidente interino do Egito
O ator britânico Bob Hoskins morre aos 71	O ator Bob Hoskins morre aos 71
Maduro Promessa da Venezuela continuou a Aliança com Cuba	Maduro Promessa da Venezuela continuou a Aliança com Cuba
Obama suores sobre os suéteres durante a parada de compras de Nova York	Os presidente dos EUA suam suéters durante a parada de compras de Nova York
as ações aumentam após a saída do verão, as saídas alimentadas	ações, títulos com manifestação após o verão saídas de corrida alimentada
Trayvon poderia ter sido eu	Trayvon Martin poderia ter sido ...
Python mata o guarda de segurança perto de Bali Luxury Hotel	Python mata o guarda de segurança em Bali
Obama para conhecer o líder coreano de S	Obama para conhecer líder sul -coreano
A Rússia alerta que responderá se os interesses atacados na Ucrânia	A Rússia alerta que "responderá" se os interesses na Ucrânia atacaram
O renomado guitarrista espanhol de flamenco Paco de Lucia morre	O guitarrista de flamenco espanhol Paco de Lucia morre aos 66
O rei belga Albert II para renunciar a favor do filho	O rei belga Albert II para abdicar em favor de seu filho
Bomber de caminhão suicida mata 11 no norte do Iraque	Bomber suicida mata 15 no norte do Iraque
Bomber suicida mata 15 na Somália Central	Bomber suicida mata 13 no restaurante no centro da Somália
Centenas evacuadas como o vulcão da Indonésia entra em erupção	Centenas evacuadas como o vulcão de Sumatra entra em erupção
Última tempestade traz mais neve para a costa leste dos EUA	Última tempestade para trazer mais neve para a costa leste
Ajuda chega às Filipinas sobreviventes do Typhoon	Aid empurra para os sobreviventes das Typhoon das Filipinas
NTU cai para 82º no ranking da World University	NTU desliza no ranking da World University
A multidão budista ataca a mesquita no Sri Lanka, 7 feridos	A mob budista ataca a mesquita na capital do Sri Lanka
aluno que usava facões destinados a carnificina	estudante que usava facões apontados para carnificina em massa no Colorado
Bangladesh Building Death Toll Tops 500	Bangladesh Building Desastre O número de mortos passa 500
O homem se pega fogo no National Mall	Homem incendiado no National Mall
O novo julgamento de Hosni Mubarak foi adiado até 8 de junho	Recupela de Mubarak encerrado para junho
A Greve dos Drones dos EUA mata oito no Waziristão	Greve de drones nos EUA mata 11 no Paquistão
O líder da Austrália demitiu o voto de liderança SNAP	O primeiro -ministro australiano Gillard demitiu a votação de liderança
Manila acusa chinês no acidente de recife	Manila acusa os pescadores da China por acidente de recife
Israel realiza teste de míssil de rotina no Mediterrâneo	Israel diz que conduziu testes de mísseis no Mediterrâneo
Suspeito de bombardeio de maratona de Boston enterrado na Virgínia	Suspeito de bombardeio de Boston enterrado no cemitério da Virgínia
Bangladesh Tribunal sentenças 152 guardas de fronteira até a morte de 2009 Motiny	Bangladesh Court sentenças 152 soldados até a morte em motim
Os manifestantes se reúnem no Brasil, apesar das concessões	protestos varrem o Brasil, apesar da concessão
Os manifestantes do Egito desafiam a ameaça do gabinete de acabar	Os manifestantes do Egito desafiam a ameaça do gabinete
'Fast & amp; A estrela do furiosa Paul Walker morre em acidente de carro aos 40	'Fast & amp; A estrela furiosa morre em acidente de carro
bombas de carro matam 20 na cidade turca perto da fronteira síria	Bombas de carro matam quatro na cidade turca na fronteira síria
O ator vencedor do Oscar Philip Seymour Hoffman encontrou morto	O ator Philip Seymour Hoffman encontrou morto
A Turquia poderia implantar o exército para reprimir protestos	A Turquia pode implantar o Exército para encerrar protestos
Dame Vivienne Westwood se junta a manifestantes fracking	Vivienne Westwood se junta ao protesto de Balcombe Fracking
sen. Mark Kirk anuncia apoio ao casamento entre pessoas do mesmo sexo	Sen do Partido Republicano. Kirk anuncia apoio ao casamento gay
casal se casar no primeiro casamento do Reino Unido Scientology	casal se casará no primeiro casamento da Grã -Bretanha Scientology
A China lança missão espacial mais antiga de todos os tempos	Cápsula Shenzhou-10: a China lança missão espacial tripulada de 15 dias
O Reino Unido 'pagou um preço muito alto' no Afeganistão, diz David Cameron	PM: UK "pagou um preço muito alto" no Afeganistão
líder da oposição russa em prisão domiciliar	Líder da oposição russa colocada em prisão domiciliar
duas explosões na maratona de Boston	Duas explosões na linha de chegada da Maratona de Boston
O Senado confirma Janet Yellen como presidente do Federal Reserve dos EUA	O Senado confirma Janet Yellen como o próximo Federal Reserve Presidente
A oposição da Síria concorda em negociações	A oposição síria concorda com as negociações de paz de Genebra
Clegg e Farage são "bastante extremos" sobre a Europa, diz Cameron	Clegg e Farage são extremistas na Europa, diz Cameron
Asiana Airlines Boeing 777 acidentes em pouso no aeroporto de São Francisco	Boeing 777 acidentes enquanto aterrissam no aeroporto de São Francisco
O Tribunal da Suécia defende o mandado de prisão para o fundador do WikiLeaks, Julian Assange	Tribunal sueco defende o mandado de prisão para Julian Assange
O presidente de Uganda assina a conta anti-gay	Presidente de Uganda para assinar uma lei anti-homossexualidade
O Emir do Catar entrega o poder ao seu filho	Qatari Emir entrega o poder do filho Tamim
Carlo Ancelotti chamado Real Madrid Boss	Ancelotti chamado Real Madrid Coach
Facilitar as preocupações sobre a Síria aumenta as ações globais	Facilitar as preocupações sobre as ações asiáticas da Síria aumentam
Filipinas Typhoon Death Toll temia ter atingido 7.000	Filipinas Typhoon Death Toll sobe acima de 5.000
Egito aparece para 'sexta -feira de raiva' após carnificina	Egito aparece para sexta -feira de raiva após repressão sangrenta
Mergulhadores encontram restos humanos no local da destruição de navio de cruzeiro da Itália	Mergulhadores encontram restos humanos perto de naufrágio italiano
Nelson Mandela sai do Hospital após 10 dias	Mandela sai do hospital após 10 dias
Mobile Home Fire mata homem, 5 crianças em Ohio	Polícia: Ohio Mobile Home Fire mata homem, 5 crianças
político japonês preso na China por acusações de drogas	político japonês preso na China por transportar drogas
O descarrilamento do trem de Nova York mata quatro, ferimentos 70	O acidente de trem de Nova York mata quatro, machuca dezenas
Red Sox Beat Tigers 5-2 para avançar para a World Series	Red Sox venceu os tigres para alcançar a World Series
Nações africanas pressionam a ONU. Conselho de Segurança para suspender o caso do Quênia	Nações Africanas Pressione o Conselho da ONU para suspender o caso do Quênia
A Microsoft anuncia 18.000 cortes de empregos em reorganização	Microsoft para cortar 18.000 empregos em grande reorganização
Mais de 1.000 presos escapam da prisão da Líbia	Mais de 1.000 presos escapam da prisão de Al-Kweifiya da Líbia
Casal holandês sequestrado no Iêmen apelos para liberação	casal holandês sequestrado no Iêmen implorando para obter ajuda no vídeo
China aterre o robô de coelho jade rover na lua	China Lands Robot Rover na lua
O avião da Malaysia Airlines 'abatido' na Ucrânia	avião da Malásia abatido sobre a Ucrânia
Filipinas recebe seu 100 milionésimo cidadão	Filipinas dá as boas -vindas a 100million bebê
Embaixada dos EUA em Israel comemora o quarto de julho	Embaixada dos EUA em Israel Marks 4 de julho
CEO da Microsoft Ballmer para se aposentar em um ano	CEO da Microsoft Ballmer para se aposentar dentro de 12 meses
Os manifestantes comemoram na praça de Istambul	Os manifestantes comemoram após a partida da polícia Istambul Square
37 faltando, dois mortos depois que o barco afunda da Malásia	dezenas de falta após o barco afundam da Malásia
Obama ataca a Coréia do Norte como estado de Pariah	Obama ataca a Coréia do Norte como um estado de pária fraco
Manning diz que é mulher, quer viver como mulher	Bradley Manning diz que quer viver como mulher
O ex -promotor -general da Líbia morto a tiros	O primeiro promotor-general pós-prisioneiro da Líbia morto a tiros
Mais soldados franceses para a República da África Central	França para enviar mais soldados para a República Central da África
Hagel diz que os EUA ainda busca a coalizão internacional da Síria	nós para procurar coalizão internacional sobre a Síria
Phil Mickelson vence o British Open com uma excelente rodada final	Phil Mickelson vence o Campeonato Open com a excelente rodada final 66
Os proprietários de fábricas de vestuário de Bangladesh se rendem ao tribunal por acusações de homicídio	Os proprietários de fábricas de vestuário de Bangladesh se rendem ao fogo mortal
James Gandolfini morre com 51 anos	Estrela de Sopranos James Gandolfini morre com 51 anos
Bangladesh colapso da morte Passa 620	Bangladesh Building Death Toll Pass 600
petkovic, halep em semifinais francesos abertos	Petkovic, Halep Reach French Open Semifinals
O Parlamento Ucraniano rejeita o presidente	O Parlamento da Ucrânia vota para demitir presidente
Os legisladores da Venezuela brigam em meio a tensões eleitorais	Os legisladores da Venezuela brigam sobre a eleição
Ciclone Folhas Trilha de destruição na Índia	Ciclone Phailin Leaves Trail of Destruction
O líder do Hezbollah promete continuar a Síria	O líder do Hezbollah promete lutar na Síria
Israel PM diz que o solo ofensivo em Gaza está em andamento	Israel inicia ofensivo terrestre em Gaza
O FMI aprova o empréstimo de US $ 17 bilhões para a Ucrânia	O FMI aprova 17 bilhões de dólares para a Ucrânia
A Coréia do Norte alerta estrangeiros no sul, aconselhando a evacuação	A Coréia do Norte alerta estrangeiros no sul para evacuar
O voto do aborto atrasado em meio ao debate os políticos irlandeses passarão um segundo dia debatendo as leis divisivas que legislarão pela primeira vez para o aborto em circunstâncias limitadas.	Lei do aborto: Segunda noite de debate nos novos políticos irlandes
Israel volta depois de Rockets disparados do Líbano	Israel retalia depois que vários foguetes disparados do Líbano
Capitão da balsa sul -coreana afundada presa	Capitão da balsa coreana de capsurizada presa
Quatro mortos no tiroteio do Navy Yard	Pelo menos 6 mortos no tiroteio no pátio da marinha
Everest Avalanche mata seis sherpas	Everest Avalanche mata 12 guias
Confrontos sectários no norte da cidade libanesa matam 8	Líbano: confrontos sectários em Northern City Kill 9
Chefe do Taliban morto no Paquistão Drone Strike	Chefe do Talibã Paquistão morto em Drone Strike
Berlusconi expulso do Senado italiano	Silvio Berlusconi expulso do Parlamento
Obama para tocar o prefeito de Charlotte para executar o transporte	Obama taps Foxx - NC Mayor - para executar o transporte
Ferry afunda em colisão nas Filipinas; 24 mortos	O navio afunda após a colisão das Filipinas; 24 mortos
Dividiu os debates da oposição da Síria que ingressam em negociações de paz	A oposição da Síria vota para ingressar em negociações de paz
Filha diz que Mick Jagger é bisavô	Sir Mick Jagger 'para se tornar bisavô'
INTERPOL PROBLEMA AVISO DE PRIMENTO PARA 'Viúva branca'	Samantha Lewthwaite: Interpol emite mandado de prisão global para viúva branca
nós. Mulher se declara culpada de matar 2 turistas de Ontário	A mulher da Filadélfia se declara culpada de matar 2 turistas canadenses
Obamas para participar de Mandela Memorial em Joanesburgo	Obama para participar do serviço memorial em Joanesburgo
Paquistão liberando mais 7 prisioneiros do Taliban	Paquistão lança sete prisioneiros do Taliban
A California Wildfire se espalha para o Parque Nacional de Yosemite	O fogo selvagem em movimento rápido se espalha para o Parque Nacional de Yosemite
A Coréia do Norte lança missionário australiano	A Coréia do Norte diz que deportará missionário australiano
Carros, motoristas mergulham no rio após a lavagem. I-5 colapso da ponte	Os carros mergulham no rio enquanto a ponte americana cai
A NFL busca US $ 1,5 milhão de M.I.A. sobre o dedo do Super Bowl	A NFL procura US $ 1,5 milhão sobre o dedo do Super Bowl
4 sauditas mantidas sobre bombardeio na Tanzânia	sauditas mantidas sobre o ataque da Tanzânia
Obama cancelou a reunião com Putin	Obama cancela as reuniões com Putin em meio a tensões
Israel confirma greve sobre armas direcionadas à Síria	Oficiais de Israel: greve sobre armas direcionadas à Síria
Índias Ocidentais Bom demais para Bangladesh	Twenty20 Copa do Mundo: Índias Ocidentais Rout Bangladesh
'Trayvon poderia ter sido eu'	Trayvon Martin poderia ter sido ...
Os preços mínimos de álcool salvariam 860 vidas por ano, o estudo encontra	Preços mínimos de álcool 'salvarão 860 vidas por ano', afirmam especialistas
O presidente eleito do Irã chama Israel a 'ferida' no mundo muçulmano	O presidente eleito do Irã chama Israel de 'ferida'
Margaret Thatcher morre de derrame com 87 anos	Margaret Thatcher morto após derrame
O número de mortos na Síria agora está no topo de 100.000	Toll de morte na Síria mais de 100.000 até agora
Os bombeiros perecem no Arizona Blaza	19 bombeiros mortos no Blaze Arizona
A França deporta a Tunísia acusada de recrutamento jihadista para a Síria	A França deporta a Tunísia suspeita de recrutar jihadistas para a Síria
Dois membros da banda punk de pussy riot prendidos em Sochi	2 banda de pussy tumultuada presa em Sochi
Adele nomeou mais rico jovem músico	Adele nomeou mais jovem músico com £ 45 milhões
A tempestade tropical Andrea se aproxima da FLA. Costa do Golfo	A tempestade tropical Andrea encrega a costa oeste da Flórida
ONU convida o Irã para as negociações de paz na Síria	ONU retira o convite do Irã para as negociações de paz na Síria
Presidente afegão atrasa a assinatura do acordo conosco	Presidente afegão atrasa a assinatura dos EUA
Novos acertos fortes do terremoto quebraram a região de Pak	poderosos novos acertos de terremoto quebraram a região do Paquistão
Drone Strike mata al-Shabab Militant na Somália	Greve dos EUA mata 2 militantes seniores al-Shabaab na Somália
Bezos da Amazon resgatou pela Marinha Equadora	Bezos da Amazon resgatou pela Marinha do Equador devido à pedra dos rins
Capitão da balsa sul -coreana afundada presa	Capitão, tripulação de balsa sul -coreana que afastou preso
A Alemanha esmaga o Brasil na semifinal da Copa do Mundo	Alemanha Crush Brasil 7-1 para chegar à final da Copa do Mundo
Rebeldes comunistas emboscam a polícia filipina, mate 7	rebeldes comunistas matam oito policiais filipinos
O Morsi do Egito enfrenta julgamento por interrupção da prisão, assassinato, diz a acusação	O Morsi do Egito enfrenta julgamento para o intervalo da prisão
As negociações nucleares do Irã entram no terceiro dia	As negociações nucleares do Irã entram no terceiro dia crucial
pelo menos 22 mortos após o terremoto da China	Pelo menos 89 mortos na China terremotos
Os jurados consideram Jodi Arias elegível para pena de morte	Jodi Arias elegível para pena de morte, diz o júri
EUA pedem à Coréia do Norte que liberte o detido	nós. pede que a Coréia do Norte libere o veterano de guerra de 85 anos
Polícia de tumulto turco muda -se para Taksim Square - Atualizações ao vivo	Polícia de tumultos turcos entra na praça Taksim
O chefe de balé de Bolshoi confronta suposto atacante no tribunal	O diretor de Bolshoi, Sergei Filin
ASIANA JET CRASC Lands no aeroporto de São Francisco	O avião mortal cai no aeroporto de São Francisco
A autora lendária Maya Angelou morre aos 86 anos	Maya Angelou morre aos 86 anos
Hollande 'ameaça a ação legal' após as alegações de caso	François Hollande ameaça a ação legal sobre as reivindicações de caso
Hong Kong preparado para uma grande manifestação de democracia no aniversário de entrega	Hong Kong preparado para uma grande manifestação de democracia
Hosni Mubarak do Egito será libertado em breve	Hosni Mubarak, do Egito, libertado da prisão
O ator britânico Bob Hoskins morre aos 71	ator Bob Hoskins morto aos 71
Os inspetores da ONU Síria vão para o suposto local de ataque químico	Os inspetores da ONU visitam o suposto local de ataque químico
Exército tailandês declara a lei marcial	O Exército da Tailândia declara a lei marcial, nega golpe
O trabalho de demolição começa no Don Valley Stadium	Demolição trabalha para começar no estádio
Dois mortos após o Boeing 777 Crash terras no aeroporto de São Francisco	Crash de avião terras no aeroporto de São Francisco
ações mais altas ao meio -dia à medida que a Black Friday se desenrola	As ações terminam misturadas à medida que a Black Friday se desenrola
Explosão na cidade paquistanesa de Peshawar mata 14	explosão na cidade de Quetta paquistanesa mata pelo menos 20
Nibali Seals Tour de France vitória	Nibali pronto para a Glória do Tour de France
Mulher morre enquanto monta montanha -russa no Texas	Mulher morre montando montanha -russa no Texas Amusement Park
Trabalhador de petróleo escocês morto a tiros no Brasil	Trabalhador britânico de petróleo morto no Brasil
Jos. um. Banco compra Eddie Bauer	Jos. um. Banco comprando Eddie Bauer em negócios de US $ 825 milhões
O chefe do Brasil Luiz Felipe Scolari apoia a Inglaterra para impressionar na Copa do Mundo de 2014	Scolari apoia a Inglaterra para impressionar na Copa do Mundo
O autor Nobel Doris Lessing morre aos 94	O autor vencedor do Prêmio Nobel Doris Lessing Dies
Mulher britânica morre em caridade transversal nadar	Mulher morre no canal de caridade nadar
31 mortos, 90 feridos no bombardeio do mercado da China	Dezenas mortas no bombardeio do mercado da China
Mais de 100 mortos enquanto o tufão bate as Filipinas Centrais	Pelo menos 100 mortos como tufões de batedores das Filipinas
Siemens Boss para pedir para deixar firme após resultados ruins	O chefe da Siemens, Peter Loescher, para ir após resultados ruins
Rafael Nadal vence Novak Djokovic para ganhar o nono título do Aberto da França	LIVO Aberto da França: Rafael Nadal vence Novak Djokovic na final
Primeiro Banco de poupança dos correios	O primeiro banco de poupança dos correios da Índia é inaugurado em Chennai
Israel concorda com o cessar -fogo de 12 horas	Israel concorda com a trégua de Gaza de 24 horas
Relatórios do Twitter bloqueando na Venezuela	Twitter diz imagens bloqueadas na Venezuela
Sen do Partido Republicano. Mark Kirk apóia o casamento entre pessoas do mesmo sexo	sen. Mark Kirk anuncia apoio ao casamento entre pessoas do mesmo sexo
Blaze do Novo México em movimento rápido causa evacuações	Blaze do Novo México em movimento rápido causa ...
O terremoto de 6.2 magnitude atinge a Sumatra da Indonésia - USGS	Terremoto de 6,9 ​​magnitude atinge a Ilha da Indonésia
Kerry diz dobrar os EUA ajuda não letal à oposição síria	EUA comprometidos em fornecer ajuda não letal à oposição da Síria
Mubarak do Egito para ser libertado da prisão, diz o advogado	Hosni Mubarak será libertado em poucos dias, diz o advogado
G7 líderes para "se mover rapidamente" para impor novas sanções contra a Rússia	Os líderes do G7 concordam com novas sanções contra a Rússia
A oposição síria quer o apoio rebelde para as negociações de Genebra	A oposição síria busca a bênção dos rebeldes para entrar em negociações de paz
A Suprema Corte dos EUA limita o poder do recesso do presidente	O Supremo Tribunal verifica o poder do recesso do presidente
Strongman Sisi jurou como presidente do Egito	Abdel Fattah al-Sisi jurou como presidente do Egito
Três mantidos sobre atividade republicana dissidente	três presos em investigação republicana dissidente
Obama elogia a 'inspiração' de Mandela	Obama é o efeito de inspiração de Mandela
China transmira a confissão por blogueiro detido em meio a repressão a boatos on -line	China transmita confissão por blogueiro detido
Três mulheres desaparecidas por uma década encontradas vivas em Cleveland Home	Três mulheres, desaparecidas por anos, encontradas em casa
O dublê britânico caiu até a morte no acidente com traje de asa	O dublê britânico morre em acidente de wingsuit em Alpes
Dies criminosos nazistas em 100	matrizes criminais nazistas
Rolf Harris enfrenta mais três cobranças de agressão	Harris enfrenta três novas acusações de agressão sexual
um morto, oito faltando depois que os navios colidem fora do Japão	Oito faltando depois que os navios colidem
Deutsche Telekom lucro, vê se recuperar em nós	Deutsche Telekom lucro, corta as perspectivas
Treina da Tailândia para o sul interrompida por suspeita de bomba	trens sul parados por suspeita de bomba
Escândalo de empréstimos Yakuza reivindica o segundo credor	Scandal de empréstimos da MOB Japan reivindica outro credor
A crise do euro acabou, diz Francois Hollande da França	A crise da dívida da zona do euro acabou, diz o presidente da França
O que faz a Índia votar? Jaipur Lit Fest Debates	O que faz a Índia votar? Debate no Jaipur Literature Festival
Ciclone Phailin Folhas Trilha de destruição, intensidade do ciclone enfraquece	Ciclone Phailin mata 14, Folhas trilhas de destruição na Índia
Chefe de Golden Dawn reendia sob custódia pendente de julgamento	Líder de Golden Dawn reendido sob custódia
'Mundial desamericano necessário após o desligamento dos EUA'	O mundo 'desamericanizado' necessário após os EUA Shutdown, diz a China Media
Sinais do avião da Malaysia Airlines desaparecidos localizados no Vietnã	A falta de avião da Malaysia Airlines cai 'fora do Vietnã'
Tropas frances	A implantação de tropas francesas diminui a violência na República Central da África
Quatro quenianos feridos nos confrontos do Sudão do Sul	'Centenas de mortos' nos confrontos do Sudão do Sul
Pistorius vizinho 'ouviu gritos'	Pistorius vizinho acordou com 'gritos terríveis'
A explosão poderosa causa lesões em Praga	Blast poderoso ferimentos até 40 em Praga
Deal alcançado no programa nuclear do Irã	O acordo provisório atingiu o programa nuclear do Irã
Microsoft para cortar 18.000 empregos em revisão	Microsoft para cortar 18.000 empregos em plano de custo
O Irã precisa de mais usinas nucleares	Irã para construir a 2ª usina nuclear
O ator canadense August Schellenberg morre em Dallas	O ator de Mohawk August Schellenberg morre às 77
Soldado francês esfaqueou no pescoço em Paris	Soldado francês esfaqueou a patrulha em Paris
White Diamond Breaks Record no leilão de Hong Kong	White Diamond Gets Record $ 34M em HK Auction
A Arábia Saudita recusa o assento do Conselho de Segurança das Nações Unidas	A Arábia Saudita rejeita o assento no Conselho de Segurança da ONU
carro -bomba iraquiano perto da igreja mata pelo menos 14	carro bomba perto da igreja do Iraque mata pelo menos 14
Letta da Itália Nome novo governo	A Itália finalmente forma um novo governo
Israel concorda em trégua humanitária temporária de Gaza	Israel, Hamas concordam com a pausa 'humanitária' de Gaza
Pontos de satélite chineses grandes objeto na área de pesquisa	Malásia: Satélite chinês encontrado objeto no oceano
Criança de três anos entre feridos no tiroteio de Chicago	Criança de três anos em estado crítico após 11 são feridos no tiroteio de Chicago Park
Lucro líquido h1 fretado padrão de 24 %	Sags de lucro estatuto padrão
Confrontos em Istambul se estendem para a noite em Taksim	Confrontos na Turquia se estendem para a noite
Código Red Sirens ouvido no Conselho Regional de Hof Ashkelon	Mídia: 2 foguetes explodem no Conselho Regional de Hof Ashkelon
Especialistas holandeses foram para o local do acidente do MH17	A equipe holandesa chega para o site de acidente do MH17
Rossi, nascido nos EUA	Rossi ausente da equipe da Copa do Mundo da Itália
GOA Building Collapse Death Toll Touches 15	O edifício indiano colapsou as mortes para 14
O ensaio de genocídio de Ruanda de referência é aberto na França	O julgamento de genocídio de Ruanda é aberto em Paris, francês primeiro
Russell Whirlwind século atordoa os tigres e define a vitória do HPC	Russell Whirlwind século atordoa tigres
Toll Toll atinge 238 no colapso do edifício de Bangladesh	O número de mortos no colapso do prédio de Bangladesh aumenta para 164
O corpo religioso Pak endossa o casamento menor de idade	CII endossa o casamento menor de idade
O colapso do edifício na Filadélfia prejudica pelo menos 12	colapso do edifício na Filadélfia, 14 puxados de escombros
JPMorgan para pagar US $ 1,7 bilhão para resolver o caso de Madoff	JPMorgan para pagar mais de US $ 2,5 bilhões em fraude de Madoff
Dezenove feridos em tiroteios no desfile do dia da mãe em Nova Orleans	Dezenove magoados no dia da mãe atirando em Nova Orleans
4 jornalistas franceses libertados após 10 meses na Síria	Quatro jornalistas franceses libertaram 10 meses depois de serem sequestrados na Síria
A proposta do Tesouro vê um aumento de 1,5 % no imposto de renda	Tesouro propõe aumento de 1,5 % de aumento de imposto de renda no orçamento
O líder da oposição russo Navalny detentou brevemente em Moscou	O líder da oposição russo Navalny detentou brevemente
Explosão no Japan Chemical Plant Kills 5, ferimentos 17	explosão na planta química do Japão, 5 mortos
Um seqüestrador dos EUA retorna de Cuba	O seqüestrador dos EUA volta para casa de Cuba após 30 anos
Holanda perde a classificação de crédito Triple-A	Holanda perde a classificação de crédito S&P Triple-A
Novos acertos fortes do terremoto quebraram a região de Pak	6.8 Quake na região do Paquistão quebrado
Pawar Sparks Row com observação de 'votação falsa'	Pawar Sparks Row com "votação falsa", reproduzi -la
O voo da Malaysia Airlines abatido no leste da Ucrânia	avião da Malásia abatido sobre a Ucrânia
PM do Paquistão em Cabul para discutir negociações de paz	O PM do Paquistão vai para Cabul para empurrar os esforços de paz
Os ministros da UE de emprego e política social discutirão como aumentar o emprego, integrarem políticas sociais e econômicas	Ministros da UE de Emprego e Política Social para discutir estratégias de impulso de emprego
un. Conselho de Segurança pede cessar -fogo humanitário em Gaza	Gaza Crisis ONU Conselho de Segurança exige cessar -fogo incondicional
O incêndio do mercado Shenzhen mata 15	China Market Inferno mata 15
corpos de pescadores decapitados encontrados no barco	Corpos de oito pescadores decapitados encontrados no barco nas Filipinas
nós. estende alguns fechamentos da embaixada sobre a ameaça da Qaeda	nós. estende o fechamento da embaixada devido a 'ameaça séria'
AstraZeneca rejeita a oferta de Pfizer "final"	A AstraZeneca Board rejeita a nova oferta da Pfizer
Putin em breve para perdoar o magnata Khodorkovsky	Putin Sinais perdem para Mikhail Khodorkovsky
Polícia de tumultos dispersam os manifestantes em Istambul Park	A polícia turca inicia o ataque aos manifestantes em Istambul Park
Coréia do Norte lança mísseis de curto alcance	Coréia do Norte dispara mísseis de curto alcance no mar do Japão
Os resultados presidenciais de Madagascar chegam	As eleições presidenciais de Madagascar começam
Os soldados participam de uma broca de incêndio na China	A equipe florestal aborda a broca de incêndio na China
Protestante anti-hezbollah disparado em Beirute	Protestante anti-hezbollah morto no Líbano
A Ucrânia não responde à 'provocação' russa	Ucrânia se recusa a agir contra a 'provocação' russa
O Senado do Havaí passa pelo casamento gay	Havaí passa uma conta de casamento gay
Governo do Sudão do Sul, rebeldes marcados para as negociações do dia de Ano Novo	Etiópia: Governo do Sudão do Sul, rebeldes para realizar palestras
Hamas pede ao Hizbullah a puxar os combatentes da Síria	O Hamas pede o Hezbollah a puxar forças para fora da Síria
Comandante do Hezbollah matou fora de Beirute Home	Chefe do Hezbollah morto em Beirute
A Starbucks paga o primeiro imposto da Corporação do Reino Unido desde 2009	A Starbucks começa a pagar o imposto sobre as empresas do Reino Unido
policial polêmico que os estudantes sentados com pimenta durante o protesto de OWs buscam compensação dos trabalhadores por lesão psiquiátrica	policial que estudantes pulverizados com pimenta buscam trabalhadores, reivindica lesão psiquiátrica
Philip Seymour Hoffman encontrou morto com agulha no braço	O ator dos EUA Philip Seymour Hoffman encontrou morto em Nova York
A decisão do tribunal turco bloquearia o Projeto Parque disputado	O Tribunal Turco cancela o Projeto Istambul Park de Istambul
5 Oficiais importantes do Laos mortos em acidente de avião	Chefe de Defesa do Laos morto em acidente de avião
Helicóptero colide com o telhado do Glasgow Club	Crash de helicóptero em Glasgow, Escócia
Jornalista do Canal One da Rússia morto no Donetsk da Ucrânia	Jornalista russo morto na Ucrânia
Os afegãos votam em votos na eleição de escoamento presidencial histórico	Os afegãos votam no escoamento presidencial
Inundações repentinas matam 58 no Afeganistão Oriental	Feridas de bombas 16 no Afeganistão Oriental
A participação baixa, o Egito estende a votação presidencial por dia	O Egito estende a eleição presidencial votando 1 dia
nós. e a Rússia alcançar um acordo sobre as armas químicas da Síria	A China nos recebe, a Rússia lida com armas químicas da Síria
O regime do Egito é a passagem de um novo eleitor	Os egípcios dizem sim para a nova Constituição
Quatro presos por matar Roma em Spree que chocou a Hungria	Quatro presos por matar neo-nazistas que aterrorizaram a Roma da Hungria
A oposição cambojana retrai a reivindicação da vitória eleitoral	O partido do Strongman PM do Camboja reivindica a vitória eleitoral
Preços do Twitter IPO a US $ 26 por ação, levantando US $ 1,82B	Preços do Twitter I.P.O. por US $ 26 por ação
PSNI fracassou oficiais da RUC, disse Tribunal	13: 23 PSNI 'Fiducious Famílias de Oficiais da RUC' "
10 feridos no acidente de avião de São Francisco	Obama recebe os respondentes no acidente de avião de São Francisco
as ações são mais baixas após os ganhos de varejo	as ações são mais baixas após os ganhos dos varejistas
O rei belga Albert II para abdicar em favor de seu filho	Bélgica rei Albert II 'para abdicar'
Rial iraniano sobe 10 % à medida que as esperanças crescem sobre o novo presidente	Rial iraniano sobe 10 % depois que o novo presidente eleito
Pistorius se declara 'não culpado' no início do julgamento de assassinato	Pistorius se declara inocente de assassinato quando o julgamento começa
Helicóptero policial colide com pub escocês	Helicóptero policial cai no topo do bar em Glasgow
Os pilotos do avião da Malásia sob escrutínio	Os pilotos do avião sob escrutínio em mistério
Suspeito de bombardeio de Boston capturado	Suspeito de bombardeio de Boston relatado encurralado no barco
A chanceler alemã Angela Merkel reduz as consultas após o acidente de esqui	Chanceler alemã Angela Merkel ferida em acidente de esqui na Suíça
nós. , navios de guerra chineses quase colidem no Mar da China Meridional	Os navios chineses e americanos quase colidem no Mar da China Meridional
Soldado esfaqueado em Paris	Soldado francês esfaqueou a patrulha em Paris
4 jornalistas franceses libertados após 10 meses na Síria	4 jornalistas franceses mantinham reféns na Síria Freed
Acordo de alcance dos EUA-Rússia sobre armas da Síria	EUA, Rússia mais perto do acordo sobre armas químicas sírias
Primeiro livro impresso na América é vendido por um recorde de US $ 14,2 milhões	Primeiro livro impresso nos EUA é vendido por US $ 14,2 milhões no leilão da Sotheby
Declaração da Casa Branca em referendo da Crimeia	Líderes da Facção Duma para enviar uma declaração sobre o referendo da Crimeia
Us -ups pressionam Israel como a ONU exige trégua de Gaza	nós, sem pressão sobre Israel sobre Gaza
O governo australiano segue a proibição da Huawei	Novo governo da Austrália defende a proibição da Huawei
ONU Chief Boots Irã fora das negociações de paz na Síria	O chefe da ONU retira convite para o Irã se juntar às negociações de paz na Síria
O gerente de campanha de Anthony Weiner sai	O gerente de campanha de Anthony Weiner desiste, reivindicando reivindicações
Tornado atinge o subúrbio de Oklahoma City	Tornado mortal atinge o subúrbio de Oklahoma City, pelo menos 37 mortos
Filha e genro de casal de idosos encontrado enterrado em seu quintal é acusado de assassinato	Filha e genro acusado de assassinar o casal de idosos encontrados em bastidores depois de desaparecer há 15 anos são presos sob custódia
Sisi jurou como presidente do Egito	O Sisi do Egito jurou como presidente
Aviões japoneses voaram para a nova zona de defesa da China	Japão, os aviões militares coreanos desafiam a nova zona de defesa da China
A Rússia diminui as acusações contra 29 tripulação do Greenpeace	Rússia Drops Charge vs 16 ativistas do Greenpeace
Militantes do Taliban Storm Pakistan Prisão, liberando centenas de 'terroristas perigosos'	Pistãos do Taliban Storm Pakistan Prisão, Free Centenas
Torturador de regime militar do Brasil morto	Revestimento militar brasileiro Paulo Malhaes morto
Israel acusa a Síria de usar armas químicas	Israel: Síria usando armas químicas
Yale Uni em bloqueio depois que o atirador avistou	Universidade de Yale em bloqueio em meio a um alerta de atirador
'23 % perderam a palha de pensão '	Os trabalhadores perdendo a noção de pensões '
O PM australiano diz que os sinais "muito confiantes" são da Black Box	Os sons confiantes do PM australiano são do voo 370
A oposição síria aguarda o convite para as negociações de paz de Genebra	A oposição síria busca a bênção dos rebeldes para entrar em negociações de paz
Alerta de viagem em problemas dos EUA sobre a ameaça da Al Qaeda	Alerta de viagem global dos EUA, cita a ameaça da Al Qaeda
O autor Nobel Doris Lessing morre aos 94	Autor do Nobel Britânico Doris Lessing Dies
MT Gox revela 200.000 Bitcoin Haul 'esquecido'	MT Gox encontra 200.000 bitcoins 'esquecidos'
Classões mortais como aniversário do Egito	A violência mortal marca o aniversário da revolta do Egito
A condição de Mandela 'melhorou'	A condição de Mandela piorou nas últimas 48 horas '
Funeral de Nova York planejado para Conn. Mulher morta no Capitol Car Chase	NY Funeral realizado para mulher morta em DC Car Chase
Terras rover lunares chinesas na lua	China Lands Robot Rover na lua
Rep. Bill Young morre aos 82	O congressista da Flórida morre aos 82 anos
desemprego da zona do euro em direção a 20 milhões	desemprego da zona do euro em novo registro
O ministro das Finanças da Cipriota, Michalis Sarris, renuncia	Ministro das Finanças de Chipre renuncia
Os hóspedes encontraram mortos na piscina no hotel de luxo se afogaram	casal encontrado morto na piscina que ambos se afogaram, os testes revelam
4 feridos em explosão perto de Sharqiya Intelligence HQ do Egito Sharqiya	4 oficiais feridos em ataques a escritórios de inteligência militar egípcia
Toll de morte aumenta no bombardeio de suicídio da Igreja do Paquistão	Toll de morte no bombardeio da igreja do Paquistão sobe para 81
Terremoto de 6,9 ​​magnitude atinge a Ilha da Indonésia	Terremoto atinge perto das ilhas da Indonésia
O Senado avança na conta de imigração	nós. O Senado Backs Fronteira em Emenda à Lei de Imigração
A âncora da Fox News acusada após a prisão do aeroporto	A âncora da Fox News foi libertada após a prisão por beligerância no aeroporto
Menino, 14 anos, preso por ataques sexuais em torno de um campus universitário	Dois adolescentes presos após ataques sexuais no campus da Universidade de Manchester
Philippe se torna rei da Bélgica	Philippe ascende ao trono da Bélgica dividida
Espíritos australianos High diz Clarke	Os espíritos australianos estão altos na popa ...
3 turistas chineses mortos no Paquistão	pistoleiros matam nove turistas no Paquistão
Duquesa de Cambridge e Baby Royal 'indo bem'	Duquesa de Cambridge dá à luz o bebê
Dois aviões quase colidem no aeroporto central do Vietnã	aviões em 'Near Miss' no aeroporto do Vietnã
Israelenses, palestinos iniciam negociações de paz	Israelenses, palestinos preparados para palestras em território doméstico
Os conselhos galeses 'amplamente despreparados' para a escala de cortes no orçamento	Conselhos 'despreparados' para cortes profundos
Partido anti-enxerto da Índia assume o comando em Nova Délhi	Partido anti-enxerto da Índia forma o governo em Delhi
Espanha aprova nova lei restritiva do aborto	O governo espanhol aprova restrições apertadas ao aborto
Bangladesh para permitir sindicatos para trabalhadores de roupas	Sobrevivente de colapso da fábrica de Bangladesh desiste do trabalho de vestuário
Cleveland seqüestrador Ariel Castro morto na cela da prisão	O seqüestrador de Cleveland Castro comete suicídio na cela da prisão
A adolescente sobrevive ao voo de cinco horas para o Havaí 'na roda do avião'	Teen Stowaway 'viajou para o Havaí na roda de avião bem'
O Carphone Warehouse e Dixons confirmam a 'fusão de iguais' em todas as ações iguais	Carphone Warehouse e Dixons revelam £ 3,8 bilhões de fusões
Detritos de avião podem ter afundado	MH370 Pesquisa fica em branco, os detritos podem ter afundado
A oposição da Espanha exige o primeiro -ministro renunciando	Os líderes da oposição da Espanha chamam Rajoy para renunciar
Quatro presos quando o pedágio de Bangladesh aumenta para 352	2 preso quando o edifício de Dhaka colapsa pedágio atinge 332
O governo aprova a libertação dos prisioneiros	O gabinete de Israel aprova a libertação do prisioneiro palestino
Obama ordena a investigação de "ataque a gás" da Síria	ONU pede inspeção de ataque a gás na Síria
dois EUA astronautas prontas para fazer a caminhada espacial da véspera de Natal para reparos	astronautas fazem raros espaciais de véspera de Natal
A Microsoft diz para cortar até 18.000 empregos	Microsoft para deitar 18.000
RF pede aos seus parceiros que denunciem as ações das autoridades de Kiev no sudeste da Ucrânia	Putin: Rússia espera que a ONU denuncie as ações anti-constitucionais das autoridades de Kiev
'Dezenas feridas' após a explosão de plantas de fertilizantes do Texas	Centenas acreditavam feridos na explosão de plantas de fertilizantes do Texas
Angkor Wat recebe View Street do Google	Os templos de Angkor do Camboja adicionados ao Street View do Google
Mandela respondendo ao tratamento, diz Zuma, na África do Sul	Zuma: Mandela 'respondendo melhor ao tratamento'
ex-fm lieberman absolvido de alegações	O ex -FM Lieberman de Israel absolveu em julgamento por fraude
Dolce e Gabbana multados no caso tributário italiano	Dolce e Gabbana condenados à prisão por sonegação de impostos
dezenas ainda faltando depois do trim blaze do Canadá	40 ainda faltando no acidente de trem de petróleo no Canadá mortal
Dois confirmados mortos após o jato de passageiros acidentes em São Francisco	2 morrem e muitos são feridos quando acidentes de avião em São Francisco
soldado da OTAN morto no ataque afegão	soldado da OTAN morto em ataque do Taliban no Afeganistão
CEO da Microsoft Ballmer para se aposentar dentro de 12 meses	À primeira vista: os altos e baixos do Microsoft CEO Ballmer
Explosão atinge a fábrica de fertilizantes no Texas	Explosão mortal na fábrica de fertilizantes do Texas
17 feridos em tiro no desfile de Nova Orleans	17 ferir no tiroteio de Nova Orleans
Democrata de Blasio leva a Big Apple	Democrata de Blasio eleito prefeito de Nova York
O ministro do Interior do Egito sobrevive a uma oferta de assassinato	O ministro do Interior do Egito sobrevive ao ataque de bomba
Poderes mundiais, o Irã conquistou o negócio nuclear 'histórico'	Irã, seis potências mundiais conquistam o negócio nuclear de avanço
Residência de Atenas do embaixador alemão atirado em	tiros disparados com a residência do embaixador alemão em Atenas
O foguete russo não tripulado cai após o lançamento no Cazaquistão	O foguete russo explode no Cazaquistão
Diana Nyad completa o recorde nadar na quinta tentativa	'Nunca, nunca desista': Diana Nyad completa a natação histórica de Cuba-to-Florida
O desligamento do governo dos EUA começa - atualizações ao vivo	O desligamento do governo começa com a briga de saúde
Afeganistão elogiado por eleições históricas	Afeganistão desfruta de eleições presidenciais pacíficas
O ministro do Quênia diz 59 mortos em ataques de shopping	Dois índios entre 39 mortos no ataque do shopping do Quênia
Dois eslovacos mortos em carros -bomba suicídicos de Cabul	3 soldados da coalizão mortos no bombardeio de carros de Cabul
Os palestinos comemoram a libertação do prisioneiro	Greetes do Presidente Palestino liberados
O ícone da oposição preso da Ucrânia Tymoshenko anda livremente	O chefe de oposição da Ucrânia quer mais protestos
Diplomatas se reúnem para planejar a conferência de paz na Síria	Enviado: Nova reunião de 25 de junho para preparar a Conferência da Paz da Síria
Terremoto poderoso atinge o Chile, desencadeia o tsunami	Quake poderoso atinge o chile
Oklahoma examina o que deu errado na execução mal feita	Okla. preso morre de ataque cardíaco após a execução mal feita
O snowboarder enterrado vivo após o túnel de gelo no Monte Hood caindo enquanto ele passava por ele	O snowboarder enterrado quando o túnel em minério. colapso da montanha; Pesquisa retomando ao amanhecer
Napolitano eleito para o segundo mandato como presidente da Itália	Presidente italiano Napolitano eleito para o segundo mandato
Dois mortos no fogo florestal do Chile	onze mortos em incêndio florestal no Chile
Os cientistas dos EUA concederam Prêmio Nobel de Química por Trabalho sobre Modelagem de Computadores	O Prêmio Nobel de Química vai para o Trio Whiz
Mais de 100 feridos na explosão de plantas do Texas	Centenas acreditavam feridos na explosão de plantas de fertilizantes do Texas
Bale pontua na estréia como empate no Real Madrid no Villarreal	pontuações de Bale na estréia; Villarreal segura Madri
o tribunal da ONU condena 6 croatas bósnios de atrocidades	O Tribunal de Crimes de Guerra da ONU condena seis croatas bósnios
nós. acusa a Rússia de enviar tanques para o leste da Ucrânia	Rússia enviou tanques contra a Ucrânia
O rapper de Toronto Drake recebe 4 indicações ao Grammy	Snubs, surpresas nas indicações do Grammy
Israel para libertar prisioneiros palestinos sobre as negociações de Kerry	EXECIENTES DE PAZ ORIENTE: Israel promete a liberação de prisioneiros políticos palestinos após as discussões de John Kerry
Coréia do Sul para tributários de empregos de cirurgia estética, figuras religiosas	A Coréia do Sul procura cirurgia plástica para novos impostos
Putin nos desafia as reivindicações da Síria	Putin exige -nos provar o uso de armas químicas da Síria
reações mistas ao casamento entre pessoas do mesmo sexo da Nova Zelândia	Nova Zelândia legaliza o casamento entre pessoas do mesmo sexo
O governo aprova a libertação dos prisioneiros	Yacimovich pede ao gabinete que aprove a libertação dos prisioneiros palestinos
Israel para libertar prisioneiros palestinos como acordo para retomar as negociações de paz surge	Canal 2: Israel para libertar cerca de 100 prisioneiros após as negociações retomar
O fogo destrói a cidade tibetana antiga na China	Cidade tibetana antiga na China destruída pelo fogo
Pelo menos 95 mortos como o Egito declara o estado de emergência	O Egito declara o estado de emergência de um mês
HM King Hamad recebe delegação hindu de baps	HM King Hamad recebe presidentes de tribunais de auditoria do GCC
Ministros das Relações Exteriores da UE para discutir o embargo de armas na Síria	Áustria: a UE falha em chegar ao acordo com o embargo de armas na Síria
O escritório do promotor da máfia pró-russo na Ucrânia do Donetsk da Ucrânia	Os manifestantes pró-russos Storm Storm Donetsk Promotor's Office no leste da Ucrânia
O ministro do Egito sobrevive à tentativa de assassinato	O ministro do Interior do Egito sobrevive ao ataque de bomba
Pontuações mortas em ataques do Iraque	Pontuações mortas em carros -bomba de Bagdá
Vacina de telhas para idosos	Campanha de vacina de telhas para começar
On Thirhips Strike Uganda Muslim Rebels no Dr. Congo	ONU CHOPPERS GRATE em rebeldes de Uganda
A Rússia levanta alarme sobre o teste de mísseis israelenses no Mediterrâneo	Israel diz que realizou o teste de mísseis conjuntos conosco no Mediterrâneo
nós. adverte a Coréia do Norte contra o lançamento de mísseis	nós. Diga ao lançamento do novo míssil da Coréia do Norte seria "grande erro"
Dave Lee Travis se declara inocente de todas as acusações	DJ Dave Lee Travis nega 15 cobranças sexuais
Cientistas esperam	SpaceCraft de Rosetta Comets-Chasing acorda
Homem saudita com panela de pressão presa no aeroporto de Detroit	Homem saudita viajando com panela de pressão presa
Quebra: o ator cômico Mel Smith morre de ataque cardíaco com 60 anos	15: 08 'Comédia grande' Mel Smith morre aos 60
O Twitter revela seu arquivamento de IPO	O Twitter revela o arquivamento do IPO, tem como objetivo arrecadar US $ 1 bilhão
Chidambaram questiona a projeção de crescimento do FMI	Chidambaram questiona a metodologia do FMI para calcular as projeções de crescimento da Índia
O chefe do Banco Cooperativo sai em meio ao rebaixamento de Moody	Cooper
Putin exige que as tropas sejam enviadas para a Ucrânia	A Grã-Bretanha pede a escalada de tensões na Ucrânia
nós. As ações aumentam após incentivar os relatórios de empregos	Os futuros de ações dos EUA se aproximam do relatório de empregos
Myleene Klass faz o Dec Philippines apelar	ONU lança o apelo de ajuda das Filipinas
A AstraZeneca paga US $ 4,1 bilhões para comprar Bristol-Myers Squibb da Diabetes Alliance	AstraZeneca para comprar Bristol do Diabetes Venture por até US $ 4,1 bilhões
O mundo da África do Sul da África do Sul	Zuma Heralds 'Our Icon' no Dia da Oração da África do Sul por Mandela
Pesquise o piloto de currículos de voo de NY Angel	Os resgatadores procuram piloto em voo mortal de NY Angel
Bangladesh sentenças 152 até a morte por 2009 motim	sentença de morte para 152 soldados sobre motim
Rousseff diz que o Brasil pode fazer melhor	Rousseff definido para abordar protestos do Brasil
Mandela não 'vegetativo' - Govt	Os médicos negam Mandela em 'Estado vegetativo'
Chefe de Drogas de Sinaloa capturado no México	O chefe de drogas do Sinaloa, do México, preso
Grã -Bretanha exclui a ação militar na Síria	O Parlamento do Reino Unido bloqueia uma ação militar britânica contra a Síria
Matt Smith deixa o médico da BBC que	Matt Smith deixando o papel principal no 'Doctor Who' da BBC
23: 21 Senado dos EUA para votar nos cheques de armas	O Senado pode votar na reforma das armas na quarta -feira
O carro -bomba explode em Stronghold do Hezbollah de Beirute	Forte explosão atinge a fortaleza de Hizballah em Beirute
O líder de protesto russo denuncia o julgamento político '	O líder de protesto russo diz que o julgamento é a vingança de Putin
Vencedor do Idol Árabe, dado o Hero's Welcome in Gaza	Os palestinos recebem o vencedor do ídolo árabe que volta para casa em Gaza
Gunfire Rocks Dr. Congo Capital	Tiros pesados ​​relatados no aeroporto no Dr. Congo Capital
A Coréia do Norte diz para colocar o cidadão dos EUA em julgamento	A Coréia do Norte diz que o turista americano detido para enfrentar julgamento
Pelo menos 239 pessoas temiam morto enquanto o jet de companhia aérea da Malásia desaparece no Vietnã	Última foto do casal temia morto depois que o voo da Malaysian Airlines 'desaparece' no Mar da China Meridional
Duzentos desaparecidos no desastre de balsa das Filipinas	Pelo menos 32 mortos, 170 faltando no desastre de balsa
protestos anti-china espalhados pelo Vietnã	Mais de 20 mortos enquanto os tumultos anti-China se espalham no Vietnã
Três motivos possíveis por trás do recente ataque aéreo de Israel na Síria	O Irã condena a alegada ataque aéreo israelense na Síria
A Microsoft diz para cortar até 18.000 empregos	Microsoft para cortar 18.000 empregos em plano de custo
Nidal Hasan culpado em 2009 Fort Hood disparando tumulto	Nidal Hasan considerou culpado de matar 13 na base de Fort Hood
A FTC acusa a T-Mobile de cobrar seus clientes por spam de telefone celular fraudulento	A FTC acusa a T-Mobile de cobrar conscientemente clientes por centenas de milhões em acusações falsas
júri delibera como irmão Dana acusado de abuso sexual	Tribunal limpa o irmão de Dana de todos os aspectos de abuso sexual histórico
Obama 'de coração partido' em outro tiroteio de Fort Hood	Fatalidades relatadas no tiroteio de Fort Hood
Síria concorda em unir a investigação em ataque químico	A Síria permite a visita da ONU ao local de ataque químico
Ataque do Talibã afegão perto do aeroporto de Cabul	Insurgentes lutam contra as forças afegãs perto do aeroporto de Cabul
Boeing Jumbo Jet Plane Lands no aeroporto errado	Boeing 747 Jumbo Jet ficou depois de pousar por engano no Tiny Kansas Airport
O número de mortos aumenta para 13 no colapso do edifício Goa	As equipes de resgate buscam sobreviventes após 15 morre na Índia colapso do edifício
Auxílio adicional aprovado para a explosão de plantas de fertilizantes do Texas	FEMA OKS Aid para a explosão de plantas do Texas
Os protestos tailandeses aumentam em meio à violência	Os manifestantes tailandeses chamam Geral Strike
O primeiro -ministro indiano Singh para renunciar após as eleições de 2014	PM indiano para renunciar
Três sobrevivem a colapso da ponte americana-canada	Os carros mergulham no rio enquanto a ponte americana cai
Gólidos em Nairóbi Lançar ataque ao shopping, mate 30	Gunmen Storm Nairobi Mall, 15 mortos
Toll de mortal de Typhoon Rammesun aumenta para 17 na China	Typhoon Rammasun Death Toll atinge 33 na China
3 suspeitos levados sob custódia no caso de bombardeio de Boston	A polícia de Boston diz que 3 levou sob custódia em bombardeio de maratona
O Egito impõe estado de emergência depois que 95 pessoas mataram	O Egito anuncia um estado de emergência em todo o país em todo o país
Giant Wildfire ameaça Yosemite Park	Raging e em movimento rápido da Califórnia, ameaça Yosemite National Park
Os estoques de Tóquio fecham 0,49pc mais baixo	Os estoques de Tóquio se abrem mais baixo no bloqueio de ganhos
Kerry olha para a China para neutralizar as tensões da Coréia	Kerry no Japão em meio a tensões na Coréia
Tudo pronto para o Fórum Econômico Nacional terça -feira	Nduom esperançoso em resultado do Fórum Econômico Nacional
Caso de amor desconfortável dos sul -africanos brancos com Mandela	A África do Sul prepara o funeral para as idades para Mandela
Os políticos de Taiwan se espalham por conta nuclear	Meltdown no Parlamento de Taiwan sobre pesquisa nuclear
Snowden, Whistleblower de inteligência dos EUA, indicado ao Prêmio Nobel da Paz	Snowden nomeado para o Prêmio Nobel
Obama para pressionar a China na segurança cibernética	Obama instou a codificar a China sobre direitos humanos
Cable avisa em ajuda para comprar 'bolha'	Vince Cable preocupado com a ajuda para comprar bolha de propriedade da casa
Facebook Puxa Vídeo de decapitação	O Facebook remove o vídeo decapitando, reabre o debate
Connecticut adota leis mais rigorosas de controle de armas em nós	Connecticut passa controles rigorosos de armas em resposta ao massacre de gancho de areia
ONU para manter conversas de emergência no Dr. Congo	O Conselho de Segurança da ONU realiza uma reunião de emergência sobre o Dr. Congo Fighting
Explosões mortais atingem a maratona de Boston em nós	Relatório de duas explosões na linha de chegada da maratona de Boston
O vídeo do Taliban mostra a transferência do soldado dos EUA	Vídeo de lançamento do Taliban da transferência do soldado dos EUA
A nova constituição do Egito explicou	A segunda tentativa do Egito na nova constituição 'uma melhoria'
Obama para visitar a Ilha Robben em Tribute de Mandela	Obama visita a célula da Ilha Robben de Mandela
Israel lança operação terrestre em Gaza	militares israelenses inicia o solo ofensivo em Gaza
78 mortos no bombardeio da igreja de Pak	Mortes no bombardeio da igreja do Paquistão aumentam para 43
Os malaios votam em pesquisas por estabilidade ou mudança	Eleições da Malásia: os malaios votam com o poder em jogo pela primeira vez
Kerry no Egito na primeira visita desde Morsi OUSTER	Kerry na primeira viagem ao Egito desde a OUSTER de Mursi
Príncipe George batizado pelo arcebispo em Londres	O batizado do príncipe George
Filipinas se prepara para enterros em massa	A cidade filipina de Typhoon, com o Typhoon, começa o enterro em massa
Rallies exigem 'justiça para trayvon'	Do outro
1000 estimados mortos depois que o tufão rasga as Filipinas	Mais de 100 mortos enquanto o tufão bate as Filipinas Centrais
Sir Jon Cunliffe para ingressar no Bank of Engalnd como vice -governador	O Banco da Inglaterra nomeia Cunliffe como vice -governador
Mighty Mickelson vence finalmente	O jogador de golfe dos EUA Phil Mickelson vence o aberto
pena de morte para traficantes de heroína no Vietnã	Vietnã entrega 5 tráfego de heroína Pena de morte
Agressão sexual um 'flagelo' nas forças armadas dos EUA, diz Hagel	Obama: agressão sexual ameaça a confiança em militares
A condução das mulheres sauditas chuta sem prisões	Mulheres sauditas dirigem em protesto com pouco problema
A bomba em Damasco mata 13 dias após o ataque ao primeiro -ministro	TV síria: bombardeio em Damasco mata 13 pessoas
ONU avisa a situação das mulheres, crianças no homs da Síria	UNICEF exige acesso seguro imediato a mulheres, crianças em Homs
Presidente da Argélia Bouteflika no hospital	Presidente argelino sofre 'mini golpe'
Nadine Gordimer, escritora sul-africana vencedora do Prêmio Nobel, morto aos 90	África do Sul se lembra de Nadine Gordimer
Redford elogia a economia de Alberta antes da votação na liderança	Redford aborda a Convenção para PC antes da revisão da liderança
Hagel, Dempsey enfrenta o Congresso pelo orçamento de defesa	Hagel lamenta mudanças "políticas" no orçamento de defesa dos EUA
Sony para vender unidade de PC e cortar empregos	Sony To Ax Unidade PC na grande revisão de negócios
Duas explosões rock boston maratona na linha de chegada	Duas explosões atingiram a linha de chegada da maratona de Boston, pelo menos dois mortos
A oposição do Camboja diz que as irregularidades da pesquisa pior	A oposição cambojana reivindica uma vitória surpresa antes do resultado
Mahathir renuncia como consultor de Petronas	O ex -primeiro -ministro da Malásia, Mahathir, desiste como consultor da gigante estadual de petróleo Petronas
Crimeia vota para deixar a Ucrânia para a Rússia	Putin desafiador como a Crimeia vota para retornar à Rússia
O homem mata 4 na Califórnia. Antes da polícia o matar	Polícia: Matilheiro matou 6 em tiroteios na Califórnia
As negociações nucleares do Irã concluem sem um acordo	FM francês Fabius diz que as negociações nucleares do Irã terminam sem acordo
Driver de trem de trem da Espanha acusado de 'imprudência'	A polícia detém o motorista do acidente de trem da Espanha como suspeito
Ainda não há sinal de companhia aérea da Malásia perdida em mistério sem precedentes	A Malaysia Airlines perdeu o avião: as nações correm para resolver 'mistério sem precedentes'
Escolas Petra Kvitova Eugenie Bouchard na final das mulheres de Wimbledon	Kvitova Blitzes Bouchard em uma final desigual
n. Coréia deporta idosos americanos	A Coréia do Norte deporta deteve o veterano da Guerra dos EUA
Nelson Mandela fazendo "Amazing Progress" enquanto o mundo celebra seu 95º aniversário	Nelson Mandela comemora 95 anos no hospital
A lenda do críquete aposentada Sachin Tendulkar recebe o mais alto prêmio civil da Índia	Sachin Tendulkar para obter Bharat Ratna, a maior honra civil da Índia
Palácio presidencial de ataque do Taliban no Afeganistão	Todos os pistoleiros em ataque ao palácio presidencial afegão mataram
Tribunal limpa o irmão de Dana de todos os aspectos de abuso sexual histórico	O irmão de Dana, John Brown, liberou duas acusações de abuso sexual
Júri em George Zimmerman Trial enfrenta tarefas difíceis	júri para obter o caso de Zimmerman
O desemprego da zona do euro atinge 12,2 % recorde	O desemprego atinge o recorde na Europa
A participação baixa, o Egito estende a votação presidencial por dia	A votação presidencial do Egito vai para um terceiro dia
Coréia do Norte preparando para o quarto teste nuclear	n. A Coréia pode estar preparando o novo relatório de teste nuclear
FAA aprova o design do sistema de bateria do Boeing Dreamliner	nós. O regulador aprova o Boeing 787 Battery System Design Alterações
O líder de pesquisa exige cautela em descobertas relacionadas à falta de jetline da Malásia	Os pesquisadores esperando que os pings venham de um avião perdido da Malásia
Os verões desistindo da corrida para o trabalho do Fed	ações impulsionadas pela retirada dos Summers da corrida do Fed
Estado do Sudão do Sul lança o Exército Recruitment Drive	Sudão do Sul (República de): os rivais do Sudão do Sul discutem cessar -fogo, detidos
Nenhum acordo sobre o programa nuclear do Irã, apesar do 'progresso concreto'	O Rouhani do Irã diz que os direitos nucleares são 'linhas vermelhas'
Hosni Mubarak, do Egito, libertado da prisão	Ordens do Tribunal Mubarak Freed
Os restos mortais de Mandela chegam a Mthatha antes do enterro	Mandela faz uma jornada final para casa em Safrica
Coréia do Sul expande sua zona de defesa aérea em reação à China	A Coréia do Sul declara o Adiz expandido que se sobrepõe a outras zonas
Mandela lembrada pela família, como o serviço Memorial do Estádio está planejado	A família de Mandela agradece nação e mundo pelo apoio
Condições boas para a tentativa de correção da Costa Concordia	Os engenheiros começam ambiciosos Costa Concordia Salvage da ilha italiana
protestos depois que George Zimmerman absolveu no caso Trayvon Martin	Zimmerman absolvido em matar
A troca de China-Myanmar termina na China SW	Mianmar recebe mais trocas de China
Chefe da ONU LAUDS CONSCRIÇÃO DO NOBEL PACK Prêmio à OPCW	O Watchdog de armas químicas ganha o Prêmio Nobel da Paz
Pope faz um apelo à paz durante a visita de Belém	Pope exige paz durante a visita da Cisjordânia
Poroshenko jurou como presidente da Ucrânia	Poroshenko diz que a Ucrânia não desistirá da Crimeia
Dubai deslumbra na festa global de 2014, ano novo recebido com alegria, fogos de artifício	Dubai anéis no ano novo com o maior show de fogos de artifício de todos os tempos
Em meio a sinais de acordo, Kerry vai para as conversas no Irã nuclear	Kerry vai para Genebra para negociações nucleares do Irã
Obama mantém conversas sobre a ação da Síria	A ação da Síria 'não causaria radicalização'
Sharif Stages Comback na eleição de referência no Paquistão	Nawaz Sharif declara a vitória nas eleições de Pak
Cheeki Rafiki encontrou, mas nenhum sinal de tripulação	O iate desaparecido encontrado, mas sem tripulação
Peaches Geldof, filha de Bob Geldof, morre	Peaches Geldof morre com 25 anos
Por que o Parlamento Britânico votou contra a ação militar na Síria?	Cameron perde a votação parlamentar sobre ação militar da Síria
Obama, Cameron 'sem dúvida', o regime da Síria travou ataques químicos	Biden: Sem dúvida, o regime da Síria usou agente nervoso
Sete mortos na California College Shooting	7 mortos no tiroteio na Califórnia
O Irã faz a proposta destinada ao progresso nas negociações nucleares	Israel pede que os poderes sejam difíceis nas negociações nucleares com o Irã
A Síria diz ONU. terá acesso ao local de possível ataque químico	A Síria permite a visita da ONU ao local de ataque químico
O Banco da Inglaterra detém taxas como Mervyn King se inclina	Bank of England diz não a mais QE
multidões esperam pelo veredicto no julgamento de Zimmerman	O fator de corrida no julgamento de George Zimmerman
Com sacos de dinheiro, a CIA busca influência no Afeganistão	Aeronaves bate na base no Afeganistão
A presidência ucraniana diz que o acordo chegou às negociações de crise	Rivais da Ucrânia Sinaliza o acordo para acabar com a crise
O juiz federal governa que o casamento entre pessoas do mesmo sexo é legal em Utah	O juiz derruba a proibição de casamento do mesmo sexo de Utah
Obama se prepara para a possível ação contra a Síria	O Parlamento do Reino Unido bloqueia uma ação militar britânica contra a Síria
Mattel Lucr Slumps enquanto o apelo da Barbie continua a desaparecer	Mattel 2Q Lucro Falls, Barbie Sales Slide novamente
O Parlamento pró-russo da Crimeia aprova a declaração de independência	Ucrânia contra Rússia: diminuindo a influência internacional russa?
Obama Mulls limitou ação militar na Síria	Obama pede ação militar contra a Síria, mas procurará ok do Congresso
O projeto de lei de imigração limpa o voto -chave e pode ser aprovado pelo Senado nesta semana	A reforma da imigração passa o teste importante do Senado
O Parlamento Russo aprova o uso do Exército na Ucrânia	Associated Press: demonstrações pró-Rússia quebram na Ucrânia
O número de mortos sírio atingiu quase 93.000, diz ONU	Conflito sírio Toll agora com mais de 93 000, na ONU diz
O exército derruba o presidente egípcio Morsy	preocupação mundial sobre a deposição do presidente do Egito
Austrália envia tropas para proteger sua embaixada em Bagdá	Tropas enviadas para proteger a embaixada
Presidente Obama para buscar a aprovação do Congresso antes de agir na Síria	França para aguardar os EUA Decisão do Congresso sobre a Síria
A agência iraniana deixa a Rafsanjani observa a crítica do governo sírio	nós. , os presidentes franceses prometem punir o governo sírio
Toyota, Honda, Nissan e Mazda recordam 3 milhões de carros japoneses após falha	Honda, Nissan e Toyota em enorme recall sobre infladores de airbags
Shashi Tharoor admitiu a AIIMS	Shashi Tharoor hospitalizado após dor no peito
Celebrações de ano novo em todo o mundo	Reveleiros ao redor do mundo anel em 2014
O líder de protesto antigovernamental tailandês morto a tiros em Bangkok Violence-Police	Os manifestantes tailandeses obstruem o voto; 1 morto em violência
Cinco mortos, 40 desaparecidos no desastre de trem do Canadá	Death confirmada na explosão de trem do Canadá
Balão de ar quente 'pega fogo e bate'	O balão de ar quente acessa no VA. ; 3 ausentes
Líder francês para aguardar o Congresso dos EUA votar na Síria	A França espera por nós votar sobre greves na Síria
4 jornalistas franceses libertados após 10 meses na Síria	Jornalistas franceses sequestrados encontrados na fronteira síria da Turquia
Obama para dar grandes mudanças climáticas discursos	The Caucus: Obama para revelar o plano climático na terça -feira
A França recebe o acordo EUA-Rússia na Síria	Acordo de alcance dos EUA-Rússia na Síria
as ações aumentam após a saída do verão, as saídas alimentadas	DiPs do dólar americano quando Lawrence Summers sai do Federal Reserve Race
PM da Síria escapa de assassinato, diz Regime	Primeiro Ministro da Síria sobrevive à tentativa de assassinato
Pesquisas abertas na eleição presidencial do Afeganistão	O Afeganistão inicia votos de escoamento para eleições presidenciais
29 mortos em 3 dias de distúrbios do Sudão	Dias sangrentos no Sudão
George Zimmerman não encontrou o assassinato de Trayvon Martin	Blog ao vivo: George Zimmerman não culpado
nós. AL-QAEDA RAIDS na Somália, a Líbia Trigger Backlash	Nós captura o líder da Al-Qaeda na Líbia; Raids Somália
EUA confirmam o uso de armas químicas pelo regime sírio	Os EUA devem mostrar evidências do uso de armas químicas pela Síria
Os requerentes de asilo do Sri Lanka ganham alívio temporário da Austrália	Os requerentes de asilo do Sri Lanka que enfrentam investigação criminal após serem devolvidos pelas autoridades australianas
Fundador do WikiLeaks do Tribunal Sueco para permanecer em detenção	O Tribunal Sueco defende a ordem de detenção no fundador do Wikileaks Assange
Dezenove magoados no dia da mãe atirando em Nova Orleans	A polícia promete resolver tiroteios de 19 em Nova Orleans
Birmânia promete libertar todos os prisioneiros políticos até o fim do ano	Mianmar para libertar prisioneiros políticos
Obama aguenta greves na Síria	Reino Unido incentiva os países sobre a Síria Aid
um morto em confrontos nos escritórios da Irmandade Muçulmana	Síria zomba do modelo de Irmandade Muçulmana do Egito
Marinheiros mortos na Índia Submarine Blast	Vários marinheiros indianos mortos após explodos e pia submarinos
T.S.A. Oficial é morto no aeroporto de Los Angeles	Obama 'preocupado' com o tiroteio no aeroporto de Los Angeles
5 morre em confrontos cristãos-muçulmanos no Egito	Egito exige calma após confrontos mortais cristãos-muçulmanos
Jordan optou por tomar um assento saudita no Conselho de Segurança da ONU	Jordan eleito para o assento do Conselho de Segurança da ONU que a Arábia Saudita rejeitou
Taliban reivindica ataque mortal no aeroporto de Karachi	Gunfeiros frescos no aeroporto de Karachi
Maldivas começa a votar em uma pesquisa presidencial cheia de controvérsia	As Maldivas Hit-Hit detém uma nova pesquisa presidencial
África do Sul se lembra de Nadine Gordimer	A autora Nadine Gordimer morre aos 90
James Gandolfini da fama de 'sopranos' morta aos 51	O ator James Gandolfini, 51, morre de parada cardíaca
21 pacientes idosos morrem em incêndio sul -coreano	incêndio no hospital por idosos mata 21 na Coréia do Sul
Pelo menos 18 mortos no bombardeio da mesquita do Iraque	Mais de 60 mortos no funeral do Iraque
A polícia cercam os manifestantes em Belfast antes de G8	protesto pacífico anti-G8 realizado em Belfast
Egito Irmandade muçulmana rejeita a oferta de gabinete	Ordens do Egito prisões dos líderes da irmandade
avião da Malásia carregando 239 pessoas desaparecidas	PM da Malásia diz ainda nenhum sinal de falta de avião
Voo da Malaysia Airlines ausente	O avião de passageiros da Malaysia Airlines temia ter travado
Casas de nível de Tornados em Oklahoma, 1 morto	VÍDEO: VÍDEO: Destruição de Tornado em Carney, Oklahoma
Pope Francis chega na Jordânia	papa para começar delicado viagem de Oriente Médio na Jordânia
3 feridos em pistoleiros em Cabul	Mesquita de pistoleiros atacam Shi '
7.2 Quake atinge as Filipinas Centrais, matando 85	7.2 Terremoto de magnitude atinge as Filipinas
Polícia de tumultos turcos Gás lacrimogêneo no protesto de Istambul	Vídeo: Showdown da Turquia: Polícia de Riot enfrenta manifestantes
Os manifestantes da Turquia 'para ficar no parque', apesar da concessão da PM	Manifestantes turcos se recusam a deixar o Parque Istambul, apesar da promessa de Erdogan
O chefe do exército da Líbia renuncia após confrontos em Benghazi matar 31	O chefe do exército da Líbia desiste após a agitação
Milhares de ingressos no dia da vitória março em Donetsk	Vladimir Putin participa do desfile do Dia da Vitória em Moscou
Conteúdo do Facebook para assumir a tela inicial inteira	O Facebook começa a revelar 'New Home On Android'
Mecreios Titanices buscam milhares em leilão	O Titanic Violin é vendido por mais de US $ 1,6 milhão em leilão
Premier chinês solicita opiniões de especialistas sobre crescimento econômico	XI: China confiante em crescimento econômico sustentável
Polícia turca de incêndio com gás lacrimogêneo, canhões de água para limpar o parque	Polícia de tumultos dispersam os manifestantes em Istambul Park
Mergulhadores puxam corpos da balsa afundada; TOLL Tops 50	A Coréia do Sul afundou o número de mortos por ferry 'atinge 50'
O Afeganistão Libera o vídeo mostrando o soldado dos EUA de mão	O vídeo do Taliban mostra a transferência do soldado dos EUA
As eleições presidenciais afegãs seguem para um segundo turno em junho	Conselho Eleitoral Afeganistão para liberar resultados finais
Obama chega à Malásia; Terceira parada no Asia Tour	Presidente Obama na terceira parada em viagem à Ásia
Yahoo! promete publicidade de 'luz' do Tumblr Bloggers	Yahoo! confirma o acordo do Tumblr por US $ 1,1 bilhão
À medida que a condição de Mandela melhora, a ansiedade da África do Sul permanece	Mandela respondendo ao tratamento, diz Zuma, na África do Sul,
Pistorius de Oscar choroso	'Eu tenho pesadelos terríveis - eu posso sentir o cheiro de sangue': recapitular enquanto o Oscar Pistorius começa o testemunho de julgamento por assassinato
George Zimmerman achou inocente de assassinato de Trayvon Martin	George Zimmerman Verdict impulsiona as notícias a cabo para o modo TalkRadio
Osborne diz que não está preocupado com os preços das casas	George Osborne diz que o déficit pode ser erradicado sem novos aumentos de impostos
Tolho de morte do terremoto da China sobe para 180 mortos	O número de mortos aumenta para 179 no terremoto da China
Wayne Rooney pediu para deixar o Manchester United, Alex Ferguson revela em novo livro	Sir Alex Ferguson Autobiografia Visão geral: Wayne Rooney pediu ao Manchester United que assine Mesut Ezil 'antes de pedir para sair'
Dez resgatou em Waterford, costas de Dublin	Seis resgatados após o barco limite em Dublin Bay
Cannes Hotel Raid Nets 40 milhões de jóias	Jóias no valor de 40m roubadas em Cannes
Putin declara que as paralímpicas de inverno Sochi abrem	Putin abre paraolímpicos como protesto encenado
Raids de prostituição infantil resgate 105 jovens	A repressão à prostituição infantil dos EUA leva ao FBI fazer 150 prisões
A Coréia do Norte promete reiniciar instalações nucleares	A Coréia do Sul promete uma resposta rápida ao norte; nós. Posições Destruidor
França tem uma linha difícil nas negociações nucleares do Irã	FM japonês visita o Irã para negociações
pistoleiros matam 9 turistas estrangeiros, 1 paquistanês	Gunmen Storm Hotel, Mate estrangeiros
O Sudão libera a mulher cristã condenada à morte por apostasia	Meriam Ibrahim: Mulher Apostasia Sudanesa 'Reestrested' com Família no Aeroporto
O Parlamento da Ucrânia vota para demitir presidente	O chefe de oposição da Ucrânia quer mais protestos
Mandela passa o terceiro dia no hospital	Mandela no hospital pelo 3º dia
O Google agora tem 1B Usuários mensais ativos do Android	O Google revela oficialmente a TV Android
inundação após forte aviso de chuva	Alertas de inundação emitidos enquanto a chuva varre o país
Casa tailandesa se dissolveu, mas os protestos persistem	Primeiro Ministro da Tailândia dissolve o parlamento
um morto em confrontos nos escritórios da Irmandade Muçulmana	Egito: os manifestantes assumem a sede da Irmandade Muçulmana
Segurança apertada na Miss World Final na Indonésia	Dezenas ainda faltavam após o barco afundar na Indonésia
Os sírios detonaram a bomba contra a patrulha israelense na fronteira com golão	A bomba explode perto da patrulha de Israel em Golan; Sem baixas
Snowden disse para procurar asilo no Equador, Islândia	Snowden 'Dado o documento de refugiados pelo Equador'
Voo de Pequim, desaparecido da Malásia	O vôo da Malásia para Pequim perdeu o contato
A pesquisa de avião se concentra em detritos	Falta MH370: Aviões enviados para verificar 2 objetos
mulheres sauditas para protestar contra a proibição de dirigir	Mulheres sauditas dirigem em protesto com pouco problema
Obama, Hollande Hail transformou o relacionamento americano-francês	Hollande chega para a visita de estado dos EUA
Boston Bombers traz eco do legado de violência da Chechênia	Suspeitos de bombardeio de Boston não conectados à Chechênia
O parlamento russo permite que Putin use militar na Ucrânia	O presidente Obama alerta a Rússia para ficar de fora da Ucrânia
3 explosões em Patna à frente do comício de Modi; 1 morto, 5 ferido	Blasts Mate 5 em Modi Rally em Patna
A Alemanha recebe o acordo nuclear do Irã	Ministro das Relações Exteriores da França: o acordo nuclear do Irã alcançado
Catar, Turquia e Irã condenam a violência no Egito	un. O chefe Ban Ki-moon condena a repressão no Egito
Bolívia vs. Europa sobre o atraso do avião ligado a Snowden	O avião do líder boliviano redirecionou o medo de Snowden
Mulher morre após o tiroteio de Newport	Mulher morre e homem gravemente ferido depois de atirar na Newport Street
Rival com rival interrompe o início do Ramadã	Rival rival do Egito planejado em meio a tensões altas
Petra Kvitova vence o título de Wimbledon	Petra Kvitova esmaga Eugenie Bouchard para reivindicar o segundo Wimbledon
Homem preso em uma parcela de carros -bomba em Kan. aeroporto	Federais: homem planejado Kan. ataque aeroportuário
Relatórios de liberação do Hospital Nelson Mandela 'Incorreto'	Nelson Mandela vai para casa após a estadia do hospital
Putin defende ação russa na Ucrânia para Merkel	A OTAN diz que a ação russa ameaça a paz na Europa
Serviço funerário realizado para Margaret Thatcher	Rainha, líderes para se despedir de Thatcher
Homem morto em ataque terrorista mortal na rua London	Soldado invadido até a morte em Londres
Pesquisas da Malásia abertas na eleição crucial	Enorme participação nas eleições nacionais da Malásia
O Tribunal do Egito proíbe todas as atividades da Irmandade Muçulmana	Irmandade muçulmana banida no Egito
As ações mundiais aumentam nas esperanças alimentadas para manter o estímulo	Fed espera manter o estímulo
Sem vencedores em uma guerra de sanções	o impacto das sanções na Rússia
Manifestantes do Brasil para marchar em 80 cidades	Os protestos do Brasil exploram a frustração de não ter
O soldado sul -coreano teria fogado depois de matar 5 camaradas na fronteira com a Coréia do Norte	O soldado sul -coreano mata camaradas e foge
Merkel pressiona Putin para ajudar a acalmar a Ucrânia	Funcionários da Cruz Vermelha detida para 'espionagem' na Ucrânia
O BJP pode ganhar 5-7 assentos em Delhi, a pesquisa de opinião diz	O BJP pode ganhar mais de 40 assentos na pesquisa UP
Rocky Road Ahead for Egypt Presidente eleito Sisi	Perfil: presidente eleito egípcio Abdel Fattah al-Sisi
Murray First GB Men's Wimbledon Champion desde 1936	Andy Murray ganha o título histórico de Wimbledon
China, UE Reach Settlement em painéis solares	Europa e China concordam em liquidar a luta pelo painel solar
Segundo assalto de jóias de Cannes em meses	Cannes Thief roubou jóias da exposição Leviev do Hotel
Tribunal do Egito sentenças 102 islâmicos a 10 anos de prisão	Corte egípcio prisões 102 apoiadores de Morsi
Putin 'não decidiu se deveria enviar tropas para a Ucrânia ainda'	Vladimir Putin pede que o Parlamento seja permissão para enviar tropas para a Crimeia
O Centro de Emergência da Capital Tailândia diz 4 feridos em explosão no local de protesto antigovernamental	28 feridos em explosões no local de protesto de Bangkok
O amigo de Oscar Pistorius relata o incidente de bala no restaurante	Oscar Pistorius 'acidentalmente disparou bala no restaurante movimentado - depois pediu ao amigo que assumisse a culpa'
Esposa da Índia Ministro encontrou morto após a briga no Twitter	A esposa do ministro indiano morreu 'não natural' morte, shows de autópsia
Nós aquecem para a Síria Plano de Anistia Química	Rússia, Síria trabalha no plano de armas químicas 'concreto'
Os edifícios de Nova York entram em colapso de pedágio para sete	Explosão de edifícios de Nova York mata 4 outros desaparecidos
Irã NUKE fala para ser estendido por 4 meses	Prazo nuclear do Irã estendido até 24 de novembro
A Índia induz C-17Globemaster-III na IAF	A Força Aérea Indiana induz os três primeiros C-17s em serviço
Copa do mundo atingida pela nova morte do estádio	Trabalhador morre no estádio da Copa do Mundo
O Egito exige que a comunidade internacional age contra a agressão de Israel em Gaza	Paquistão condena a agressão israelense em Gaza
Ucrânia Presidente do Presidente Desconhecido	O presidente ucraniano compara a situação em Kiev à Alemanha nazista
Tata Nano e outros carros pequenos indianos falham nos testes de colisão	Como o carro mais barato do mundo faz no teste de colisão?
Centenas sitiadas na mesquita de Fateh do Egito	Dezenas morrem no Egito Blood Bathath
Três adolescentes israelenses desaparecidos na Cisjordânia	Pesquisa massiva lançada por 3 adolescentes temidos sequestrados na Cisjordânia
A Irlanda sai de resgate com a última parcela do FMI	Irlanda livre de manilhas de resgate, mas não fora de florestas
Israel concorda em uma pausa "humanitária" em ataques aéreos; 4 meninos mortos brincando na praia de Gaza	Srael Naval Strike mata crianças na praia de Gaza
A Grécia chega a um acordo com a Troika, a parcela de resgate esperada em poucos dias	Inspetores de dívida chegam ao acordo com a Grécia
O Conselho da Vila Indiana ordena o estupro de gangue da mulher como trocadilho ...	Tribunal de Kangaroo no leste da Índia supostamente ordena estupro de gangue de mulher
A Coréia do Norte corta a ligação final com o sul na nova escalada da crise nuclear	A Coréia do Norte pode estar preparando um novo teste nuclear
príncipe William e esposa Kate apresentam o bebê príncipe	World espera para conhecer o novo príncipe
tiroteios no desfile do dia da mãe em nós	17 feridos em tiro no desfile de Nova Orleans
britânico entre 50 mortos na Rússia acidente de avião	A Rússia busca respostas sobre o acidente de avião mortal
Quake da China deixa 181 mortos, 24 faltando	O terremoto de Sichuan deixa a devastação - em fotos
A China pede a ação precoce sobre o acordo de armas da Síria	Watchdog recebe detalhes do arsenal químico sírio
As colegas nigerianas desaparecidas começam no segundo mês em cativeiro	Meninas nigerianas desaparecidas por um mês
Murray termina com 77 anos de espera pela vitória britânica	Murray ganha o título de Wimbledon termina a agonia dos britânicos 77 anos
Crashos de avião da Malaysia Airlines na fronteira da Ucrânia -Rússia - ao vivo	EUA: Rússia em massa tropas na fronteira da Ucrânia
A França ameaça o Google com multas de privacidade	O Google ameaçou com desprezo ao tribunal por violação de privacidade
A ação militar direta exigirá uma votação adicional	Forest Whitaker 'Todos nós compartilhamos um vínculo comum'
Gov sírio 'T, oposição para se encontrar na' mesma sala '	Lados em guerra da Síria não na mesma sala para o início das negociações
Paquistão, Índia Troca fogo ao longo da fronteira da Caxemira	militares do Paquistão dizem que o oficial morto por incêndio indiano na Caxemira
pistas de Heathrow fechadas depois que o avião BA faz pouso de emergência	BA Jet faz pouso de emergência após incêndio do motor
As reivindicações de magnatas ganham na Ucrânia e promete procurar futuro na UE	Assembléias de votação são abertas nas eleições presidenciais ucranianas
nós para determinar a extensão do uso de armas químicas pela Síria	O que sabemos até agora sobre armas químicas na Guerra Civil da Síria
Egito na beira como massa de multidões	Egito tenso à medida que o prazo do exército se aproxima
Jodi Arias Júri para escolher pena de morte ou vida	O júri do Arizona considera Arias elegíveis para pena de morte no assassinato de ex-namorado
Por que Mitch McConnell não está tão condenado como essa enquete faria você acreditar	Mitch McConnell empatou em uma nova pesquisa. Ele já sente falta de Ashley Judd?
O nascimento do bebê real deixa o avô príncipe Charles "Overyded" para William e Kate	bebê real a caminho; Catherine entra no hospital em trabalho de parto
A guerra secreta no Paquistão	Novo grande terremoto balança no sudoeste do Paquistão
Obama é o efeito de inspiração de Mandela	Obama se reúne com a família Mandela
Bill Qantas vai para um Senado hostil	Qantas mais perto da propriedade estrangeira
Os apoiadores de Morsi protestam no Egito	Morsi Batchers desafiadores diante da ameaça do governo do Egito
Os esforços de resgate continuam no desastre de balsa coreano	A raiva se espalha sobre o afundamento de balsa coreano
88 anos e Tiwari se casa com a mãe de seu filho biológico	A Índia e Tiwari se casa com a mãe de Son
Bangladesh para permitir sindicatos para trabalhadores de roupas	Bangladesh colapsa pesquisar; Tollo de morte 1.127
Síria concorda em entregar armas químicas	Cameron do Reino Unido: Síria, Rússia deve mostrar a proposta de armas químicas é genuína
Autoridade de reivindicações de Putin da Rússia para invadir a Ucrânia	Kremlin: Putin ainda para decidir usar tropas russas na Ucrânia
Oficial sênior do CPC conhece o enviado especial do líder da RPDC	O líder norte -coreano envia 'enviado especial' para a China
Us Probles Global Travel Alert, Citing-Al Qaeda	Departamento Estadual. Questões amplas alertas de viagem, diz o ataque terrorista possível
Libere francês suspeita de terror, mas o cobra por incitar o ódio racial	França diminui as acusações de terror contra o músico
A agitação da peru continua apesar do protesto do final do estacionamento	O primeiro -ministro turco, Erdogan
Boko Haram diz que o vídeo mostra meninas nigerianas desaparecidas	As colegas nigerianas: o Boko Haram lança um novo vídeo, oferece comércio de estudantes para prisioneiros militantes
Os preços do petróleo misturados na Ásia	Os preços do petróleo misturados no comércio asiático
manchetes nos principais jornais iranianos em 5 de agosto	manchetes em vários jornais iranianos em 19 de outubro
Principais notícias asiáticas às 12h30 GMT	Top Asian News 7: 48 da manhã GMT
Top Asian News 7: 48 da manhã GMT	Principais notícias asiáticas às 23:00 GMT
Futuros de títulos do Tesouro da China abrem um pouco mais de quarta -feira	Futuros de títulos do tesouro da China fecham mais alta terça -feira
Estoques indianos abrem mais baixo	Estoques indianos fecham mais baixo
Enfermeira primeiro a contrair o Ebola fora da África	Enfermeira espanhola primeiro a contrair Ebola fora da África
Pope exige ação sobre as mudanças climáticas na encíclica de rascunho	Pope pede ação sobre a mudança climática na encíclica de rascunho
manchetes nos principais jornais iranianos em 5 de agosto	Manchetes nos principais jornais iranianos em 27 de setembro
manchetes nos principais jornais iranianos em 5 de agosto	Manchetes nos principais jornais iranianos em 24 de setembro
Nigéria confirma o 2º caso de Ebola	Nigéria confirma 2 novos casos de Ebola
Os jihadistas sequestram 90 cristãos na Síria: Monitor	é sequestrado 90 cristãos na Síria: monitor
Inspirado Nishikori pronto para a final de Londres ATP	Inspirado Nishikori pronto para a final de Londres ATP
Principais notícias asiáticas às 14h30 GMT	Principais notícias asiáticas às 10:00 GMT
19 mortos no ataque do museu Tunis	21 mortos no ataque de armas do Museu Tunísia
Preços do petróleo no comércio asiático	Os preços do petróleo misturados no comércio asiático
Kerry cauteloso antes que o New Irã fale, cita 'lacunas importantes'	Kerry cauteloso antes que o New Irã fale, cita 'lacunas importantes'
Campos de treinamento de verão de Gaza: 'Nenhuma hora restante para jogar' agosto. 11, 2015	Campos de treinamento de verão de Gaza: 'Não há tempo para jogar'
As ações de Cingapura abrem 0,28 % menor na quinta -feira	As ações de Cingapura abrem 0,19 % maior na quinta -feira
Como a média industrial da Dow Jones se saiu na segunda -feira	Como a média industrial da Dow Jones se saiu na quarta -feira
Quem é Jihadi John?	Quem era 'Jihadi John? '
Target aumenta a previsão de ganhos após o lucro aumentando	Target aumenta a previsão de ganhos de 2015 após saltos de lucro
Como a média industrial da Dow Jones se saiu na sexta -feira	Como a média industrial da Dow Jones fez segunda -feira
Iraque Shi 'Ite Militia Mate dezenas de sunitas em tiro	Shi 'Ite Militia Mate dezenas de sunitas iraquianos em tiro
Twitter processa pela vigilância do governo	Twitter processa o governo dos EUA por vigilância
China Hushen 300 Índice Futuros abrem alta quinta -feira	China Hushen 300 ÍNDICE FUTURES OPEN MIXED SEXTA SEXTA -FEIRA
Como a média industrial da Dow Jones fez sexta -feira	Como a média industrial da Dow Jones se saiu na sexta -feira
Como a média industrial da Dow Jones se saiu na segunda -feira	Como a média industrial da Dow Jones se saiu na quinta -feira
Principais notícias asiáticas às 13h30 GMT	Top Asian News 11: 42 da manhã GMT
Irã, funcionários da AIE se reúnem antes do prazo nuclear de março	Irã, funcionários da AIE se reúnem antes do prazo nuclear de março: ISNA
Como a média industrial da Dow Jones fez sexta -feira	Como a média industrial da Dow Jones se saiu na terça -feira
Manchetes nos principais jornais iranianos em 4 de outubro	manchetes em vários jornais iranianos em 19 de outubro
Estoques indianos fecham mais baixo	As ações indianas fecham mais alto
10 coisas para saber para quarta -feira	10 coisas para saber para hoje
Taxas de câmbio na Índia	Taxas de câmbio na Tailândia
As ações de Cingapura abrem 0,35 % maior na quarta -feira	As ações de Cingapura abrem 0,19 % maior na quinta -feira
Paquistão: emergência diária & amp; Relatório de informações situacionais de resposta, 25 de outubro de 2014	Paquistão: Paquistão: Relatório de Informações Situatacionais de Emergência e Resposta, 22 de setembro de 2014
atentados matam 9 pessoas na capital iraquiana	atentados matam 19 pessoas no Iraque
Sua manhã leia para domingo, 6 de setembro de 2015 em Toronto	Sua manhã leia para domingo, 12 de julho de 2015 em Toronto
Principais Notícias Asiáticas 13: 25:00 GMT	Top Asian News 7: 48 da manhã GMT
Notícias de terrorismo e conflito israelense -palestino (7 a 21 de outubro de 2014)	Notícias de terrorismo e conflito israelense-palestino (24 a 30 de junho de 2015)
Como a média industrial da Dow Jones se saiu na quinta -feira	Como a média industrial da Dow Jones se saiu na sexta -feira
Como a média industrial da Dow Jones fez segunda -feira	Como a média industrial da Dow Jones fez quinta -feira
Atualização do World News, o que você precisa saber	Atualização de notícias financeiras, o que você precisa saber
O procurador -geral dos EUA renuncia	Procurador -Geral dos EUA Eric Holder para renunciar
nós. , UE amplia sanções à Rússia	nós. , UE aumenta as sanções à Rússia
10 coisas para saber para quarta -feira	10 coisas para saber para quinta -feira
petróleo sobe no comércio asiático	Preços do petróleo no comércio asiático
Como a média industrial da Dow Jones se saiu na quinta -feira	Como a média industrial da Dow Jones fez sexta -feira
Taxas de câmbio na Índia	Taxas de câmbio em Cingapura
Como a média industrial da Dow Jones fez segunda -feira	Como a média industrial da Dow Jones se saiu na sexta -feira
Principais notícias asiáticas às 9:00 GMT	Top Asian News 8: 39 da manhã GMT
Top Asian News 7: 48 da manhã GMT	Principais notícias asiáticas às 9h30 GMT
Principais notícias asiáticas às 14h30 GMT	Principais Notícias Asiáticas 13: 25:00 GMT
Principais notícias asiáticas às 9h30 GMT	Top Asian News 4: 39 GMT
Principais notícias asiáticas às 7:00 GMT	Top Asian News 8: 39 da manhã GMT
A estrela dos Vingadores Patrick MacNee morre	A estrela dos Vingadores Patrick MacNee morre com 93 anos
Como a média industrial da Dow Jones fez sexta -feira	Como a média industrial da Dow Jones fez quarta -feira
Sua manhã leia para domingo, 19 de julho de 2015 em Toronto	Sua manhã leia para segunda -feira, 30 de março de 2015 em Toronto
Como a média industrial da Dow Jones fez quarta -feira	Como a média industrial da Dow Jones se saiu na segunda -feira
Como a média industrial da Dow Jones se saiu na sexta -feira	Como a média industrial da Dow Jones se saiu na terça -feira
Como a média industrial da Dow Jones se saiu na terça -feira	Como a média industrial da Dow Jones fez quinta -feira
Comet Dead With Skull Face Scims Passado Terra no Halloween	Cometa morta com o crânio Face To Hurtle By Earth no Halloween
Hajj para ir em frente, apesar do colapso do guindaste, as autoridades promete	Hajj para ir em frente, apesar do colapso do guindaste
Os preços do petróleo aumentam mais após os ganhos na Ásia	Os preços do petróleo aumentam ainda mais na Ásia
mais recente da Missão de Monitoramento Especial da OSCE (SMM) para a Ucrânia, com base em informações recebidas a partir de 19: 30hrs, 16 de outubro de 2015	Ucrânia: mais recente da Missão de Monitoramento Especial da OSCE (SMM) para a Ucrânia com base nas informações recebidas a partir de 18: 00 (Kiev Time), 28 de setembro de 2014
10 mortos nos atentados da Nigéria	71 mortos na Síria bombardeio
13 rebeldes PKK mortos nas operações militares da Turquia	61 rebeldes mortos em operações militares
O Tribunal do Egito adia a sentença de morte de Morsi	O Tribunal do Egito confirma a sentença de morte de Morsi
at & amp; T ajudou os EUA NSA em espionar o tráfego da Internet: N.Y. vezes	at & amp; T ajuda os EUA Espionando na Internet: N.Y.Times
Top Asian News 11: 42 da manhã GMT	Principais notícias asiáticas às 9:00 GMT
Top Asian News 11: 42 da manhã GMT	Principais notícias asiáticas às 2:00 GMT
petróleo sobe no comércio asiático	O petróleo cai no comércio asiático
Pope recebeu a República da África Central	Pope conhece muçulmanos na República Central da África
Os índices de ações de Xangai fecham mais na sexta -feira	As ações da China se aproximam mais na sexta -feira
Terremoto poderoso atinge o leste do Japão	Terremoto poderoso atinge o Nepal
O Facebook ativa o recurso de segurança após o bombardeio da Nigéria	O Facebook ativa o recurso de segurança após o bombardeio de Yola
A estrela dos Vingadores, Patrick MacNee, morre com 93 anos	A estrela dos Vingadores, Patrick MacNee, morreu aos 93 anos de idade
O Batty, Pendrel, do Canadá, ganha ouro, prata na bicicleta de montanha feminina	Pendrel do Canadá, Batty ganham ouro, prata em bicicleta de montanha
O ISIS traz sua guerra ao Líbano - e pode ser uma parte essencial do plano mestre de Abu Bakr al -Baghdadi	O ISIS traz sua guerra para o Líbano - e pode ser a chave para um plano diretor
7.3 Quake de magnitude atinge o Nepal devastado	7.9 Quake de magnitude atinge o Nepal
Os republicanos da Câmara dos EUA elegem Paul Ryan como Presidente	Republicanos da Casa dos EUA Ryan Ryan para o Presidente
cessar-fogo nas extremidades de Gaza	cessar -fogo em Gaza em andamento
Suspeito de greve de drones nos EUA mata 9 em funcionários do Afeganistão	Suspeita -nos dos EUA, o greve de drones mata 6 no Paquistão
Principais notícias asiáticas às 9:00 GMT	Top Asian News 4: 39 GMT
Principais Notícias Asiáticas 13: 25:00 GMT	Principais notícias asiáticas às 4:30 da manhã GMT
Principais notícias asiáticas às 13:00 GMT	Top Asian News 7: 48 da manhã GMT
Principais notícias asiáticas às 13:00 GMT	Top Asian News 8: 39 da manhã GMT
Principais notícias asiáticas às 16:00 GMT	Top Asian News 3: 12h GMT
Principais notícias asiáticas às 16:00 GMT	Top Asian News 8: 39 da manhã GMT
As ações de Cingapura abrem 0,35 % maior na quarta -feira	As ações de Cingapura abrem 0,06 % menor na terça -feira
As ações de Cingapura abrem 0,83 % maior na quarta -feira	As ações de Cingapura abrem 0,06 % menor na terça -feira
Futuros de títulos do Tesouro da China abrem alta terça -feira	Futuros de títulos do Tesouro da China Close Misted quarta -feira
Pelo menos 59 mortos, 600 faltando após enorme deslizamento de terra na Guatemala	Pelo menos sete mortos, pontuações ausentes após deslizamento de terra na Guatemala
Nigéria declara emergência nacional sobre o ebola	Nigéria declara um estado de emergência sobre a crise do Ebola
Taxas de câmbio na Tailândia	Taxas de câmbio em Cingapura
Quanto você sabe sobre o ISIS?	Quanto você sabe sobre o Serviço Secreto?
Mali: Declaração de imprensa do Conselho de Segurança no Mali	Iêmen: declaração de imprensa do Conselho de Segurança no Iêmen
Como a média industrial da Dow Jones fez sexta -feira	Como a média industrial da Dow Jones se saiu na segunda -feira
Como a média industrial da Dow Jones fez sexta -feira	Como a média industrial da Dow Jones se saiu na quarta -feira
22 mortos em atentados ao Iraque	71 mortos na Síria bombardeio
5 coisas a saber para o seu novo dia - sexta -feira, 28 de agosto	5 coisas a saber para o seu novo dia - quarta -feira, 15 de julho
surto de ebola: mantenha -se atualizado	surto de ebola: acelere
Ações chinesas abrem mais alta na quinta -feira	Ações chinesas abrem na sexta -feira inferior
Quem: Ebola Death Toll sobe para 729	Quem: Ebola Death Toll atinge 932
O procurador -geral dos EUA renuncia	Procurador -geral Eric Holder para renunciar
Bomber feminino mata dois na Nigéria	Bombeiros de suicídio feminino ataque na Nigéria
EUA: testes de saúde positivos para o Ebola	2º Testes de Trabalhador de Saúde dos EUA positivos para Ebola
Manchetes nos principais jornais iranianos em 27 de setembro	manchetes em vários jornais iranianos em 19 de outubro
AbbVie azeda em negócios de US $ 55 bilhões após alterações fiscais	Abbvie esfria em US $ 55 bilhões de acordo depois de alterações fiscais dos EUA
A Áustria agora diz que mais de 70 corpos que se pensam ser de migrantes estavam em caminhão	A Áustria encontra até 50 corpos que se pensam ser de migrantes em caminhão
Serra Leoa declara o estado de emergência sobre o Ebola (atualizado)	O presidente da Serra Leoa declara o estado de emergência sobre o ebola
Missão de Monitoramento Especial da OSCE para Ucrânia Vice -Chefe do Monitor Alexander abraço para visitar Donetsk	Ucrânia: Missão de Monitoramento Especial da OSCE à Ucrânia Vice -Chefe do Monitor para visitar o sudeste da Ucrânia
Departamento de Estado para liberar mais dos e -mails de Hillary Clinton	O Departamento de Estado dos EUA libera e -mails de Hillary Clinton
Yuan chinês se fortalece para 6.3665 contra US $ terça -feira	Yuan chinês enfraquece para 6.3459 contra o USD na sexta -feira
Futuros de títulos do Tesouro da China abrem alta terça -feira	Futuros de títulos do Tesouro da China Close Misted Friday
5 coisas que você precisa saber quarta -feira	5 coisas que você precisa saber neste fim de semana
6.1 Quake de magnitude atinge a área da baía	7.9 Quake de magnitude atinge o Nepal
nós. Para fornecer US $ 351 milhões para a cúpula de ferro de Israel	Os EUA aprovam US $ 225 milhões para a cúpula de ferro de Israel
China em alerta alto para o tufão Kalmaegi	China emite alerta amarelo para o tufão Kalmaegi
Coréia do Sul declara o final do surto de MERS	Quarto coreano morre no surto de MERS
Futuros de títulos do tesouro da China fecham a segunda -feira mais alta	Futuros de títulos do Tesouro da China abrem um pouco mais de quarta -feira
s. A Coréia reduz a taxa -chave à medida que o MERS surge como ameaça à recuperação	A Coréia do Sul reduz a taxa -chave como Mers temia diminuir a recuperação
Tornados mortais greve nos EUA central.	5 mortos como tornados explodir os EUA centrais.
Os rebeldes do Iêmen se recusam a embarcar no avião para negociações de paz de Genebra	A delegação rebelde do Iêmen chega para as negociações de paz de Genebra
Yuan chinês se fortalece para 6.1318 contra o USD quarta -feira	Yuan chinês enfraquece para 6.1402 contra USD na segunda -feira
uma história de dois pais	Uma história de dois trunfos
ataques aéreos liderados pela Arábia Saudita atingem a capital iemenita	ataques aéreos sauditas na capital do Iêmen Kill 29
7.0 Magnitude Quake atinge 42 km a leste de Tambo, Peru-USGS	7.5 Quake de magnitude atinge 35 km a leste de Lamjung, Nepal: USGS
Presidente da Nigéria promete caçar atacantes de mesquitas	O presidente da Nigéria ordena a investigação do ataque da mesquita
Militantes do Estado Islâmico Raze Raze Iraque's Ancient Hatra City	Militantes do Estado Islâmico Bulldoze Antiga Cidade de Nimrud
As negociações nucleares do Irã vão para as horas extras	As negociações nucleares do Irã mudam para a alta marcha
Novo chefe de manutenção da paz da ONU nomeado para a República Central da África	ONU assume a manutenção da paz na República Central da África
EUA lança ataques aéreos contra o ISIS	US lança os primeiros ataques aéreos contra a Síria
A inteligência alemã gravou Clinton, Kerry liga	Inteligência alemã teria espiado em Kerry, Clinton liga
Centenas de mortos quando o terremoto forte atinge o sudoeste da China	Pelo menos 367 mortos após o terremoto atingem o sudoeste da China
Centenas de mortos quando o terremoto forte atinge o sudoeste da China	Pelo menos 150 mortos após o terremoto atingem o sudoeste da China
Islândia reduz o alerta da aviação no vulcão	Islândia reduz o alerta do vulcão para laranja
Clinton pede desculpas pelo uso de conta de e -mail privada	sem desculpas de Clinton sobre seu uso de e -mail privado
s. Coréia relata a 11ª morte por surto de Mers	s. Coréia relata o 7º Mers Death, promete acabar com o surto
Ataque militante do Afeganistão mata quatro no sol superior	Ataque militante do Afeganistão mata o soldado FC no Baluchistão
17 mortos quando o ônibus cai em desfiladeiro em Almora	22 mortos quando o ônibus cai em desfiladeiro em J&K
Computer Glitch Grounds Aviões	Falha no computador Fundos nos voos dos EUA
Território palestino ocupado: a Arábia Saudita doa US $ 12 milhões para ajudar os refugiados palestinos	Território palestino ocupado: a Arábia Saudita promete US $ 500 milhões para a reconstrução de Gaza
nós. O paciente de ebola dá uma guinada para pior	Paciente de Ebola em Dallas se revezam para pior
5.5 Quake de magnitude atinge a Indonésia-USGS	5.7 Quake de magnitude atinge 140 km WSW de Naze, Japão-USGS
Pelo menos 3 mortos na explosão do Paquistão	Pelo menos 39 mortos no acidente de avião iraniano
Mali Hunts Jihadist Nightclub Killers	Militantes atacam a ONU como assassinos de boate jihadistas do Mali Hunts
7.3 Terremoto de magnitude atinge o Nepal	6.6 Terremoto de magnitude acaba com a Indonésia
Grécia adia o pagamento do FMI de € 300m	A Grécia padroniza o pagamento do FMI
Líder do ISIS principal morto no Airstrike	Líder do ISIS atingido por Airstrike
As ações de Tóquio abrem mais alto sobre os EUA. mercado	As ações de Tóquio abrem rastreamento mais alto dos EUA ganhos
O Parlamento do Irã apóia o acordo nuclear	Irã hardliners atacam negócios nucleares
17 Talibã morto em n. Afeganistão	A bomba do Taliban mata 29 no Afeganistão
Jato da Malaysia Airlines faz pouso de emergência na Austrália após 'incêndio do motor'	O avião da Turkish Airlines faz pouso de emergência após incêndio do motor
Jatos turcos atingem curdos no Iraque, Estado Islâmico na Síria	Os turcos ajudam os curdos iraquianos a combater o Estado Islâmico na Síria
Líder aéreo liderado pelos EUA mata o líder da Al-Qaeda na Síria: Pentágono	nós. Lança ataque aéreo contra o líder da Al Qaeda na Líbia: Pentágono
Os tanques israelenses atacam Gaza depois que o foguete disparou	Israel renova ataques aéreos em Gaza após fogueira
Os separatistas do Iêmen deixam palestras não patrocinadas	Os separatistas dos Iêmen suspendem a participação em palestras patrocinadas pela ONU
Serra Leoa para desligar por 3 dias para desacelerar o ebola	Sierra Leoa para cordão de 3 áreas para parar o Ebola
As forças israelenses atiram, mate o atacante palestino na Cisjordânia	Polícia israelense atira, mate a mulher palestina em Hebron
Grécia adia o pagamento do FMI de € 300m	A Grécia atrasa o pagamento de 300 milhões de euros ao FMI
As ações de Hong Kong fecham 1,27 pct mais alto	As ações de Hong Kong se aproximam mais ao meio -dia
Brasil para realizar eleições gerais no domingo	Dinamarca para realizar eleições gerais em 18 de junho
Como o escândalo da VW poderia ser o ponto de morte de Diesel	O escândalo da Volkswagen poderia ser o ponto de morte de Diesel?
Netanyahu: o acordo nuclear do Irã ameaça a existência de Israel	Netanyahu: o Plano Nuclear do Irã ameaça o mundo
Polícia de Burundi, gás lacrimogêneo, venceu manifestantes anti-presidentes	Polícia de Burundi, gás lacrimogêneo em protesto contra o presidente
Grã -Bretanha lança ataques aéreos no ISIS na Síria	Reino Unido para lançar ataques aéreos contra está na Síria
Os carros autônomos do Google tiveram 11 acidentes	Carros autônomos do Google envolvidos em 11 acidentes
Havaí prepara para o primeiro furacão em 22 anos	Havaí Bring como primeiro furacão em 22 anos se aproxima
As forças israelenses detêm 4 palestinos na AQSA Compound Sit-In	As forças israelenses detêm 12 palestinos durante a noite
Sangue dos sobreviventes do Ebola no mercado negro	O sobrevivente do Ebola doa sangue para o paciente com ebola
Os atentados no Iraque matam pelo menos 26	O Bomber Iraque suicídio mata pelo menos 12
Os estoques de Taiwan fecham 0,77 pct mais baixo	Estoques indianos fecham mais baixo
As ações de Tóquio abrem mais alto após a noite da noite para os EUA ganhos	As ações de Tóquio abrem mais alto na flutuante U.S. mercado
UE e nós. anunciar novas sanções à Rússia sobre a Ucrânia	O Japão impõe sanções à Rússia sobre a Ucrânia
Ucrânia inspeciona o comboio de 'ajuda' russo	Ministro da Ucrânia denuncia o comboio de ajuda russa
Sierra Leoa em Ebola Lockdown	Sierra Leoa atinge o último dia de bloqueio do Ebola
5.5 Quake de magnitude atinge o oeste do Irã	6.1 Quake de magnitude atinge a área da baía
As ações de Tóquio abrem mais alto na flutuante U.S. mercado	As ações de Tóquio abrem mais alto após os EUA fortes desempenho
tianjin warehouse explosão mortal Toll aumenta para 104	Tianjin explode o número de mortos para 114, 70 ausentes
A namorada de Jim Carrey encontrou morto, suicídio suspeito	A namorada de Jim Carrey encontrou morto
Rússia tira um pouco do McDonald's	A Rússia tira a mordida do McDonald em 'New Cold War'
O petróleo cai no comércio asiático	Preços do petróleo no comércio asiático
As forças israelenses detêm o deputado palestino em Hebron	Forças israelenses detêm 2 palestinos em ataques de prisão noturna
Os manifestantes de Hong Kong não estão recuando	Por que os protestos de Hong Kong são um grande negócio
Polícia e manifestantes se chocam em Hong Kong	A polícia limpou os manifestantes de Hong Kong HQ
O número de mortos para terremoto no Nepal ultrapassa 7.000	NEPAL Quake Toll cruza 5.000
Hajj para ir em frente depois que o colapso do guindaste de Meca mata 107	Hajj para ir em frente, apesar do colapso do guindaste
Os estudantes mortos em colapso da varanda de Berkeley lamentados na Irlanda	5 estudantes irlandeses mortos em colapso da varanda de Berkeley, dizem as autoridades
12 mortos em atentados à beira da estrada no Afeganistão	13 mortos em atentados a mesquitas na Nigéria
Secretário Kerry viaja para Bagdá, Iraque	Viagem do secretário Kerry para a Rússia e a Turquia
TV ao vivo agora dirige! 03: 00 UTC DW News	TV ao vivo agora foco na Europa 05: 00 UTC DW News
Gaza Ceasefire se apodera à medida que o foco se volta para a longo prazo	O cessar-fogo de Gaza toma conta à medida que os negociadores se reúnem
7.3 Quake de magnitude atinge o Nepal devastado	8.1 Terremoto de magnitude atinge o Nepal
Nigéria dissipa os boatos de mais casos de Ebola	Nigéria confirma mais 1 caso de ebola
motorista atinge pedestres em Jerusalém	Cinco feridos no ataque de carro a pedestres em Jerusalém
A estrela dos Vingadores Patrick MacNee morre	A estrela dos Vingadores, Patrick MacNee, morreu aos 93 anos de idade
As ações da China se aproximam mais na segunda -feira	As ações da China fecham mais baixa na quinta -feira
Soldado morto no Canadá tiro	Três mortos no tiroteio na Califórnia
Dois mortos em suspeitos de ataques de Boko Haram aos eleitores na Nigéria	Suspeito de ataques de Boko Haram matam dezenas na Nigéria
Quênia Kimetto quebra o recorde mundial da maratona	Dennis Kimetto estabelece um novo recorde mundial de maratona em Berlim
O soldado norte -coreano atravessa a DMZ em tentativa de defeito para o sul	Par de pares norte -coreanos nadam pela fronteira do mar para defeito para a Coréia do Sul
Ações dos EUA misturados no comércio do meio -dia	As ações dos EUA deslizam no comércio do meio -dia; As companhias aéreas afundam
Estoques dos EUA-Wall St Up 1 PCT, à medida que a China teme a facilidade	Estoques dos EUA Wall St pula 2 PCT; Olhos na China
IED Ataque Kills Chefe de Polícia no Anbar do Iraque	IED Ataque mata duas pessoas no Bagdá do Iraque
Premier chinês mantém conversas com o chanceler alemão	Premier chinês conhece o chanceler britânico
Milhares de curdos sírios fogem para a Turquia, assim como os avanços	Milhares de curdos sírios fogem para a Turquia para escapar da ofensiva do Estado Islâmico
China: pelo menos 150 mortos, 180 desaparecidos no SW China Quake	China: Pelo menos 10 mortos na China SW Rainstors
Centenas de migrantes e refugiados resgatados chegam a Cagliari	Milhares de migrantes e refugiados chegam à Alemanha
4 mortos, vários feridos no acidente de carro da SW China	Dois mortos, dezessete feridos no acidente de estrada de Raiwind
protestos surgem durante os jogos indígenas mundiais no Brasil	protestos marcar a abertura de jogos indígenas mundiais
República Árabe da Síria: Subsecretário-Geral para Assuntos Humanitários e Coordenador de Selífica de Emergência, Valerie Amos: Briefing do Conselho de Segurança sobre Síria-Nova York, 26 de março de 2015	República Árabe Síria: Nações Unidas subsecretário-geral para assuntos humanitários e coordenador de socorro de emergência, Stephen O 'Brien Declaração à imprensa na Síria
Ebola Toll Toll sobe para 887: Quem	Ebola Death Toll sobe para pelo menos 2.296
Seis civis mortos em luta fresca no leste da Ucrânia	9 mortos em luta no leste da Ucrânia
Forças israelenses prendem 12 palestinos na Cisjordânia	Os colonos israelenses incendiaram a terra palestina na Cisjordânia
Os ataques aéreos do exército matam 28 militantes no Paquistão NW	ataques aéreos, tiroteio matam 21 militantes no norte do Waziristão
Mais de 3.400 migrantes resgatados no mar no Mediterrâneo	Mais de 2.000 migrantes resgatados de barcos de madeira no Mediterrâneo
Júri de bombardeio de Boston para ouvir argumentos finais, iniciar deliberações de culpa	O júri de bombardeio de Boston tem horas de perguntas em deliberações
O co-piloto do voo 4U9525 da Alemanha foi tratado para tendências suicidas	Promotores: co-piloto de Alemanwings tratado por tendências suicidas
Floyd Mayweather bate em Manny Pacquiao em decisão unânime	Floyd Mayweather lutará com Manny Pacquiao em Las Vegas em maio
Facções palestinas As demandas de liberação por cessar -fogo de Gaza	Palestinos e Israel concordam que Gaza Ceasefire
7.3 Terremoto de magnitude atinge o Nepal, perto do Everest	8.1 Terremoto de magnitude atinge o Nepal
Novo chefe de manutenção da paz da ONU nomeado para a República Central da África	UNION GONTRADORES DE PAZ IMPRESSIO
Typhoon para trazer chuva para as Filipinas	Typhoon Koppu atinge as Filipinas
Grupo: Forças israelenses detêm 11 palestinos durante a noite, 152 na semana passada	Forças israelenses prendem 21 palestinos durante a noite, confronto com os habitantes locais
Lewis Hamilton toma polo para o GP russo	Lewis Hamilton vence o GP russo inaugural
UE pronta para impor sanções mais duras à Rússia	UE para dar novas sanções à Rússia
O UN Security Council ouve o final do Iêmen ...	O Conselho de Segurança da ONU pede que os houthis do Iêmen acabem ...
A Coréia do Norte diz conversa	Planos da Coréia do Norte conversam com a Coréia do Sul na próxima semana
p132b marcado para mudança climática	Marchando para a mudança climática
Os investigadores investigam o acidente de avião russo mortal no Egito	Investigadores 90 % Cerre
Os ataques aéreos matam 18 militantes em s. Afeganistão	ataques aéreos, tiroteio matam 21 militantes no norte do Waziristão
Forças israelenses prendem 21 palestinos durante a noite, confronto com os habitantes locais	Forças de segurança israelenses prendem 8 palestinos em varreduras noturnas da Cisjordânia
13 mortos no ataque terrorista de Afgan	6 mortos no ataque da mesquita da capital afegã
4 mortos, 3 feridos no acidente rodoviário do leste da China	2 mortos, 8 feridos no acidente de trânsito central de Israel
Lançamento dos EUA greves em torno da barragem de Haditha do Iraque	Us lançam uma nova rodada de ataques aéreos em torno da barragem do Iraque
Leituras anteriores do Rev: 2 de março	Rev. LEITAS ANTES: setembro. 3º, 2015
Mercados ao vivo: esperando dados da China	Mercados ao vivo: China arrasta
Rivais de pesquisa afegãs assinam acordo do governo da unidade	Aquela conversa sobre o colapso do governo da unidade
NEPAL Quake Death Toll Toll toca 3.700, quase 7.000 feridos	Terremoto do Nepal Toll Toll Tops no topo de 5.500; 11.440 feridos
Palestinos, policial israelense confronta o Al-Aqsa de Jerusalém	Palestino baleado pela polícia israelense em Jerusalém Oriental morre
QPR vence o Aston Villa por 2 a 0 na Premier League	West Ham vence o Newcastle por 2 a 0 na Premier League
Os ataques de Paris matam mais de 100	O terremoto do Nepal mata mais de 1200
Ataques de Paris: o que você precisa saber	drama de dívida da Grécia: o que você precisa saber
surto de ebola: mantenha -se atualizado	surto de ebola: acelere com o último
A conta de tempestade tropical avança em direção à costa do Texas	Tropical Storm Dolly se dirige para a costa do México
Suspeito Boko Haram Bombers Bombers na Nigéria Kill 24	Suspeito de ataques de Boko Haram matam dezenas na Nigéria
Forte terremoto atinge o norte do Afeganistão	Forte terremoto sacode o leste do Japão
Dois mortos, quatro feridos no tiroteio na escola dos EUA	Hospital: adolescente ferido em matrizes de tiro na escola dos EUA
ataques aéreos liderados pela Arábia Saudita atingem a capital iemenita	A coalizão liderada pela Arábia Saudita retoma ataques aéreos na capital iemenita
Os democratas de Hong Kong aderem às suas armas à medida que a votação da reforma se aproxima	Grupos de democracia de Hong Kong para levar às ruas como teares -chave de voto
O fim dos protestos de Hong Kong?	'Preocupação' do Reino Unido sobre os protestos de Hong Kong
19 mortos no ataque de ônibus do Paquistão	21 mortos no ataque de armas do Museu Tunísia
líder de golpe de burkina dado ultimato	líder de golpe de Burkina Faso em custódia
Typhoon Mujigae libra o sul da China, matando nove	Typhoon Mujigae Lands no sul da China
Júri de bombardeio de Boston para ouvir argumentos finais, iniciar deliberações de culpa	O júri de bombardeio de Boston inicia deliberações de pena de morte
Kerry: Chave do Egito na luta contra o Estado Islâmico	Progresso misto relatado na luta contra o Estado Islâmico
Tropical Storm Fung-Wong inunda as Filipinas	A tempestade tropical libra Taiwan, Filipinas
Putin acusa a Turquia de ajudar o ISIS, pedidos para a frente anti-terror internacional	Putin exige uma ampla frente anti-terror internacional
Nova Zelândia venceu a África do Sul para chegar à final da Copa do Mundo	Nova Zelândia e Austrália se reúnem para a Final da Copa do Mundo de Rugby perfeita
Sem câmeras policiais em Ferguson	Dois oficiais baleados em Ferguson
6 Polícia afegã mortava em explosão	4 soldados afegãos mortos no ataque de bomba de Cabul
Austrália possui serviço memorial para vítimas de MH17	Malásia para realizar o serviço memorial para lembrar as vítimas do MH17
Prisão de Bali por tentativa de estupro escolar	homem somali preso após tentativa de estupro
10.000 fogem casas enquanto o tufão atinge as Filipinas	Milhares fogem quando o tufão atinge o norte das Filipinas
PM grego convocado para Bruxelas para negociações de acordos de dívida	Gregos indo para Bruxelas para negociações cruciais
Planos de guerra russos atacam dentro da Síria	Roleta russa na Síria
Polícia: Indiana suspeita sugerem mais assassinatos	Polícia: Indiana Man confessa a todos os 7 assassinatos
Milhares de húngaros protestam contra impostos sobre o tráfego da Internet	Milhares na Hungria marcham contra o imposto da Internet
Polícia indiana prenda 4 por estupro de freira	A polícia indiana prende seis por ataque de tinta
4 soldados turcos feridos no ataque de PKK	Três soldados turcos mortos no ataque de PKK no sudeste
As autoridades alemãs liberam Ahmed Mansour, da Al Jazeera - Al Jazeera	A polícia alemã prende Ahmed Mansour, da Al Jazeera
Juiz ordena o funcionário do Kentucky a emitir licenças de casamento	Pope secretamente conheceu o funcionário do Kentucky sobre licenças de casamento gay
Israel, o Hamas aceita proposta de cessar-fogo egípcia	Israel, o Hamas concorda em deixar de disparar
China Hushen 300 Índice Futuros abrem alta quinta -feira	Futuros de títulos do tesouro da China fecham mais alta terça -feira
UE planeja não novas sanções contra a Rússia	A UE expande a lista de sanções contra a Rússia, Ucrânia
Promotores: co-piloto de Alemanwings tratado por tendências suicidas	Promotor: A Germanwings Co-Pilot temia ficar cega
Obama para fechar a visita histórica do Quênia com o endereço nacional	Obama para acabar com a visita de referência no Quênia com o endereço nacional
Kentucky Clerk preso por recusar licenças de casamento	O funcionário do Kentucky, Kim Davis, poderia voltar ao tribunal para alterar as licenças de casamento
A mortalidade tóxica de licor atinge 27	China explodir o número de mortos atinge 112
Toyota para investir US $ 1 bilhão em pesquisa de IA	Soros pronto para investir US $ 1 bilhão na Ucrânia
Iraque: Relatório da Situação de Crise do Iraque # 24, 1 de agosto de 2015	Iraque: Relatório da Situação de Crise do Iraque no. 22 (22 - 28 de novembro de 2014)
Reivindicações do Estado Islâmico decapitação de reféns britânicos	Estado islâmico emite vídeo de decapitação de reféns nos EUA
As ações chinesas fecham mais baixa na quinta -feira	Ações chinesas abertas na segunda -feira
Prince William emitidos apelar para a FIFA	Prince William Begins Japan Tour
O Japão impõe sanções à Rússia sobre a Ucrânia	UE para preparar possíveis novas sanções sobre a Rússia sobre a Ucrânia
6.6 Terremoto de magnitude acaba com a Indonésia	6.0 Magnitude Quake atinge a Indonésia-USGS
Mianmar Ferry Capsiza; 33 mortos, pelo menos uma dúzia desaparecida	Mianmar Ferry Capsiza; 33 mortos
Ucrânia: Ucrânia: Situação Relatório no. 15 a partir de 10 de outubro de 2014	Sudão do Sul: Relatório da situação de crise do Sudão do Sul no. 58 (a partir de 16 de outubro de 2014)
O Egito pagou de volta US $ 500 milhões ao Catar	O Egito paga US $ 2,5 bilhões para o Catar
CCTV de pistoleiros no ataque do Museu Tunísia	19 mortos no ataque do museu Tunis
5.2 Quake de magnitude atinge o Tibete	7.3 Quake de magnitude atinge o Nepal devastado
Dois mortos, quatro feridos no tiroteio na escola estadual de Washington	Terceiro aluno morre em tiroteio na escola de Washington
Conferência Riyadh: Dia 1	A conferência de Riyadh sobre o Iêmen
As ações de Hong Kong abrem mais alto	As ações indianas fecham mais alto
Blog ao vivo: Ucrânia em crise	Blog ao vivo: Iraque em turbulência
6.8 terremoto de magnitude atinge o chile	6.7 Terremoto de magnitude ataca a Grécia Ocidental: USGS
as vistas do British Labor favorito Jeremy Corbyn	As lições da história para Jeremy Corbyn
Momento crítico para protestos de Hong Kong	'Preocupação' do Reino Unido sobre os protestos de Hong Kong
A polícia israelense colidem com manifestantes palestinos no sensível Site Sagrado de Jerusalém	A polícia de Israel confronta com os palestinos em Jerusalém
Vice -presidente da Serra Leoa em casa: porta -voz	O vice-presidente da Serra Leoa pede asilo
Votos da Nigéria em eleições presidenciais apertadas	Os guinenos vão para as pesquisas nas eleições presidenciais
Os líderes da zona do euro divulgam o acordo de resgate da Grécia	Os legisladores alemães para votar no acordo de resgate da Grécia
Tribunal Egípcio adia o julgamento dos jornalistas da Al Jazeera para 25 de março	Corte egípcio sentenças 3 jornalistas da Al Jazeera a 3 anos de prisão
Prince William Dons Samurai Gear no Japão Tour	Príncipe William da Grã -Bretanha chega em Pequim
Veja as impressionantes novas imagens de Plutão	NASA libera mais imagens de Plutão
Bomber suicida mata 21 na Nigéria	A bomba do Taliban mata 29 no Afeganistão
espião israelense Jonathan Pollard libertado dos EUA prisão depois de 30 anos	espião israelense Jonathan Pollard liberado por nós
Pentágono: EUA General morto no Afeganistão	Pentágono confirma o general dos EUA morto no ataque de Cabul
É Djokovic novamente na China Open	Djokovic e Sharapova vencem China Open
O primeiro -ministro do Japão vai até nós para mostrar laços estreitos	Primeiro Ministro do Japão vem para os EUA para turnê nacional
Marco Rubio rouba o show	Professores roubam o show
Pope canoniza 2 palestinos	A Suécia reconhece o estado palestino
A China Lodges protesta com os EUA na patrulha de guerra no mar da China Meridional	A China diz a outros que não despertam problemas no Mar da China Meridional
Forças iraquianas retomaram 2 bases militares em Anbar	Forças iraquianas quebram o cerco militante da cidade xiita
Greves aéreos liderados pela Arábia Saudita matam dezenas no Iêmen	Greves aéreos liderados pela Arábia Saudita no Iêmen, os ataques matam mais de 90
3 mortos, 4 feridos em tiroteios em Los Angeles	Cinco mortos no tiroteio na Arábia Saudita
Manchester United 3-1 Barcelona	Manchester United Sign Falcao, cego
A Índia reforça a explosão de segurança no lado do Paquistão da fronteira com Wagah	Pelo menos 55 mortos na explosão suicida no lado paquistanês da fronteira com Wagah
Vice -presidente da Micronésia para visitar a China	Vice -presidente da Bolívia para visitar a China
Senado para realizar mais um voto no acordo nuclear do Irã	Os republicanos do Senado planejam votar no acordo nuclear do Irã
Militantes do Estado Islâmico Raze Raze Iraque's Ancient Hatra City	Militantes do Estado Islâmico matam 40 tropas iraquianas
Estado islâmico emite vídeo de decapitação de reféns nos EUA	Estado islâmico publica segundo vídeo de propaganda de refém do Reino Unido
Hillary Clinton promete fazer campanha por candidatas democratas	Hillary Clinton toca para os democratas de Iowa e ela mesma
Estado Islâmico reivindica a responsabilidade por matar o japonês em Bangladesh	O Japão diz indignado com o assassinato de japonês em Bangladesh
45 mortos no ataque de bomba do Paquistão	09: 01 25 mortos no ataque de hotel da Somália
As ações chinesas fecham na segunda -feira	Futuros de títulos do tesouro da China fecham mais alta quarta -feira
Centenas de tropas iranianas missa na Síria	Centenas de tropas ucranianas se retiram pela fronteira para a Rússia
Ucrânia: Ucrânia: Situação Relatório No.17 Em 24 de outubro de 2014	Sudão do Sul: Relatório da situação de crise do Sudão do Sul no. 58 (a partir de 16 de outubro de 2014)
UE aperta as sanções contra a Rússia	EUA, UE expandem sanções para a Rússia
Hillary Clinton para entregar seu servidor de e -mail privado	Hillary Clinton se recusa a pedir desculpas por usar o sistema de e -mail privado
Tropas de Israel matam 2 suspeitos palestinos no assassinato dos adolescentes	Israel demolia casas de suspeitos palestinos em matar adolescentes
A enfermeira dos EUA processa por ebola quarentena	NJ Nurse critica sua quarentena
Typhoon Swipes Oriental China	Typhoon se dirige para o sul da China
nós. Para rastrear passageiros aéreos da África Ocidental para Ebola	Paquistão para examinar os passageiros em planos de combater o Ebola
Polícia de Burundi, gás lacrimogêneo, venceu manifestantes anti-presidentes	Polícia de incêndio com gás lacrimogêneo contra manifestantes de Hong Kong
Pessoas encontradas trancadas em um contêiner em Harwich Port	pessoas encontradas em contêiner 'de origem indiana'
Irã termina o acordo de cooperação com o Paquistão	Irã, Contrato de Cooperação do Sinal do Tajiquistão
Testes de adolescentes negativos para o ebola	Testes de trabalhadores do hospital do Texas positivos para o Ebola
7.3 Quake de magnitude atinge o Nepal devastado	Magnitude 7.9 Terremoto atinge o Nepal
Texas processa por refugiados sírios	Turquia 'explora' refugiados sírios
Novas sanções dos EUA visam atacantes cibernéticos no exterior	A China discorda dos EUA Programa de Sanções sobre atacantes cibernéticos no exterior
Território palestino ocupado: as forças israelenses matam civis palestinas e feriram outro ao sul de Nablus	Território palestino ocupado: Iof prender dois menores na fronteira de Gaza e abusar de um deles
A Grã -Bretanha começou a aprovar ataques aéreos contra o Estado Islâmico no Iraque	Grã -Bretanha se junta à luta contra o grupo de Estado Islâmico
A greve de drones nos EUA mata sênior é militante	nós. Drone Strike mata 4 no Paquistão NW
Toll de mortalidade O terremoto mortal do Nepal sobe para 8.413	Toll de morte no terremoto do Nepal sobe mais de 7.000
World, Dallas Health Worker testes positivos para o Ebola	Testes de médicos de Nova York positivos para o Ebola
A China Manufacturing mostra sinais de estabilização em outubro	A fabricação chinesa sofre outro revés com uma desaceleração em outubro
Typhoon para trazer chuva para as Filipinas	Typhoon Koppu bate no norte das Filipinas
líder do golpe de Burkina quer as eleições 'em breve'	líder de golpe de Burkina Faso em custódia
Os mediadores ganham o Prêmio Nobel da Paz	Quem ganhará o Prêmio Nobel da Paz de 2014?
Dez acusados ​​de abuso infantil em Manchester	11 mantidos em várias acusações sexuais infantis em Manchester
5 mortos em ataques aéreos israelenses em Gaza	38 são militantes mortos em confrontos, ataques aéreos no Iraque
Djokovic reivindicações 6º título aberto da China	Djokovic vence o Italian Open
Batalha feroz raiva para Kobani	Fierce luta contra Kobani
Mina de carvão de rochas mortais no leste da Ucrânia	12 mortos, apesar do cessar-fogo no leste da Ucrânia
A incerteza de resgate da Grécia pesa nos mercados globais	A Grécia diz respeito à arrastar nos mercados da Ásia
As vítimas de acidentes do Sinai chegam na Rússia	Pais de vítima francesa de arrasto aéreo chegam a Taiwan
As ações asiáticas seguem o Wall St mais alto, mas a China teme que demore	As ações da Ásia balançam mais à medida que a China se aproxima de sete anos
Militantes do Estado Islâmico matam 14 soldados iraquianos	Grupo de Estado Islâmico mata 50 iraquianos
armas rebeldes cortadas no leste da Ucrânia	Retirada de armas pesadas trancadas em impasse no leste da Ucrânia
Erdogan da Turquia se perguntando sobre ação russa na Síria	O Erdogan da Turquia pede a zona de exclusão na Síria
Premier chinês encontra presidente armênio	O vice -premier chinês encontra ex -EUA Secretário de Estado
Quatro mortos como super tempestades lesões australianas da costa leste	Quatro mortos enquanto chuva enche a costa leste
Os resgatadores correm para salvar sobreviventes após o Monte Everest Avalanche	Quake do Nepal: sobreviventes contam sobre o horror de avalanche no Everest
surfista australiano mordido depois de pousar em tubarão	Pescadores australianos atraem tubarão de monstro raro
Chave da unidade palestina para a reconstrução de Gaza	A autoridade palestina bate execuções do Hamas
Terremoto do Nepal Toll Toll TOLS TOPS 3.350	Tolho do nepal Passagens de pedágio 7000
Funeral de Ian Paisley para acontecer em Belfast	Funeral da vítima do MH17 Liam Sweeney acontece em Newcastle
A Guarda Costeira termina a busca por 33 membros da tripulação desaparecidos	Rainha Mary 2 busca por parte da tripulação desaparecida perto do Canadá
Donald Trump não se curva sobre a controvérsia de Megy Kelly	Donald Trump varre Iowa em seu helicóptero pessoal
Roy Hodgson promete que a Inglaterra definitivamente se qualificará para o Euro 2016	Espanha para jogar a Inglaterra amigável se se qualificar para a Euro 2016
Rooney ajuda o Man United venceu o Everton por 3 a 0 na Premier League	West Ham vence o Newcastle por 2 a 0 na Premier League
Líder judaico de linha dura atirou em Jerusalém	Líder israelense pede calma em Jerusalém
WABA emerge um novo presidente da NLC	Esperando pelo próximo presidente
Os movimentos dos bastidores se intensificam à medida que a luta contra o Estado Islâmico aumenta	Progresso misto relatado na luta contra o Estado Islâmico
As ações de Hong Kong abrem mais alto	As ações de Hong Kong terminam mais baixo
A polícia de Israel entra em conflito com os palestinos no local sagrado de Jerusalém	Polícia israelense atira, mate a mulher palestina em Hebron
Egito: IPI insta a liberação do jornalista Al Jazeera preso em Berlim	Egito sentenças Al Jazeera jornalistas para a prisão
Irã, seis poderes exigem concessões mútuas em negociações nucleares tensas	O Irã diz
A economia do Japão contratou 1,2 % no trimestre de abril a junho	Contratos de economia dos EUA no primeiro trimestre
Suas cartas: suas cartas Hong Kong protege os ajudantes domésticos	Suas cartas: suas cartas mostram misericórdia, Sr. presidente
Território palestino ocupado: as forças israelenses continuam a derramar sangue palestino em opção	Território palestino ocupado: Israel alerta sobre a segurança, enquanto o currículo de Gaza Truce Talks
Escritor contribuinte: Guia de Vladimir Putin para a história do mundo	Escritor contribuinte: o cheque de realidade do Roberts Court
Ataques de carro -bomba matam 57 pessoas no Iraque: Polícia	IED Ataque mata duas pessoas no Bagdá do Iraque
5 Aviadores aéreos dos EUA visam combatentes do Estado Islâmico	Curds veem a Turquia impedindo a luta do Estado Islâmico
Os atacantes do Museu Tunísia 'treinaram' na Líbia	Ataque do Museu Tunísia: pelo menos 17 mortos, 3 em geral
Typhoon Koppu bate no norte das Filipinas	fortes cílios do tufão nordeste das Filipinas, dois mortos
O ministro das Finanças Gregas diz que alguns votos eleitorais podem ser adiados	O ministro das Finanças Gregas diz que o acordo de resgate levará o país
África: China em apoio ao desenvolvimento da África	A China é um parceiro imensamente importante no desenvolvimento da África
A Carolina do Sul remove a bandeira confederada do Capitólio do Estado	Era termina quando a Carolina do Sul abaixa a bandeira confederada
médico francês doente com ebola na Libéria	médico nos EUA infectado com ebola em condição estável
Erdogan ganha eleição presidencial turca na Turquia	Togo oposição rejeita os resultados das eleições presidenciais
Mercados ao vivo: esperando dados da China	Mercados ao vivo: Recursos em Retiro
As ações dos EUA sobem mais alto no comércio inicial	As ações dos EUA abrem modestamente mais altas em negociações silenciosas
O dinheiro federal começa a fluir para refugiados sírios	Angelina Jolie faz um apelo poderoso para refugiados sírios
Território palestino ocupado: o Hamas exige Israel gratuitamente 54 palestinos antes de novas negociações	Território palestino ocupado: a UE alerta a violência de Gaza pode retornar nos 'meses'
A Alemanha pede seus parceiros, o Irã a pegar negócios nucleares	A agência de imprensa alemã é Zarif como arquiteto do negócio nuclear do Irã
O Irã diz que novas sanções dificultarão o acordo nuclear	O Irã quer sanções levantadas antes do acordo nuclear: oficial
falta de Ashya: mandado de prisão emitido para pais	mandado de prisão emitido para Pistorius
Chad mata 200 militantes do Boko Haram na Nigéria: Relatório	Militantes do Boko Haram Storm Town na Nigéria
Território palestino ocupado: tropas israelenses matam palestinas que esfaquearam civil na Cisjordânia: Exército	Território palestino ocupado: palestino morto em conflito com as forças de Israel em Jenin: Médicos
Segundo Trabalhador Assistente Americano com Ebola chega em nós	O médico americano atingido por ebola está melhorando
Líbia: ONU ordena a investigação sobre abusos dos direitos da Líbia	A principal investigação do tribunal da Índia sobre fragmentos de emprego, mortes
A Guarda Costeira de Taiwan lança novos navios à medida que as tensões do mar do sul da China aumentam	Militares chineses chegam ao meio de tensões no mar da China Meridional
Holder pede autópsia federal no Missouri Teen	Autópsia federal ordenada na morte do adolescente do Missouri
Polícia de Burundi, gás lacrimogêneo em manifestantes	Montenegrin Police Fire Gas Gas para dispersar oposição
Os Estados dos EUA-Wall ST abrem mais à frente da declaração do Fed	Estoques dos EUA-Wall St Lower enquanto os investidores aguardam a palavra de Yellen
Havaí prepara para o primeiro furacão em 22 anos	Havaí aparece quando os furacões fecham em
paciente de ebola não perguntado sobre viagens	Paciente de Ebola no Texas Dies diz o Hospital dos EUA
O ataque aéreo israelense tem como alvo o Hamas em resposta ao ataque de foguete	Exército israelense ordenado a retomar greves contra alvos em Gaza após ataques de foguetes
Manifestantes de Hong Kong em greve de fome após confrontos violentos	Os manifestantes de Hong Kong exigem que Leung Chun-ying renuncia como líder da cidade
Coréia do Sul declara de fato o final do surto de MERS	Defetores da Coréia do Norte nadam pela fronteira do mar até a Coréia do Sul
Egito: IPI insta a liberação do jornalista Al Jazeera preso em Berlim	Corte egípcio sentenças 3 jornalistas da Al Jazeera a 3 anos de prisão
Libéria descarrega o último paciente do Ebola	Libéria: pacientes em Ebola fugitivos encontraram
Terroristas atacam a Universidade no Quênia	O ataque ao terrorismo temia 'em alguns dias'
Israel e Hamas concordam	Israel e Hamas para retomar as negociações indiretas em 27 de outubro
China luta para interromper o slide do mercado de ações	Meltdown do mercado de ações da China
O papa Francisco enfrenta um novo desafio em Cuba	O Papa Francis aborda o Congresso
nós, o Irã, veja o progresso nas negociações nucleares, mas maneiras de ir	Poderes europeus, o Irã faz pouco progresso nas negociações nucleares
O número de mortos para terremoto no Nepal ultrapassa 7.000	Toll de morte no terremoto do Nepal no topo de 8.000
Os profissionais de saúde do Ebola entram em greve na Serra Leona	Os casos de Ebola aumentam bruscamente na Serra Leoa Ocidental
Israel, o Hamas concorda com a trégua de 72 horas	Israel e palestinos teriam concordado com o cessar-fogo de 72 horas
As negociações nucleares do Irã entram no seu último dia	Esboço do acordo nuclear do Irã - a maratona finalmente acabou?
FM húngaro para visitar a China	Estado húngaro ainda com fome
explosões de bombas no templo hindu em Bangladesh, 10 feridas	Ataques de bomba em Bangladesh deixam 1 morto, mais de 100 feridos
Congresso da NFF processa pela paz	Missa de manifestantes de Hong Kong para Rally da Paz
Obama: surto de ebola também uma ameaça à segurança	Obama: ameaça de ebola à 'segurança regional e global'
A polícia de Baltimore aplica o toque de recolher após tumultos	O prefeito de Baltimore levanta o toque de recolher 6 dias após os tumultos
Kerry: Chave do Egito na luta contra o Estado Islâmico	Liga Árabe para apoiar iraquiano, campanha dos EUA contra o Estado Islâmico
O Irã nomeia a primeira mulher embaixadora desde a revolução	Irã convoca embaixador do Paquistão sobre assassinatos nas fronteiras
É Jason Day e todos os outros no BMW Championship	Jason Day detém liderança de dois tiros sobre a Jordânia Spieth no PGA Championship
O futuro de Jeremy Clarkson no Top Gear jogado em dúvidas	O caminho de Jeremy Clarkson para arruinar a marcha
Pelo menos 30 lutadores mortos na cidade síria de Kobani	Pelo menos oito soldados afegãos mortos no incidente de 'fogo amigável'
Processo da Comissão Europeia contra Malta ...	Reunião tributária européia em Malta
Malala procura vir no Paquistão, se juntar à política	O PM Nawaz vê o Paquistão livre de poliomielite em seis meses
Os pais de Ashya chegam para audiência de extradição	Os pais de Ashya King foram libertados da prisão na Espanha
Polícia de Hong Kong prenda 9, apreenda materiais explosivos	A polícia de Hong Kong prende dezenas de manifestantes estudantis
Nigéria admite lenta resposta no caso do Ebola	EUA aumentam a resposta à crise do Ebola
O Jeep IDF derruba, mata o palestino em confrontos da Cisjordânia	Israel detém 14 palestinos na Cisjordânia, convoca o homem
A votação começa nas eleições presidenciais da FIFA	O escândalo de suborno abala as eleições presidenciais do Brasil
A Turquia identifica suspeito em ataque suicida	Quatro civis mortos no ataque de suicídio de Cabul
pistoleiros matam 8 trabalhadores no sudoeste do Paquistão	nós. drone mata oito no noroeste do Paquistão
Milhares atravessam a fronteira da Áustria-Hungria	milhares de russos presos no exterior
caminhões militares russos no navio com destino à Síria	Novo poder militar russo em plena exibição na Síria
Israel: nós não espionamos as negociações nucleares do Irã	'Sim ou não' tempo nas negociações nucleares do Irã
Por que os protestos de Hong Kong são um grande negócio	Os protestos de Hong Kong veem cenas estranhas e maravilhosas
Forte Quake de Magnitude 6.0 atinge o norte da Califórnia	4.1 Quake de magnitude Jolts SW China
Rouhani felicita o presidente do Gana	O Afeganistão inaugura o novo presidente
Pelo menos 17 mortos, 400 feridos em grandes explosões de Tianjin	Cinco mortos, 40 feridos em ataque suicida em Lahore
Kranjcar deixa atrasado para resgatar o QPR contra o Stoke inspirado em Moisés	Harry Kane deixa atrasado para resgatar um ponto para o Tottenham Hotspur
Presidente da Libéria descreve um custo pesado do Ebola	Presidente nigeriano substitui o melhor latão do militar
6.0 Magnitude Quake atinge a Indonésia-USGS	6.7 Terremoto de magnitude ataca a Grécia Ocidental: USGS
As negociações nucleares do Irã se estendem para outro dia	Irã Nuclear Talks: Deal abrangente 'a ser anunciado já na segunda -feira' '
Austrália venceu a Irlanda em Stormont	Austrália repreende Israel por ataques 'chocantes'
John Kerry pede negociações para facilitar as tensões do mar da China	Kerry: Israel, Jordânia trabalhando para facilitar as tensões do site sagrado
Oscar Pistorius condenado a 5 anos de prisão	'contador de Auschwitz' condenado a quatro anos de prisão
A Grécia se aproxima do acordo de resgate	O pagamento do FMI da Grécia perdido à medida que o resgate expira
FM parabeniza Erdogan pela vitória das eleições	Obama parabeniza as pessoas turcas por causa da eleição
Os manifestantes de Hong Kong se afastam de algumas áreas	Líderes estudantis de Hong Kong Retiro de protesto Mull
Ativistas pró-palestinos marcharam para a sede da ONU	Ativistas pró-palestinos preparam a flotilha para quebrar o bloqueio de Gaza
Os protestos de Hong Kong aumentam	Os protestos de Hong Kong se tornam festivos após o caos do gás lacrimogêneo
Militantes do Estado Islâmico Mate 15 Polícia iraquiana perto da fronteira síria	Um militante do Estado Islâmico realiza um ataque suicida na Aleppo da Síria
5 mortos em ataques militantes curdos no sudeste da Turquia	Dez policiais turcos mortos em um ataque a leste da Turquia
O candidato presidencial do Brasil morre em acidente de avião	Os candidatos presidenciais da Costa do Marfim reconhecem a vitória de Ouattara
China, África para forçar a cooperação em saúde	Vice-Premier chinês pede uma cooperação climática China-UE mais forte
Os preços do petróleo aumentam após os dados comerciais chineses	Preços do petróleo no comércio asiático
Benzema enfrenta possíveis acusações em caso de fita sexual	Menendez enfrenta possíveis cobranças de corrupção
Votos do Senado dos EUA para avançar no Irã Nuclear Review Bill	Os cientistas dos EUA elogiam o acordo nuclear do Irã
Estado Islâmico esmaga a história iraquiana com margetande	Estado islâmico apreende a base do exército iraquiano, PM para enviar lutadores de ite
A China alerta contra a arte 'imoral'	BP alerta contra sanções da Rússia
Todos os 224 mortos no acidente de mistério de avião russo	Flash de calor detectado no momento do acidente de avião russo
Merkel: Tomar migrantes é uma coisa certa a fazer	AMANIGRAÇÃO ALEMANO OFFICIAL PASSA
Donald Trump Ebola Tweet Ofrestes	Donald Trump para revelar o plano tributário na segunda -feira
Os usuários de Ashley Madison enfrentam ameaças de extorsão	Ashley Madison trapaceiros expostos
Ministros do Euro se prepararam para lançar o resgate grego, cortejando o FMI em dívida	Os ministros da zona do euro aprovam o acordo de resgate de 86-Bln-Euro Greek
Fighters do Estado Islâmico e Força Aliada de Clash Tripoli na Líbia central	Os combatentes do Estado Islâmico apreendem a base aérea síria
nós. envolvido em sete ataques aéreos em metas do Estado Islâmico	Atstacos aéreos da coalizão libra fortaleza do Estado Islâmico na Síria
O Papa Francisco pede ao Congresso que abraça migrantes	O papa Francis começa a excursão por Cuba e nós
Govt. Para manter conversas com os alunos do FTII	Cameron para manter conversas com Sturgeon no Futuro do Reino Unido
3 autoridades indianas suspensas após linchamento do suspeito de estupro	Índia para libertar cinco suspeitos de estupro de gangues
li na para anunciar a aposentadoria	Senador dos EUA Ted Cruz para anunciar a oferta presidencial
Gunners disparam, mas não conseguem avançar na Liga dos Campeões	Clubes de EPL para evitar problemas da Liga dos Campeões
Cinco mortos, 40 feridos em ataque suicida em Lahore	Seis mortos, 50 feridos enquanto o trem descarrila perto de Rae Bareli
Estado islâmico destrói santuários antigos na cidade de Palmyra, na Síria	Grupo do Estado Islâmico apreende aldeias na Síria
Patrulha rodoviária assume o policiamento de Ferguson e abraça manifestantes	Dois policiais baleados em Ferguson em meio a protestos raciais
469 Israelenses Petição Espanha para reconhecer um estado da Palestina	Parlamento britânico para debater a moção para reconhecer a Palestina
Os cientistas provam que há água em Marte	A NASA descobriu água em Marte?
Cameron em Beirute sobre a crise dos refugiados	Cameron muito atrás da curva em refugiados
O presidente iraniano elogia o acordo nuclear	Irã prende vários espiões perto da usina nuclear
Boko Haram interrompe as eleições nigerianas	pressione as eleições gerais da Nigéria
MARCH DIPS PMI de não manufatura da China	A fabricação da China melhora em setembro
Nomes de cargos estrangeiros vítimas repatriadas da Tunísia	silêncio para lembrar as vítimas da Tunísia
Chefe da FIFA Sepp Blatter agora 'na mira'	Presidente da FIFA Sepp Blatter enfrentando suspensões
Coréia do Sul lamenta a recusa de negociações de North	Coréia do Sul relata 14th Mers Death, 12 novos casos
O Iraque lança ataque para retomar o Tikrit de IS	As forças iraquianas não conseguem recuperar o tikrit de militantes
O presidente chinês mantém conversas com o presidente angolano	Presidente chinês declara os Jogos Olímpicos da Juventude Abertos
7 chineses confirmados mortos em Bangkok Blast	A Tailândia prende o segundo suspeito estrangeiro em Bangkok Blast Probe
Pesquisa no local do acidente de avião acabou com a noite	Pacote Tour de France sai para o estágio 15
Obama para obter briefing sobre plano militar contra o Estado Islâmico	A morte marinha é a 1ª em campanha contra o Estado Islâmico
Quatro fuzileiros navais dos EUA mortos em ataques a instalações militares	Quatro fuzileiros navais e atiradores matados em 'ato de terrorismo' no Tennessee
Vote para permitir que a bandeira da Palestina voe na sede da ONU	A Assembléia Geral Vote permite que os palestinos voem na bandeira na ONU. sede
Editores de todo o mundo pedem à Turquia que proteja a mídia	Liberdade de mídia em jogo enquanto a Turquia luta contra rebeldes
Forças russas vistas em Donetsk e Luhansk, diz o coronel ucraniano	A igreja não deve temer a mudança, Pope diz no Synod Close
A Agência libera seu relatório de desastre de trem em Quebec	O Catar rejeita o Relatório do Grupo de Direitos sobre Abuso de Trabalho 'Rampa'
As ações aumentam à medida que a China teme a facilidade; O petróleo se recupera	As ações da Ásia balançam mais à medida que a China se aproxima de sete anos
Cameron pede mais ação na crise dos migrantes após o caos de Calais	Camerwoman disparou por tropeçar em migrantes fugindo
Obama consulta Turnbull sobre o negócio de portos da China	Bulls espanhóis Gore sete até a morte
A generosa lance de 1MDB da China foi visto em grande retorno na Malásia	A China fica de olho em visitar o Tiger libertado pelo presidente russo
Khaleda Zia concedeu fiança em casos de enxerto	Oliseh nomeado como treinador da Nigéria
O acordo nuclear histórico chegou; Irã não está mais sob sanção	Irã otimista no acordo nuclear, muito menos
Chefe da ONU apela por calma em Jerusalém	Gaza Aid O apelo levanta quase £ 1 milhão
Os mercados globais se preparam para atingidos de curto prazo após ataques de Paris	A Índia bate o calor do carvão em Paris se encontra
O cantor britânico Cliff Richard entrevistado pela polícia	O pregador radical britânico Choudary concedeu fiança
Bancos gregos reabram à medida que os olhos do governo retornam à normalidade	O ex-primeiro-ministro do Líbano retorna após a ausência de três anos
A asiáia comercializa após o Fed atas	Investidores enterrando a cabeça na areia?
O Hezbollah tem como alvo Qaeda se reunir ao longo da fronteira com a Síria	A Bielorrússia aperta a segurança ao longo da fronteira com a Ucrânia
Coréia do Sul relata sete casos de New Mers	Mulher sul -coreana em contato com MERS Paciente morre
Hawks Equal Franchise Wins Record	Papa Francisco na América
Polícia de metrô para obter novos treinamentos em manuseio de multidões na Academia de Polícia	A polícia de Baltimore aplica a terceira noite de toque de recolher
Um desertor norte -coreano quer voltar para casa - e é proibido	Defetores da Coréia do Norte nadam pela fronteira do mar até a Coréia do Sul
A França empurra a ONU. para apoiar a luta contra o estado islâmico	setor privado instado a se juntar à luta contra a malária
Irã FM chega em Najaf	Chris Brown chega na China
EUA exigem resgate de migrantes asiáticos à deriva no mar	Mais de 1.800 migrantes resgatados de seis barcos à beira da Líbia
Protestos de Hong Kong pesando sobre mercados globais	Os líderes de protesto de Hong Kong suspendem o voto planejado
Irã: Mensagens trocadas conosco sobre a batalha contra o Estado Islâmico	A morte marinha é a 1ª em campanha contra o Estado Islâmico
Greves aéreos liderados pela Arábia Saudita no Iêmen, os ataques matam mais de 90	Coalizão liderada pela Arábia Saudita Camps Rebeld Rebelds, atacando no Irã
Obama pede a frente internacional contra o IS	Obama promete salvar os iraquianos presos na montanha
O Estado Islâmico levanta a bandeira no lado leste de Kobani	Irã: o avião da polícia cai, deixando sete pessoas mortas
1 americano morto, 1 dogo no tiroteio em posto de gasolina saudita	nação 1 morta, 4 feridos em tiro de zumbicon
As ações dos EUA abrem mais alto à medida que os investidores esperam no Fed	Os estoques de Tóquio abrem mais alto após a parede. ganhos
nós. Militar diz que conduz ataques aéreos contra a Síria, Iraque	Observatório diz que ataques aéreos russos matam 45 na Síria
Quem abandonou 3 aviões da Boeing no aeroporto?	A polícia abandona os postos no Lesoto, medo por vidas
Reino Unido: Jets fazendo reconhecimento, pronto para atacar no Iraque	França começa voos de reconhecimento sobre o Iraque
Coréia do Norte para colocar o cidadão dos EUA em julgamento	n Coréia atingiu com novas sanções dos EUA
Obama tenta vender um plano para derrotar o Estado Islâmico	O Líbano entrou na guerra com o grupo de Estado Islâmico
Tropas iraquianas, milícias repele são ataques na província de Anbar	20 palestinos feridos em ataques de IOF em Jenin
Sete mortos como veículo de trem de Nova York atinge	Pelo menos 12 mortos como Shebab Attack Somalia Hotel
Milhares protestam contra as políticas do governo em Nazaré, chamam o estado palestino	Protestos de Hong Kong: o funcionário do governo da China diz que a Cúpula da APEC não deve ser afetada
O Parlamento reavalia o primeiro -ministro da Líbia	governante do exército tailandês chamado Primeiro Ministro
Paciente da Espanha Ebola por 'risco sério' de morrer	escondendo pacientes com ebola agora ilegal
6 feridos enquanto hits de explosão trem no Paquistão do Sul	Power Cut atinge o sul do Paquistão
Poroshenko: o contrato de associação será ratificado em setembro	Poroshenko levanta o referendo de descentralização, mas os rebeldes rejeitam
Netanyahu Bars ministros de visitar o site sagrado de Jerusalém	Netanyahu alerta sobre a ameaça islâmica militante
Os funcionários de Hong Kong retomam o trabalho como protestos finos	Líderes estudantis de Hong Kong Retiro de protesto Mull
nós, homem condenado por suicídios na web	Zim Animado com o Presidente XI Visita
estimado 6.500 feridos em colapsos de convés desde 2003	2 mortos, 450 feridos nos confrontos da polícia do Paquistão
Grã -Bretanha venceu a Austrália pela primeira vez em 17 anos	índices planos; no caminho do melhor mês em quatro anos
Escócia decide parar de financiar a Queen via Scottish Crown Estate	é reivindicações de manter reféns chineses e noruegueses
A Rússia denuncia a chegada dos EUA treinadores militares na Ucrânia	O ICRC confirma sua participação em consultas na Ucrânia
Ebola UK: o pessoal do NHS 'em pânico' após suspeitos de casos de Ebola	Reino Unido diz que investigar 2 casos suspeitos de MERS
nós. Senador pede que o relatório de corrupção de futebol seja tornado público	ONU SEC-GEN exige a contribuição dos Irans para a segurança do Líbano
'muitos mortos' no acidente de avião do Egito	Pelo menos 39 mortos no acidente de avião iraniano
FM francês: ainda não há garantias de acordo nuclear verificável do Irã	un. Conselho de Segurança endossa o acordo nuclear do Irã
O Paquistão rejeita a reivindicação da Índia na Caxemira	Os protestos do Paquistão cessaram as violações do fogo da Índia
Crashes para passageiros perto do aeroporto de Teerã	A sonda mensageira da NASA colide com Mercury fazendo cratera gigante
O líder do Reino Unido sinaliza o apoio a ataques aéreos na Síria	Por que Chipre apóia o empurrão de Cameron para os ataques aéreos do Reino Unido na Síria
O número de mortos para terremotos do Nepal aumenta acentuadamente em meio a tremores secundários	Japão Typhoon Death Toll sobe para seis: Relatório
Filipinas, Canadá, se comprometeu a aumentar ainda mais as relações	Filipinas salva 100 após pias de balsa
Migrantes Storm Budapest Train Station	Hungria reabre a estação de trem Budapeste, desencadeando um novo impasse
O líder de 'culto' israelense enfrenta prisão por crimes sexuais	Israel, Hamas, para discutir a troca de prisioneiros
contribuir para a construção da nação - Cyril	A Tunísia contribui para o esforço internacional para reconstruir Gaza
Os lançamentos da Nigéria detiveram os jornalistas da Al-Jazeera: TV	O Irã recebe turistas ferroviários europeus
Temores de segurança sobre explosões químicas chinesas em Tianjin	Presidente XI visita a delegação olímpica da juventude chinesa em Nanjing
Israel barra palestinos da cidade antiga de Jerusalém	Solução de dois estados entre palestinos, torta de Israel no céu
Rússia dá as fotos	Os russos protestam contra Putin
Mulher britânica morre na Austrália Crash	Investimentos britânicos no Egito no valor de US $ 26 milhões
Enviado alemão: nações prontas para ir além das sanções do Irã	Os políticos da coalizão alemã quebram as classificações nas reparações gregas da Segunda Guerra Mundial
Presidente responde ao apelo da eutanásia da menina	Presidente: Irã para continuar o enriquecimento
Mais ajuda em socorro chinês enviado às vítimas de inundação de Mianmar	Chelsea, Mourinho se desculpa com a vítima do racismo
'Vida no planeta em jogo', a França alerta quando os ministros do clima se encontram	Quatro razões para o otimismo como ministros climáticos assumem as negociações
'Warrior King' fará a eleição?	Prefeito de Chicago em eleição de segundo turno
Quanto você sabe sobre o Serviço Secreto?	Os legisladores de ambos os lados expressam indignação no Serviço Secreto
Burundi diz que demos contra a candidatura do Presidente acabaram	Polícia de Burundi, gás lacrimogêneo em protesto contra o presidente
Alexander Lukashenko vence a raça presidencial da Bielorrússia	Polônia vota Duda nas eleições presidenciais
Putin assume a Síria	Grã -Bretanha lança ataques aéreos no ISIS na Síria
Eleição da Turquia: Tirante ou Mão Parte?	Partido no poder da Turquia perde a maioria parlamentar
Homem em estado grave após o tiroteio de Ballyfermot	MSF quer uma investigação independente após bombardeio fatal
Soldados de Israel, palestinos se chocam no dia de 'Nakba'.	As forças israelenses atiram, ferirem 82 palestinos em Gaza, Banco Ocidental de Nov. 27, 2015
Líder da NAACP mentindo sobre ser negro, a mãe diz	NDA DOES UPA LINHA ATRAVÉS DO DIFRAÇÃO DO DINHEIRO BLack
Rússia processa a Alemanha por causa do contrato de treinamento em Mulino	Rússia pronta para devolver mais de 20 navios ucranianos com sede na Crimeia para a Ucrânia
Muhammadu Buhari assume a Nigéria em crise	A Hungria autoriza o governo a usar o Exército na crise de migração
As ações dos EUA aumentam ao meio -dia antes da declaração do Fed	nós. A queda dos futuros de ações após a liquidação do mercado da China currículos
Hillary Clinton faz comentários na Carolina do Sul	Hillary Clinton: EUA devem liderar a energia limpa
Soldados mortos em ataque do Taliban em Cabul	Pelo menos 27 mortos em carros -bomba, milícias ataques ao norte de Bagdá
Ferguson Uns Repert: protesto marca duas semanas desde o tiroteio da polícia	Ferguson Teen Brown Autópsia revela seis tiros
A Hungria cai	Jornalista de TV húngaro demitido por tropeçar em migrantes fugindo
n. Coréia concorda em conversar com o sul	Johor coroa seu quinto sultão
Bill Clinton aparece no filme de realidade virtual na África	Clinton faz o arremesso para os americanos que trabalham
teme que o extremismo australiano possa escalar	Austrália venceu a Escócia em suspense
A Somália Mate Mate 7, perto do Palácio Presidencial: Polícia	Polônia inicia a eleição presidencial
Nós, aliados, dizem conduzir 15 ataques aéreos na Síria e no Iraque	ataques aéreos liderados pelos EUA no ISIS na Síria: o que você precisa saber
imagens de drones de fogo de Manchester	Aguero Strike Sinks de 10 jogadores Manchester United
a equipe procura quem encontrou o paciente com Ebola	Libéria para processar o homem que trouxe o Ebola para nós
2 supostos rebeldes da NPA mortos em Bukidnon	Vários mortos no tiroteio de pub na Suécia
Hacker chinês mais jovem é um adolescente	Os partidos de direita da França levam o Senado
Mob joga pedras no comboio do Paquistão	O papa Francisco canoniza duas mulheres palestinas
China, África para forçar a cooperação em saúde	Chefe de polícia pede o aprofundamento da cooperação do continente-HK
O número de mortos sobe para 19 no Monte Kinabalu, da Malásia, depois do Quake: Official	A torre histórica entra em colapso em Katmandu depois do terremoto
Top general iraniano, o Hezbollah lidera a guerra terrestre do Iraque	O general iraniano é morto na Síria aconselhando militares
O líder do Jamaat de Bangladesh perde apelo contra o enforcamento	Os enlutados de Bangladesh prestam homenagem ao blogueiro morto
A polícia de Hong Kong prende dezenas de manifestantes estudantis	As tensões de Hong Kong aumentam à medida que a polícia usa spray de pimenta em manifestantes presos 45
Michael Brown Shooting: Family Lawyer sugere que estava "se rendendo"	A família de Michael Brown processando policial e Ferguson
Palácio até o sexto depois da vitória em Watford	Os objetivos tardios dão à Man City Victory no Villa
Irã, um grande parceiro importante para a Rússia: Novak	O Irã reitera o apoio ao Iraque, Síria
Pressão global sobre nós para afrouxar a proibição de exportações de petróleo	Irã pronto para retomar as exportações de petróleo para o Egito
EUA e Irã positivos após negociações nucleares	Os protestos de Hong Kong se tornam festivos após o caos do gás lacrimogêneo
Presidente de Taiwan Charters Plane para prestar respeito a Lee	O presidente da Polônia perde para desafiante
Dois palestinos morrem em ataques a israelenses antes da visita de Kerry	OFICIAL PALESTINO SLAMS
Ministro pede malaios no Iêmen a retornar	Ministro para aumentar o caso do Paquistão na Conferência Climática
Os preços das casas da China aumentam pelo segundo mês em junho	A China aprova o iPhone 6 após as garantias de segurança
Tribunal do Egito declara o movimento palestino do Hamas 'Terrorist'	A onda de agitação deixa o presidente palestino sem boas escolhas
Thomas Cook acusou de colocar custos antes dos clientes	fraternidade da Universidade da Flórida acusada de cuspir veteranos de guerra feridos
Soldier Strip-Searches 2 mulheres palestinas em Beit Ummar	Três homens mantidos sobre séries de facadas na área de Temple Bar
Grande Prêmio da Austrália: Lewis Hamilton recebe as honras em grande estilo	Austrália Bins Standalone Coding for Kids in Schools Curso
Obama assegura o voto -chave para proteger o acordo nuclear do Irã nos EUA congresso	O político libanês exorta os países árabes a receber o negócio nuclear
Narendra Modi 'Photoshopped' Imagem de inundações de chennai Visita se torna viral	O PM Narendra Modi fala de não discriminação e igualdade
Ativistas educacionais de Mianmar presos	Mianmar descobre caso suspeito de ebola
Ted Cruz: Donald Trump não será indicado no Partido Republicano	Donald Trump para revelar o plano tributário na segunda -feira
Glasgow vota 'sim' para a independência escocesa	Brexit levará ao clamor pela independência escocesa, diz Sturgeon
Os enlutados marcharam para comemorar vítimas de acidente de ônibus francês	Lágrimas em Barcelona no Funeral for Alemanwings Crash Victim
O chefe da ONU recebe as eleições presidenciais pacíficas na Guiné	O chefe da ONU condena o ataque contra as forças de paz no Mali
Netanyahu diz que usará 'todos os meios' para acabar com a violência palestina	A Alemanha diz que quer manter laços estreitos com a Polônia
Starbucks incentiva os baristas a conversar	Os rivais do Senado de Kentucky mantêm o debate solitário
Obama luta para acalmar os medos sauditas quando o Irã fala retomar	Mianmar luta para finalizar as listas de eleitores para pesquisas de domingo
7 estrangeiros, 1 tunisiano morto no ataque de tiro em museus	nós. Government luta para lidar com um ataque de hacking maciço
As execuções do Paquistão desenham ira internacional	Os protestos do Paquistão cessaram as violações do fogo da Índia
Filipinas confirma a enfermeira infectada com MERS	Havaí prepara para o primeiro furacão em 22 anos
Brasil para eleger o presidente hoje em votação de segundo plano	Tanzânia aguarda o resultado tenso da pesquisa presidencial
Obama: 'sem desculpa' para a violência	MERS: Não há motivo para alarme no PHL
Obama começa a se encontrar com Raul Castro no Panamá	AG titular encontro com os pais de Michael Brown
O presidente da Liberty pede um campus cristão armado	O presidente da Libéria ordena aos funcionários públicos que fiquem em casa em meio à crise do Ebola
Ministro da Defesa de Israel em nós, depois de cuspir sobre Kerry, observações	O gabinete da Itália ganha o voto principal de confiança no Senado sobre a reforma trabalhista
Pesquisa currículos por falta no Brasil Mine Medslide	Pesquise o helicador ausente da Indonésia em andamento
Tony Blair nega dizer que Miliband não pode ganhar	Tony Blair, da Grã -Bretanha, renuncia à ONU. Enviado do Oriente Médio
Coréia do Norte inicia um enorme desfile militar	Enviado: a Coréia do Norte perseguirá o programa nuclear 'defensivo'
Coréia do Sul declara o final do surto de MERS	A delegação da Coréia do Norte se reúne com autoridades sul -coreanas
EUA prometem mais apoio militar à Somália	CUI: Patrulha dos EUA Série Política, Provocação Militar
A tensões de Pranab precisam lutar pela paz pelas nações	OMC: Índia lamenta a ação das nações desenvolvidas
Missão das freiras no Paquistão	ativista da liberdade de expressão morta no Paquistão
Filipinas nos procura ajudar para impedir a recuperação de terras da China	Filipinas: ERC para construir 10 escolas nas áreas devastadas pelo Typhoon das Filipinas
A Europa Oriental rejeita o Plano de Refugiados	Japão reinicia a usina nuclear
bombeiro morto no sul da China	Mais de 80 militantes mortos na agência Khyber
Estoques asiáticos principalmente em dados fracos, preços de commodities	Os estoques dos EUA se abrem principalmente mais baixos à medida que os ganhos decepcionam
A Volkswagen desliza para o vermelho na sequência do escândalo de poluição	O "Gesto of Goodwill" da Volkswagen para os proprietários de diesel
Dois australianos mortos no Quênia depois que o ônibus caiu no rio	Permalink para dois mortos no acidente de trem da Alemanha
6 mortos na escola debandada na China	21 mortos no ataque de armas do Museu Tunísia
A França fecha a mesquita, prende o homem de repressão após ataques	A segurança se apertou nas igrejas de Nova Délhi após ataques
Refugiados sírios não são bem -vindos em 30 EUA estados	Libéria para se tornar Estado Cristão
O filho do vice -presidente dos EUA morre	Vice -presidente da Comissão de Eleições do Congo renuncia
Trem Rams SUV, matando 13 no leste da Índia	A colisão de frente mata 7 no leste da China
o avião russo supostamente coloca no Egito	piloto morto como caça de jato nos EUA na Inglaterra
Du Preez dirige Springboks para as semifinais da Copa do Mundo	Jibes voam antes da final da Copa do Mundo de Rugby da Austrália-NZ
Coalizão liderada pelos EUA realiza 25 ataques aéreos contra militantes do Estado Islâmico	Os comandantes da coalizão de Obama se reúnem contra os jihadistas
O Parlamento Britânico apóia ataques aéreos contra o ISIS no Iraque	US MILITARES LIMENTOS PROFIDOS DE GRAÇÕES AR AR ISIS METERS NO IRAQUE E Síria
O Iraque lança operação para retomar o Tikrit do Estado Islâmico	Obama promete atingir o estado islâmico
Amit Jain nomeado Presidente da Uber Índia	Beau Biden, filho do vice -presidente, morre de câncer no cérebro
Três somalis mortos em ataque ao comboio da ONU no capital	Dezenas matadas após ataques aéreos na capital do Iêmen
O Japão continua insistindo em seus direitos para as Ilhas Senkaku	Gov 'T: Sanções contra a Rússia não atingiram os planos de Paks
Centenas teriam participado do enterro para o atirador dinamarquês	Mercado russo: grandes potencialidades de exportação para a Tunísia
Fales severos como Storm Clodagh atingem a Grã -Bretanha	Merkel promete solidariedade da OTAN com a Letônia
Netanyahu procura abordagens alternativas para negociações de paz	Netanyahu forma um novo governo logo antes do prazo
Quake forte mata 367 no sul da China	Pai australiano acusado de abusar de gêmeos substitutos
A Itália alerta a ameaça da Líbia à medida que a pressão pela ação cresce	continente para elevar a necessidade de ingresso para os residentes de Taiwan
A Bielorrússia aperta a segurança ao longo da fronteira com a Ucrânia	Shoppings em Paris, Londres, sob forte segurança após a ameaça do Shabab
Pistorius ataca à frente do veredicto	JP otimista antes do triangular
Enfermeira com Ebola aparece na câmera antes de sair do Hospital Dallas	Primeiro caso de Ebola diagnosticado em nós depois do homem que voou da Libéria FIRS ILL
Crianças entre vítimas de bombardeio na Síria	Mercado de bombas de meninas na Nigéria
A OTAN evitou quando a França chama a UE para destruir o Estado Islâmico	Homem do Texas preso, acusado de ajudar um amigo a viajar para o exterior para se juntar ao Estado Islâmico
Dezenas de reféns egípcios tomados por terroristas líbios como vingança por ataques aéreos	Crash em barcos egípcios Crash Death Toll aumenta à medida que mais corpos encontrados no Nilo
Presidente indo para o Bahrein	Presidente XI: China para continuar ajudando a combater o Ebola
O presidente da Venezuela concede derrota	Venezuela aperta as regras do visto na América
nós. Os estoques abrem mais baixo após a manifestação	As ações dos EUA terminam a semana rochosa com uma onda; Nike ganha
Poderes de vigilância dos EUA prontos para ceder após a votação do Senado	Islândia reduz o alerta do vulcão para laranja
China, Índia promete mais laços bilaterais	A China luta para tranquilizar os comerciantes de ações nervosas
júri tsarnaev para começar as deliberações	O partido de Musharraf para contestar as eleições locais do Paquistão
Gólidos matam 20 trabalhadores no SW Paquistão: Oficiais	Ataque suicida, explosão de bombas no Paquistão Kill 10
China para colocar o escritor de 81 anos em julgamento: advogado	A China cortou a taxa de yuan mais de 1 % em relação ao dólar
Boko Haram: Os comerciantes recomendam o FG / Boko Haram CeaseFire	Adam Chandler: um cessar-fogo ucraniano oco
Ucrânia City se prepara para o avanço rebelde	O ministro da Ucrânia diz 'sem ameaça' do acidente de usina nuclear
Funeral de Ian Paisley para acontecer em Belfast	Kerry pede a Frente Unida para enfrentar o Estado Islâmico
Obama está certo: a África merece melhor liderança	Obama esperando o meio do mandato para nomear o procurador -geral
Homem, 20 anos, mata 13 no tiroteio na faculdade de Oregon	4 mortos em Okla. Crash envolvendo o time de softball universitário
O ministro alemão pousa no Irã com a equipe de comércio	Iêmen para nomear o novo PM em trato com rebeldes xiitas
Felline Pips australia	Hamilton ganha o GP russo, pois Rosberg falha ao terminar
Ataque ao Parlamento Canadense: Soldado, Shooter morto	Chefe do Exército da Tunísia renuncia depois que os soldados mataram
Turquia bate o lançador de mísseis russos 'Provocação'	A Turquia pede à Rússia que não aumente a tensão na Síria
Obama aborda a situação dos cristãos no Oriente Médio	nós. repreende a vitoriosa Netanyahu de Israel na política do Oriente Médio
nós é o destino mais popular para viajantes chineses	Nusra exige compensação, auxílio à liberação de soldados
Biden tem o que é preciso para competir em New Hampshire?	A polícia ligou para relatos de helicóptero no mar
'estrutura' para o acordo final alcançado nas negociações nucleares do Irã	Aproveite o momento de avanço nas negociações nucleares do Irã
A Espanha não se comprometeu a receber mais migrantes	Turquia vota em uma das eleições mais cruciais em anos
Kranjcar deixa atrasado para resgatar o QPR contra o Stoke inspirado em Moisés	O Irã é acadêmico por crimes contra o regime
Kerry pretende acalmar as tensões do mar do sul da China	Curds iraquianos dizem que o Estado Islâmico usou bomba de cloro
surto de ebola e 'emergência internacional' - Organização Mundial da Saúde	O surto de ebola as mortes excedem 4.000 - quem
A Nigéria chega a lidar com o Boko Haram sobre as meninas sequestradas: fonte	pontuação morta após o ataque de bomba do Boko Haram na Nigéria
porta -voz de Putin: as acusações de doping parecem infundadas	O mais recente sobre clima severo: 1 morto no Texas depois de tornado
Seis mortos, 33 feridos na explosão de plantas de fogos de artifício da China	2 mortos, 5 feridos em acidente de helicóptero na província afegã de Bamyan
O Paquistão não permitirá que as ONGs trabalhando contra o interesse nacional: NISAR	Tianjin China Blast: resgatadores trabalhando contra o tempo
Novo vídeo mostra os policiais dos EUA que batendo no homem mental-ilegal	O policial de Nova York feriu criticamente em ataque de machadinha
'centenas presos' em Burundi em meio a agitação política	Burundi: Pequenos grupos de manifestantes, colapso da polícia em Burundi Capital: Testemunhas
Todos os nove a bordo morrem no Alaska Crash of Excursion Plane	Lonmin espera os custos de caixa subjacentes do ano inteiro abaixo da orientação